Cppf_phi1,Cppf_phi2,Cppf_phi3,Cppf_phi4,Cppf_theta1,Cppf_theta2,Cppf_theta3,Cppf_theta4,cluster_size1,cluster_size2,cluster_size3,cluster_size4,Deltaphi12,Deltaphi23,Deltaphi34,Deltatheta12,Deltatheta23,Deltatheta34
384,374,370,374,13,14,12,13,2,3,3,1,10,4,-4,-1,2,-1
604,600,595,590,14,14,13,13,2,3,3,2,4,5,5,0,1,0
571,567,567,562,14,14,15,16,1,1,2,3,4,0,5,0,-1,-1
440,436,436,431,20,19,20,18,1,2,2,1,4,0,5,1,-1,2
942,937,937,932,13,14,15,13,1,2,2,2,5,0,5,-1,-1,2
693,689,689,684,17,19,18,18,2,3,3,2,4,0,5,-2,1,0
614,609,609,604,14,17,15,16,3,3,1,2,5,0,5,-3,2,-1
862,857,862,857,14,17,15,16,3,1,2,1,5,-5,5,-3,2,-1
918,914,914,909,14,14,13,13,1,2,1,1,4,0,5,0,1,0
881,871,876,867,14,14,15,13,1,1,2,2,10,-5,9,0,-1,2
618,604,604,600,14,14,13,13,2,2,1,2,14,0,4,0,1,0
553,543,539,539,14,14,13,13,1,3,3,3,10,4,0,0,1,0
539,534,534,529,18,19,18,19,2,3,2,3,5,0,5,-1,1,-1
782,773,768,768,18,19,18,18,2,3,3,1,9,5,0,-1,1,0
637,632,637,637,20,19,20,21,1,1,2,1,5,-5,0,1,-1,-1
937,923,914,918,13,14,15,13,2,3,1,3,14,9,-4,-1,-1,2
773,773,778,768,17,19,18,18,3,2,2,2,0,-5,10,-2,1,0
881,867,867,867,14,14,15,13,3,1,2,2,14,0,0,0,-1,2
974,960,956,960,13,14,12,13,1,3,1,1,14,4,-4,-1,2,-1
557,548,548,548,14,14,13,13,1,2,3,2,9,0,0,0,1,0
684,928,674,670,17,19,18,18,2,1,2,1,-244,254,4,-2,1,0
942,937,937,937,20,19,20,21,1,1,1,3,5,0,0,1,-1,-1
426,412,417,417,17,16,15,16,2,2,1,2,14,-5,0,1,1,-1
600,595,595,590,14,14,13,13,3,2,2,2,5,0,5,0,1,0
389,384,384,379,17,16,18,16,1,1,2,2,5,0,5,1,-2,2
290,286,286,286,18,19,20,19,2,3,1,1,4,0,0,-1,-1,1
239,234,234,234,21,19,20,18,2,1,2,1,5,0,0,2,-1,2
262,257,262,257,21,19,20,21,1,2,1,2,5,-5,5,2,-1,-1
192,1073,1073,1073,18,16,18,16,1,2,1,1,-881,0,0,2,-2,2
248,243,243,239,21,19,20,18,1,2,1,2,5,0,4,2,-1,2
824,815,815,810,14,14,13,13,1,2,1,1,9,0,5,0,1,0
646,637,623,614,13,14,13,13,1,3,1,2,9,14,9,-1,1,0
286,281,276,276,14,14,15,16,3,3,1,1,5,5,0,0,-1,-1
454,450,450,440,13,14,15,13,1,3,3,2,4,0,10,-1,-1,2
665,651,642,646,13,14,12,13,3,2,1,2,14,9,-4,-1,2,-1
937,923,923,923,17,17,15,16,2,2,1,2,14,0,0,0,2,-1
609,614,614,609,21,19,21,19,2,1,3,1,-5,0,5,2,-2,2
834,815,815,815,18,19,18,19,1,2,2,1,19,0,0,-1,1,-1
820,764,764,754,14,14,15,13,2,3,2,2,56,0,10,0,-1,2
271,262,262,262,14,14,15,16,2,2,4,1,9,0,0,0,-1,-1
515,515,515,510,14,14,13,13,1,2,1,2,0,0,5,0,1,0
876,876,881,881,14,14,15,13,1,2,2,1,0,-5,0,0,-1,2
393,393,389,379,13,14,12,13,2,4,2,2,0,4,10,-1,2,-1
820,815,815,810,14,14,13,13,1,1,1,2,5,0,5,0,1,0
623,618,618,618,14,17,15,16,1,2,3,1,5,0,0,-3,2,-1
1054,1040,1031,1031,20,19,18,18,1,2,1,2,14,9,0,1,1,0
440,436,426,431,13,14,15,13,3,2,1,1,4,10,-5,-1,-1,2
600,595,600,595,14,14,15,13,1,3,2,1,5,-5,5,0,-1,2
1064,1064,1064,1064,17,16,15,16,3,1,2,1,0,0,0,1,1,-1
351,351,346,342,20,19,18,18,1,3,1,2,0,5,4,1,1,0
623,614,614,604,14,14,13,13,1,2,2,2,9,0,10,0,1,0
717,712,712,707,17,16,18,18,3,1,1,1,5,0,5,1,-2,0
464,459,459,459,13,16,15,16,2,2,1,1,5,0,0,-3,1,-1
520,520,524,520,14,14,15,13,2,4,2,2,0,-4,4,0,-1,2
192,196,196,196,14,14,15,13,1,1,1,1,-4,0,0,0,-1,2
281,276,281,276,18,17,18,16,2,2,1,3,5,-5,5,1,-1,2
857,843,839,834,14,14,13,13,2,2,1,2,14,4,5,0,1,0
909,890,890,890,14,17,15,16,2,2,1,2,19,0,0,-3,2,-1
389,384,384,398,20,19,20,18,2,3,2,2,5,0,-14,1,-1,2
524,520,515,515,14,14,15,13,2,3,3,1,4,5,0,0,-1,2
609,604,604,604,21,19,20,21,2,3,2,2,5,0,0,2,-1,-1
412,407,407,403,17,16,15,16,3,2,2,1,5,0,4,1,1,-1
543,539,539,539,18,19,18,18,3,1,2,1,4,0,0,-1,1,0
468,459,459,454,13,14,12,13,2,2,2,2,9,0,5,-1,2,-1
473,464,459,459,13,14,15,13,2,3,2,1,9,5,0,-1,-1,2
1078,1078,1073,1078,20,19,20,18,2,1,1,1,0,5,-5,1,-1,2
1017,1007,1012,1012,20,19,20,21,2,2,2,1,10,-5,0,1,-1,-1
703,698,693,698,20,19,18,18,3,1,1,1,5,5,-5,1,1,0
220,215,206,215,14,14,13,13,1,2,3,3,5,9,-9,0,1,0
1017,1007,1007,1012,17,16,18,18,1,2,1,1,10,0,-5,1,-2,0
989,984,984,989,20,19,20,18,2,1,1,1,5,0,-5,1,-1,2
998,998,993,993,13,14,12,13,1,2,1,1,0,5,0,-1,2,-1
1054,1050,1045,1045,13,14,12,13,3,3,1,1,4,5,0,-1,2,-1
759,759,754,754,13,14,12,13,3,3,2,2,0,5,0,-1,2,-1
496,492,492,496,14,14,13,13,1,3,1,1,4,0,-4,0,1,0
412,407,407,407,13,14,12,13,1,2,2,1,5,0,0,-1,2,-1
351,346,346,346,17,19,18,18,3,2,1,1,5,0,0,-2,1,0
210,201,196,196,18,19,18,19,3,3,1,2,9,5,0,-1,1,-1
304,295,295,290,18,19,18,19,3,2,1,2,9,0,5,-1,1,-1
562,553,553,553,18,19,18,18,3,2,6,1,9,0,0,-1,1,0
534,529,529,529,18,17,18,19,2,1,1,2,5,0,0,1,-1,-1
1045,1036,815,1040,20,19,18,18,1,1,1,1,9,221,-225,1,1,0
974,979,970,965,13,14,15,13,3,2,3,2,-5,9,5,-1,-1,2
942,932,932,932,20,19,20,18,1,2,1,1,10,0,0,1,-1,2
871,871,871,867,14,14,15,13,2,3,2,2,0,0,4,0,-1,2
524,524,524,520,18,17,18,19,1,3,2,1,0,0,4,1,-1,-1
328,318,314,323,18,19,18,19,1,3,1,1,10,4,-9,-1,1,-1
356,351,356,450,13,14,15,11,3,3,2,1,5,-5,-94,-1,-1,4
660,656,656,660,20,19,20,21,1,1,1,1,4,0,-4,1,-1,-1
853,848,843,843,14,14,13,13,1,1,3,3,5,5,0,0,1,0
510,501,510,520,21,19,20,21,4,1,1,1,9,-9,-10,2,-1,-1
323,309,295,290,14,14,13,13,2,3,2,4,14,14,5,0,1,0
918,909,914,918,14,14,13,13,3,2,1,3,9,-5,-4,0,1,0
524,515,515,510,18,17,18,19,3,2,1,1,9,0,5,1,-1,-1
520,520,520,515,14,17,15,16,1,1,2,2,0,0,5,-3,2,-1
979,979,974,974,17,16,15,16,3,1,2,2,0,5,0,1,1,-1
267,267,262,262,18,17,18,18,1,1,1,1,0,5,0,1,-1,0
886,881,881,881,14,14,13,13,1,2,2,1,5,0,0,0,1,0
257,243,239,239,18,17,15,16,3,1,3,1,14,4,0,1,2,-1
609,600,595,595,14,14,15,13,4,2,1,2,9,5,0,0,-1,2
951,946,946,946,17,16,18,16,1,1,2,1,5,0,0,1,-2,2
595,586,586,586,18,19,18,19,2,2,1,2,9,0,0,-1,1,-1
351,346,346,346,20,19,20,18,2,1,1,1,5,0,0,1,-1,2
459,459,459,450,20,19,20,21,3,1,1,2,0,0,9,1,-1,-1
220,215,220,210,18,17,18,19,2,1,2,2,5,-5,10,1,-1,-1
857,839,834,829,14,14,15,13,1,4,1,1,18,5,5,0,-1,2
370,360,356,356,20,19,18,18,1,1,1,1,10,4,0,1,1,0
276,271,276,271,14,14,13,13,2,6,1,1,5,-5,5,0,1,0
1031,1026,1021,1017,17,16,15,16,1,2,2,2,5,5,4,1,1,-1
600,595,595,590,18,19,18,19,3,2,2,1,5,0,5,-1,1,-1
660,656,651,651,17,16,18,18,2,3,1,2,4,5,0,1,-2,0
670,670,665,670,17,16,15,16,1,1,1,2,0,5,-5,1,1,-1
295,300,300,300,21,19,20,21,1,3,1,6,-5,0,0,2,-1,-1
679,674,679,679,20,19,20,21,2,2,2,3,5,-5,0,1,-1,-1
586,576,576,571,14,14,15,13,1,2,2,2,10,0,5,0,-1,2
745,740,740,736,20,19,18,18,1,2,1,2,5,0,4,1,1,0
712,712,712,707,13,14,15,13,1,1,2,2,0,0,5,-1,-1,2
1045,1036,1036,1040,13,14,12,13,2,2,1,1,9,0,-4,-1,2,-1
993,984,984,984,17,19,18,18,2,1,1,2,9,0,0,-2,1,0
923,918,914,918,14,17,15,16,3,1,1,1,5,4,-4,-3,2,-1
393,389,393,389,20,19,18,18,1,2,3,1,4,-4,4,1,1,0
337,300,300,300,17,17,18,19,3,1,1,1,37,0,0,0,-1,-1
759,754,754,750,13,14,12,13,2,3,2,2,5,0,4,-1,2,-1
271,271,271,267,18,17,18,18,2,2,1,2,0,0,4,1,-1,0
468,459,464,459,13,14,12,13,1,2,2,1,9,-5,5,-1,2,-1
351,346,346,342,20,19,20,18,2,3,1,2,5,0,4,1,-1,2
712,703,707,703,17,16,18,18,2,2,1,2,9,-4,4,1,-2,0
267,262,262,262,21,19,20,18,1,2,1,1,5,0,0,2,-1,2
464,459,468,459,17,19,18,18,3,2,1,1,5,-9,9,-2,1,0
281,276,271,276,14,14,13,13,3,2,2,1,5,5,-5,0,1,0
262,257,257,257,18,17,18,16,1,2,1,1,5,0,0,1,-1,2
445,445,445,440,17,16,15,16,1,3,2,1,0,0,5,1,1,-1
539,539,543,539,14,14,13,13,1,2,4,1,0,-4,4,0,1,0
215,210,210,206,14,14,13,13,3,3,3,1,5,0,4,0,1,0
890,876,871,871,14,14,15,13,2,2,3,1,14,5,0,0,-1,2
801,796,796,796,21,19,21,21,1,1,1,1,5,0,0,2,-2,0
618,609,604,604,14,17,15,16,3,2,2,2,9,5,0,-3,2,-1
314,309,314,309,18,19,18,19,2,2,2,1,5,-5,5,-1,1,-1
281,267,271,276,14,14,13,13,1,2,2,1,14,-4,-5,0,1,0
693,689,707,684,13,14,12,13,2,2,2,1,4,-18,23,-1,2,-1
515,492,478,473,14,14,13,13,3,3,2,1,23,14,5,0,1,0
853,843,843,843,14,14,15,13,1,2,3,3,10,0,0,0,-1,2
651,646,642,637,13,14,15,16,2,2,3,3,5,4,5,-1,-1,-1
571,567,571,562,18,17,18,18,2,2,3,2,4,-4,9,1,-1,0
1059,1059,1050,1054,17,16,15,16,3,1,1,3,0,9,-4,1,1,-1
539,534,534,534,14,14,13,13,1,3,1,3,5,0,0,0,1,0
923,923,918,918,18,19,18,19,1,3,1,1,0,5,0,-1,1,-1
473,468,468,478,13,14,15,16,1,1,3,1,5,0,-10,-1,-1,-1
281,276,281,271,18,19,18,18,3,2,4,2,5,-5,10,-1,1,0
253,248,253,248,18,19,20,18,1,2,2,1,5,-5,5,-1,-1,2
454,450,464,464,20,19,20,18,3,3,1,1,4,-14,0,1,-1,2
974,965,956,956,13,14,12,13,1,2,1,3,9,9,0,-1,2,-1
407,407,407,403,17,19,18,18,1,2,1,2,0,0,4,-2,1,0
660,656,660,656,20,19,20,18,3,1,1,2,4,-4,4,1,-1,2
707,703,703,698,13,14,12,13,2,3,1,4,4,0,5,-1,2,-1
928,923,923,918,21,19,21,21,1,2,1,2,5,0,5,2,-2,0
496,487,492,492,18,17,15,16,3,1,2,1,9,-5,0,1,2,-1
510,506,506,501,14,14,15,13,2,3,2,2,4,0,5,0,-1,2
576,562,567,567,14,14,15,13,4,3,1,2,14,-5,0,0,-1,2
862,857,853,857,18,19,18,18,3,1,2,3,5,4,-4,-1,1,0
360,356,360,356,20,19,20,21,1,1,1,2,4,-4,4,1,-1,-1
576,571,571,571,21,19,20,21,1,2,3,1,5,0,0,2,-1,-1
220,220,220,215,14,14,13,13,2,3,2,2,0,0,5,0,1,0
496,496,496,496,18,17,18,19,1,3,2,1,0,0,0,1,-1,-1
956,946,946,946,13,14,15,13,4,3,1,3,10,0,0,-1,-1,2
496,454,454,454,14,14,15,13,2,2,2,1,42,0,0,0,-1,2
1031,1031,1031,1026,13,14,12,13,1,1,2,2,0,0,5,-1,2,-1
1059,1050,1054,1050,13,14,12,13,1,2,2,2,9,-4,4,-1,2,-1
557,557,553,553,18,17,18,18,1,1,2,1,0,4,0,1,-1,0
515,506,510,506,18,19,18,19,2,1,2,2,9,-4,4,-1,1,-1
478,473,473,473,17,16,15,16,1,2,1,2,5,0,0,1,1,-1
1050,1040,1045,1050,13,14,15,13,1,2,1,4,10,-5,-5,-1,-1,2
196,187,187,182,21,19,21,21,2,1,2,2,9,0,5,2,-2,0
646,642,642,637,20,19,20,21,3,1,3,2,4,0,5,1,-1,-1
862,848,853,848,14,14,15,13,3,2,1,3,14,-5,5,0,-1,2
220,215,215,215,18,17,18,19,2,2,1,1,5,0,0,1,-1,-1
1012,1012,1007,1003,17,16,18,16,3,3,2,1,0,5,4,1,-2,2
210,201,196,201,14,14,13,13,3,3,2,1,9,5,-5,0,1,0
843,839,839,839,18,17,18,16,1,2,3,1,4,0,0,1,-1,2
721,721,726,717,13,14,12,13,1,3,2,2,0,-5,9,-1,2,-1
1059,1054,1050,1050,20,19,20,21,2,1,1,2,5,4,0,1,-1,-1
548,553,543,548,14,14,15,13,3,3,1,1,-5,10,-5,0,-1,2
562,562,557,562,21,19,20,21,2,1,1,1,0,5,-5,2,-1,-1
384,374,365,365,20,19,20,21,3,2,1,1,10,9,0,1,-1,-1
323,323,328,314,21,19,21,21,2,2,2,2,0,-5,14,2,-2,0
412,403,403,407,20,19,20,21,4,2,1,1,9,0,-4,1,-1,-1
782,782,787,782,21,19,21,21,2,2,2,1,0,-5,5,2,-2,0
468,459,459,464,13,14,12,13,1,1,3,1,9,0,-5,-1,2,-1
689,689,684,684,13,14,15,13,3,3,4,2,0,5,0,-1,-1,2
243,239,229,234,14,14,15,13,2,1,1,1,4,10,-5,0,-1,2
571,557,562,557,18,17,18,16,2,1,1,2,14,-5,5,1,-1,2
562,548,548,543,14,17,15,16,2,1,1,1,14,0,5,-3,2,-1
243,239,243,253,18,17,18,18,1,4,1,1,4,-4,-10,1,-1,0
454,450,454,450,20,19,20,21,3,2,1,1,4,-4,4,1,-1,-1
290,290,286,295,18,17,18,16,6,1,3,1,0,4,-9,1,-1,2
707,707,703,703,17,16,18,16,1,1,1,3,0,4,0,1,-2,2
736,726,726,721,20,19,20,21,2,1,1,2,10,0,5,1,-1,-1
754,745,750,745,17,16,18,18,2,2,2,1,9,-5,5,1,-2,0
417,417,426,426,20,19,20,21,1,1,2,1,0,-9,0,1,-1,-1
848,843,843,843,21,19,20,18,1,1,2,1,5,0,0,2,-1,2
201,196,196,196,18,17,18,19,2,2,1,2,5,0,0,1,-1,-1
543,543,543,543,18,17,18,18,2,2,3,3,0,0,0,1,-1,0
543,539,539,543,18,17,18,18,2,2,1,1,4,0,-4,1,-1,0
487,482,478,482,14,14,13,13,3,1,1,1,5,4,-4,0,1,0
454,454,454,450,20,19,20,21,1,2,1,1,0,0,4,1,-1,-1
928,914,928,937,21,19,21,18,1,2,1,1,14,-14,-9,2,-2,3
918,918,923,918,14,14,13,13,1,3,2,2,0,-5,5,0,1,0
993,989,993,989,13,14,12,13,3,2,2,2,4,-4,4,-1,2,-1
689,684,684,679,20,19,20,21,2,1,2,2,5,0,5,1,-1,-1
515,510,510,510,18,17,18,16,5,2,2,1,5,0,0,1,-1,2
295,286,281,281,18,19,20,19,2,1,1,1,9,5,0,-1,-1,1
300,295,290,290,14,14,15,16,2,3,1,1,5,5,0,0,-1,-1
473,464,454,464,20,19,20,21,3,2,1,1,9,10,-10,1,-1,-1
979,979,974,974,17,16,18,18,3,3,1,3,0,5,0,1,-2,0
417,407,407,403,13,14,15,16,2,3,3,1,10,0,4,-1,-1,-1
1012,1003,1007,1003,17,16,18,18,1,1,1,1,9,-4,4,1,-2,0
515,510,506,501,14,14,15,13,1,3,1,2,5,4,5,0,-1,2
328,323,318,318,14,17,15,16,1,1,3,1,5,5,0,-3,2,-1
501,501,501,492,21,19,21,19,2,1,1,2,0,0,9,2,-2,2
707,693,689,684,17,16,18,18,2,1,2,1,14,4,5,1,-2,0
890,890,886,890,18,19,18,19,1,1,3,3,0,4,-4,-1,1,-1
768,759,764,759,20,19,20,21,2,1,2,1,9,-5,5,1,-1,-1
187,187,1078,1073,14,14,15,16,3,1,1,2,0,-891,5,0,-1,-1
524,520,520,520,18,19,18,19,1,2,1,3,4,0,0,-1,1,-1
365,356,356,351,13,14,15,13,1,2,2,1,9,0,5,-1,-1,2
979,970,970,974,20,19,20,18,2,2,1,1,9,0,-4,1,-1,2
703,693,689,693,13,14,12,13,2,3,1,1,10,4,-4,-1,2,-1
703,689,670,670,13,14,15,13,1,3,1,2,14,19,0,-1,-1,2
886,881,946,881,14,17,20,16,2,2,1,1,5,-65,65,-3,-3,4
257,248,253,253,18,19,18,18,3,4,3,1,9,-5,0,-1,1,0
717,707,712,707,20,19,20,21,6,1,1,1,10,-5,5,1,-1,-1
403,403,393,389,20,19,20,21,2,1,1,1,0,10,4,1,-1,-1
956,956,956,946,13,14,15,16,2,1,2,2,0,0,10,-1,-1,-1
482,482,487,482,18,19,18,19,2,1,2,1,0,-5,5,-1,1,-1
374,365,365,365,13,14,15,13,1,2,1,2,9,0,0,-1,-1,2
421,417,421,417,20,19,20,21,1,2,2,3,4,-4,4,1,-1,-1
276,267,262,262,14,14,13,13,2,3,3,3,9,5,0,0,1,0
445,431,436,436,20,19,20,21,2,3,1,1,14,-5,0,1,-1,-1
482,487,478,478,18,19,18,18,2,2,2,1,-5,9,0,-1,1,0
374,374,365,379,13,14,15,13,2,2,1,1,0,9,-14,-1,-1,2
590,586,586,581,14,14,15,13,1,2,2,1,4,0,5,0,-1,2
529,534,529,529,18,17,18,16,3,2,1,3,-5,5,0,1,-1,2
281,271,276,276,18,19,18,18,3,1,2,1,10,-5,0,-1,1,0
436,431,426,426,17,16,18,16,1,1,1,1,5,5,0,1,-2,2
853,843,848,843,14,14,15,13,2,1,2,2,10,-5,5,0,-1,2
421,417,417,417,17,16,18,18,1,2,1,1,4,0,0,1,-2,0
984,979,984,979,17,16,18,16,1,2,2,6,5,-5,5,1,-2,2
370,365,365,360,17,16,18,18,2,3,2,2,5,0,5,1,-2,0
1021,1021,1017,1017,13,14,12,13,3,2,1,1,0,4,0,-1,2,-1
590,586,586,581,18,17,18,16,3,2,2,3,4,0,5,1,-1,2
567,557,553,553,18,19,18,18,2,1,1,3,10,4,0,-1,1,0
642,637,637,632,17,16,18,16,1,3,1,1,5,0,5,1,-2,2
365,356,356,351,13,14,12,13,1,4,3,1,9,0,5,-1,2,-1
848,834,834,834,14,17,15,16,3,2,1,1,14,0,0,-3,2,-1
271,267,267,267,18,17,18,18,1,3,1,1,4,0,0,1,-1,0
346,342,342,342,20,19,20,21,3,2,2,2,4,0,0,1,-1,-1
796,796,792,792,18,19,18,19,3,3,1,1,0,4,0,-1,1,-1
243,243,239,239,18,17,18,18,2,1,1,1,0,4,0,1,-1,0
1007,1003,1007,1007,17,19,18,18,1,2,1,1,4,-4,0,-2,1,0
304,295,290,286,14,17,15,16,1,2,2,4,9,5,4,-3,2,-1
557,553,557,548,14,17,15,16,3,2,2,1,4,-4,9,-3,2,-1
384,374,374,374,13,14,12,13,1,2,3,2,10,0,0,-1,2,-1
998,998,989,989,13,14,12,13,1,3,1,1,0,9,0,-1,2,-1
824,815,815,815,14,14,15,16,1,2,2,1,9,0,0,0,-1,-1
815,806,796,796,14,14,15,13,4,2,1,2,9,10,0,0,-1,2
1003,998,993,993,17,19,18,18,2,1,1,1,5,5,0,-2,1,0
365,356,356,356,20,19,20,21,2,1,1,3,9,0,0,1,-1,-1
609,604,604,604,18,17,18,19,2,2,3,1,5,0,0,1,-1,-1
417,407,407,407,13,14,15,13,1,2,3,1,10,0,0,-1,-1,2
881,881,881,876,18,17,18,16,2,1,2,1,0,0,5,1,-1,2
304,300,304,300,14,17,15,16,2,2,2,1,4,-4,4,-3,2,-1
351,346,351,351,13,14,15,16,1,2,1,1,5,-5,0,-1,-1,-1
220,210,206,210,18,17,18,19,3,3,1,1,10,4,-4,1,-1,-1
1017,1012,1017,1021,17,16,18,18,1,2,1,1,5,-5,-4,1,-2,0
459,450,445,445,13,16,15,16,1,3,2,3,9,5,0,-3,1,-1
309,300,300,300,14,17,15,16,2,2,2,1,9,0,0,-3,2,-1
1007,1003,998,998,17,16,18,18,2,3,2,1,4,5,0,1,-2,0
660,651,646,646,13,14,12,13,2,1,2,1,9,5,0,-1,2,-1
787,787,787,782,14,17,15,16,2,2,3,2,0,0,5,-3,2,-1
426,421,426,421,13,14,15,13,3,2,1,3,5,-5,5,-1,-1,2
450,445,450,440,20,19,20,21,4,2,3,1,5,-5,10,1,-1,-1
581,581,581,459,14,14,15,9,3,5,1,1,0,0,122,0,-1,6
220,215,215,210,14,14,15,16,1,3,2,3,5,0,5,0,-1,-1
370,360,356,360,13,14,12,13,3,1,3,3,10,4,-4,-1,2,-1
595,586,590,590,18,19,18,19,3,2,2,1,9,-4,0,-1,1,-1
698,693,674,679,13,14,12,13,1,1,5,1,5,19,-5,-1,2,-1
515,515,520,515,21,19,20,21,2,2,2,3,0,-5,5,2,-1,-1
300,539,286,286,14,14,13,13,1,1,1,1,-239,253,0,0,1,0
1003,998,1003,998,13,14,12,13,2,1,1,2,5,-5,5,-1,2,-1
304,290,295,300,14,14,15,13,3,2,1,2,14,-5,-5,0,-1,2
520,515,510,510,18,17,18,19,1,2,3,2,5,5,0,1,-1,-1
445,421,421,426,13,14,15,13,1,2,1,1,24,0,-5,-1,-1,2
914,918,918,914,21,19,21,19,2,1,2,1,-4,0,4,2,-2,2
1031,1021,1017,1021,13,14,12,13,1,3,1,1,10,4,-4,-1,2,-1
187,1073,1073,1073,14,14,15,16,1,2,1,2,-886,0,0,0,-1,-1
815,815,815,820,18,19,18,19,2,3,1,3,0,0,-5,-1,1,-1
942,932,928,928,17,19,18,19,2,1,1,1,10,4,0,-2,1,-1
970,965,965,960,17,16,18,18,1,2,3,3,5,0,5,1,-2,0
1045,1040,1040,1040,13,16,15,16,3,2,2,1,5,0,0,-3,1,-1
674,674,674,670,13,14,12,13,3,3,1,2,0,0,4,-1,2,-1
820,815,810,810,14,17,15,16,1,3,1,1,5,5,0,-3,2,-1
459,445,445,440,13,14,12,13,2,2,2,3,14,0,5,-1,2,-1
229,229,224,224,18,17,18,19,1,1,1,1,0,5,0,1,-1,-1
853,848,848,848,14,14,13,13,3,1,2,2,5,0,0,0,1,0
520,515,515,510,21,19,20,19,4,1,1,1,5,0,5,2,-1,1
445,436,440,436,20,19,20,18,2,3,1,1,9,-4,4,1,-1,2
229,224,224,224,18,17,18,19,3,1,1,1,5,0,0,1,-1,-1
736,721,721,717,17,16,15,16,2,2,2,1,15,0,4,1,1,-1
914,904,900,900,18,19,18,19,3,1,2,1,10,4,0,-1,1,-1
853,848,848,843,21,19,20,18,3,3,1,1,5,0,5,2,-1,2
351,342,342,337,17,16,18,18,1,1,1,2,9,0,5,1,-2,0
576,567,567,567,14,14,15,13,2,1,1,2,9,0,0,0,-1,2
998,989,984,989,13,14,12,13,2,3,1,1,9,5,-5,-1,2,-1
867,862,862,857,18,17,18,18,2,2,2,1,5,0,5,1,-1,0
539,515,515,506,14,14,13,13,3,2,2,2,24,0,9,0,1,0
1007,1003,1007,1007,20,19,18,18,2,3,3,2,4,-4,0,1,1,0
248,239,248,239,18,17,18,18,1,2,2,1,9,-9,9,1,-1,0
365,360,360,360,13,14,12,13,2,3,1,1,5,0,0,-1,2,-1
764,759,759,754,13,14,12,13,2,2,2,4,5,0,5,-1,2,-1
623,623,628,623,18,19,18,19,2,1,2,2,0,-5,5,-1,1,-1
243,224,229,229,14,14,13,13,1,2,2,1,19,-5,0,0,1,0
300,290,286,290,18,19,18,19,1,1,1,1,10,4,-4,-1,1,-1
182,1073,1078,1078,14,14,15,13,2,2,1,1,-891,-5,0,0,-1,2
998,993,993,993,17,16,18,18,3,1,3,1,5,0,0,1,-2,0
1021,1017,1026,1031,20,19,18,18,1,3,1,1,4,-9,-5,1,1,0
773,759,778,764,13,14,13,13,1,2,2,1,14,-19,14,-1,1,0
665,660,656,651,17,16,15,16,3,4,2,2,5,4,5,1,1,-1
586,571,562,557,14,14,15,13,2,3,2,2,15,9,5,0,-1,2
609,604,595,600,14,14,13,13,2,1,1,1,5,9,-5,0,1,0
848,843,848,848,21,19,20,18,2,2,1,1,5,-5,0,2,-1,2
553,548,548,548,18,19,18,18,1,1,3,5,5,0,0,-1,1,0
257,243,234,234,14,14,15,13,5,3,1,1,14,9,0,0,-1,2
754,750,750,750,20,19,20,18,2,2,2,1,4,0,0,1,-1,2
600,590,590,590,14,17,15,16,1,2,3,1,10,0,0,-3,2,-1
904,904,904,900,21,19,20,19,1,1,2,3,0,0,4,2,-1,1
224,562,201,196,14,14,13,13,1,1,3,1,-338,361,5,0,1,0
215,206,201,196,14,14,13,13,2,1,2,2,9,5,5,0,1,0
796,787,787,787,14,14,13,13,2,2,1,2,9,0,0,0,1,0
239,234,229,229,14,14,15,13,2,3,1,2,5,5,0,0,-1,2
937,937,937,937,13,14,12,13,1,2,1,1,0,0,0,-1,2,-1
576,571,571,539,18,19,18,18,1,1,1,1,5,0,32,-1,1,0
970,182,960,951,17,17,18,18,3,1,2,2,788,-778,9,0,-1,0
600,586,637,670,21,19,20,21,2,2,1,2,14,-51,-33,2,-1,-1
759,759,759,754,17,19,18,18,3,3,2,2,0,0,5,-2,1,0
417,412,417,412,17,16,18,16,3,3,1,2,5,-5,5,1,-2,2
984,979,979,979,20,19,20,18,1,1,1,2,5,0,0,1,-1,2
520,510,496,492,18,17,18,16,1,1,1,2,10,14,4,1,-1,2
618,618,618,614,21,19,21,21,2,3,2,2,0,0,4,2,-2,0
881,1064,876,876,18,19,18,18,2,1,1,2,-183,188,0,-1,1,0
360,351,370,374,17,16,15,16,1,1,2,1,9,-19,-4,1,1,-1
829,824,824,824,18,17,18,19,1,3,1,1,5,0,0,1,-1,-1
993,993,993,989,13,14,15,13,3,1,2,2,0,0,4,-1,-1,2
215,215,215,210,18,17,18,19,2,2,2,1,0,0,5,1,-1,-1
543,534,539,534,21,19,20,21,3,2,1,3,9,-5,5,2,-1,-1
674,674,674,674,20,19,18,18,1,2,1,1,0,0,0,1,1,0
290,281,286,281,14,14,13,13,1,2,2,2,9,-5,5,0,1,0
1050,1045,1040,1040,13,14,12,13,2,3,2,2,5,5,0,-1,2,-1
942,243,937,932,17,17,15,16,2,1,1,2,699,-694,5,0,2,-1
895,895,895,895,18,17,18,16,2,3,2,1,0,0,0,1,-1,2
707,703,707,707,20,19,20,18,1,1,2,3,4,-4,0,1,-1,2
792,787,782,787,18,19,18,19,3,1,1,1,5,5,-5,-1,1,-1
281,281,276,276,18,19,18,18,1,1,1,2,0,5,0,-1,1,0
417,412,412,407,13,14,12,13,2,1,2,2,5,0,5,-1,2,-1
707,693,693,689,13,16,15,16,2,2,1,1,14,0,4,-3,1,-1
351,346,351,374,13,14,12,13,1,4,3,2,5,-5,-23,-1,2,-1
492,487,487,487,21,19,21,19,1,2,1,1,5,0,0,2,-2,2
698,693,689,689,17,16,15,16,3,1,3,2,5,4,0,1,1,-1
309,309,304,309,18,17,18,19,1,2,3,1,0,5,-5,1,-1,-1
417,417,417,412,20,19,20,18,3,2,3,3,0,0,5,1,-1,2
548,543,543,539,18,17,18,18,4,2,2,1,5,0,4,1,-1,0
965,956,960,951,13,14,12,13,1,2,3,2,9,-4,9,-1,2,-1
323,323,323,318,14,14,13,13,2,2,3,2,0,0,5,0,1,0
886,796,792,792,14,17,15,16,1,3,1,2,90,4,0,-3,2,-1
210,206,196,201,14,14,13,13,2,3,1,2,4,10,-5,0,1,0
281,281,286,346,18,19,18,18,4,2,1,1,0,-5,-60,-1,1,0
693,679,679,679,13,16,15,16,2,5,1,1,14,0,0,-3,1,-1
1007,1003,1003,1003,17,16,18,18,3,1,2,1,4,0,0,1,-2,0
389,379,379,379,13,14,15,16,1,3,1,1,10,0,0,-1,-1,-1
900,895,895,895,18,17,18,19,2,2,1,1,5,0,0,1,-1,-1
365,356,360,360,13,14,15,13,1,2,2,1,9,-4,0,-1,-1,2
323,300,304,300,14,17,15,16,3,2,2,1,23,-4,4,-3,2,-1
459,450,459,454,20,19,20,18,3,1,1,2,9,-9,5,1,-1,2
412,412,412,412,20,19,18,18,4,1,3,1,0,0,0,1,1,0
407,403,403,398,13,14,12,13,1,2,1,2,4,0,5,-1,2,-1
604,600,600,595,18,17,18,19,2,2,2,1,4,0,5,1,-1,-1
862,848,848,848,21,19,20,18,1,3,1,1,14,0,0,2,-1,2
642,637,637,660,17,16,18,18,2,2,1,1,5,0,-23,1,-2,0
543,539,539,539,18,17,18,16,1,2,1,1,4,0,0,1,-1,2
1073,1073,1078,1068,17,16,15,16,1,3,2,4,0,-5,10,1,1,-1
295,290,290,290,18,19,18,19,1,2,1,1,5,0,0,-1,1,-1
389,384,384,384,13,16,15,16,1,4,1,2,5,0,0,-3,1,-1
576,576,571,571,18,19,18,18,2,4,1,1,0,5,0,-1,1,0
262,239,234,239,14,14,15,13,1,2,1,1,23,5,-5,0,-1,2
712,717,712,712,17,16,15,16,1,3,3,1,-5,5,0,1,1,-1
290,286,286,281,14,14,13,13,1,3,4,1,4,0,5,0,1,0
286,281,276,286,18,17,18,16,3,1,5,1,5,5,-10,1,-1,2
295,286,281,281,18,17,18,16,1,2,1,3,9,5,0,1,-1,2
881,867,862,862,14,14,15,13,3,1,3,3,14,5,0,0,-1,2
904,900,900,895,21,19,20,21,1,3,1,1,4,0,5,2,-1,-1
590,581,586,581,18,17,18,19,3,1,4,1,9,-5,5,1,-1,-1
707,712,707,707,13,16,15,16,3,1,2,2,-5,5,0,-3,1,-1
806,801,796,796,21,19,21,19,2,1,1,1,5,5,0,2,-2,2
1050,1045,1050,1045,20,19,18,18,1,2,1,1,5,-5,5,1,1,0
801,801,796,792,21,19,21,21,1,3,1,2,0,5,4,2,-2,0
295,290,290,290,21,19,20,21,2,1,1,3,5,0,0,2,-1,-1
445,440,445,440,17,16,15,16,3,1,2,2,5,-5,5,1,1,-1
468,468,468,473,13,14,12,13,1,1,2,3,0,0,-5,-1,2,-1
286,276,281,276,21,19,20,21,1,2,1,1,10,-5,5,2,-1,-1
464,459,454,454,13,14,15,16,1,5,1,2,5,5,0,-1,-1,-1
839,829,824,824,14,14,13,13,1,2,1,2,10,5,0,0,1,0
806,801,801,801,14,17,15,16,1,2,2,1,5,0,0,-3,2,-1
262,253,253,253,14,17,15,16,2,2,1,2,9,0,0,-3,2,-1
267,262,290,309,14,14,15,13,2,1,1,1,5,-28,-19,0,-1,2
810,801,801,796,21,19,21,21,1,2,1,3,9,0,5,2,-2,0
839,843,839,834,14,14,13,13,2,3,1,1,-4,4,5,0,1,0
1064,1059,1059,1059,20,19,18,18,3,1,1,1,5,0,0,1,1,0
295,295,295,295,18,17,18,16,4,3,2,1,0,0,0,1,-1,2
534,524,529,524,14,17,15,16,3,2,3,1,10,-5,5,-3,2,-1
407,398,398,398,13,14,15,16,2,3,4,1,9,0,0,-1,-1,-1
1031,1021,1012,1017,17,16,18,16,2,1,1,1,10,9,-5,1,-2,2
904,890,886,890,14,14,15,16,3,2,1,1,14,4,-4,0,-1,-1
440,436,436,431,20,19,20,21,4,4,2,1,4,0,5,1,-1,-1
384,379,374,379,20,19,20,21,1,1,1,1,5,5,-5,1,-1,-1
595,586,595,604,14,17,15,16,1,1,1,1,9,-9,-9,-3,2,-1
346,342,342,342,13,14,15,13,1,3,2,3,4,0,0,-1,-1,2
271,257,253,253,14,17,15,16,2,1,2,1,14,4,0,-3,2,-1
365,360,356,356,13,14,15,13,1,2,3,1,5,4,0,-1,-1,2
679,670,684,679,13,14,15,13,1,2,2,2,9,-14,5,-1,-1,2
707,707,703,703,20,19,20,21,1,3,1,1,0,4,0,1,-1,-1
524,520,515,515,14,14,13,13,5,3,3,1,4,5,0,0,1,0
974,970,970,970,17,16,15,16,1,2,2,3,4,0,0,1,1,-1
407,407,403,398,17,16,18,18,1,2,3,2,0,4,5,1,-2,0
501,492,492,492,21,19,21,21,1,2,1,1,9,0,0,2,-2,0
271,257,267,262,21,19,20,18,1,1,1,1,14,-10,5,2,-1,2
459,454,454,450,17,16,18,16,2,1,2,2,5,0,4,1,-2,2
206,206,206,201,14,17,15,16,2,2,3,3,0,0,5,-3,2,-1
1045,1031,1036,1036,13,14,15,13,2,2,2,2,14,-5,0,-1,-1,2
253,253,253,253,18,17,18,18,2,3,2,3,0,0,0,1,-1,0
196,187,182,182,18,17,18,19,1,1,1,1,9,5,0,1,-1,-1
651,651,651,651,13,14,15,16,3,1,2,1,0,0,0,-1,-1,-1
942,932,932,932,20,19,20,18,2,2,1,2,10,0,0,1,-1,2
960,960,960,956,13,14,15,13,1,3,2,2,0,0,4,-1,-1,2
820,796,782,782,14,14,13,13,3,3,1,1,24,14,0,0,1,0
206,196,201,196,14,14,15,16,3,2,2,3,10,-5,5,0,-1,-1
890,886,886,881,18,17,18,16,2,2,2,1,4,0,5,1,-1,2
773,768,792,778,20,19,21,21,1,3,1,1,5,-24,14,1,-2,0
440,436,440,436,13,14,12,13,2,3,2,2,4,-4,4,-1,2,-1
764,754,754,754,13,14,12,13,2,2,2,1,10,0,0,-1,2,-1
496,398,393,393,14,16,18,16,3,1,2,1,98,5,0,-2,-2,2
356,356,356,351,20,19,18,18,3,1,1,2,0,0,5,1,1,0
721,721,721,717,20,19,20,18,1,2,2,2,0,0,4,1,-1,2
820,820,820,820,21,19,20,21,1,2,2,1,0,0,0,2,-1,-1
707,703,698,703,20,19,20,18,3,1,3,1,4,5,-5,1,-1,2
914,909,904,900,14,17,15,16,3,1,4,1,5,5,4,-3,2,-1
431,421,421,421,20,19,20,21,2,2,2,1,10,0,0,1,-1,-1
923,923,923,923,14,14,13,13,2,2,3,2,0,0,0,0,1,0
445,436,436,440,13,14,15,16,1,3,5,4,9,0,-4,-1,-1,-1
768,764,764,764,17,16,18,18,1,1,2,4,4,0,0,1,-2,0
886,867,857,862,14,14,13,13,1,1,1,3,19,10,-5,0,1,0
365,360,360,360,13,14,15,13,1,2,1,2,5,0,0,-1,-1,2
586,581,586,586,14,14,15,13,2,1,1,1,5,-5,0,0,-1,2
998,989,993,993,13,14,12,13,3,2,1,2,9,-4,0,-1,2,-1
253,239,234,220,14,14,15,13,1,1,2,2,14,5,14,0,-1,2
1040,1040,1040,1036,17,16,18,16,1,1,2,1,0,0,4,1,-2,2
576,571,567,562,21,19,20,18,1,2,1,2,5,4,5,2,-1,2
646,642,637,637,20,19,20,21,3,1,1,2,4,5,0,1,-1,-1
782,778,773,773,21,19,20,18,1,1,2,3,4,5,0,2,-1,2
567,553,548,548,18,17,18,16,2,2,3,3,14,5,0,1,-1,2
201,196,196,201,14,14,13,13,2,1,1,3,5,0,-5,0,1,0
1012,1003,1007,1003,20,19,20,21,1,2,2,1,9,-4,4,1,-1,-1
567,557,557,557,18,17,18,16,1,2,1,1,10,0,0,1,-1,2
464,454,454,454,13,14,12,13,1,2,2,1,10,0,0,-1,2,-1
417,412,417,412,13,14,15,13,1,3,2,2,5,-5,5,-1,-1,2
271,271,276,271,21,19,20,18,1,3,2,1,0,-5,5,2,-1,2
750,745,745,745,17,16,18,16,1,2,1,1,5,0,0,1,-2,2
698,698,693,689,20,19,20,21,1,3,1,2,0,5,4,1,-1,-1
314,318,309,309,14,17,15,16,2,2,1,1,-4,9,0,-3,2,-1
740,736,731,726,13,14,15,13,1,1,1,2,4,5,5,-1,-1,2
243,243,239,239,14,14,13,13,1,3,1,2,0,4,0,0,1,0
295,286,276,276,18,17,18,18,1,3,3,1,9,10,0,1,-1,0
960,956,960,965,20,19,20,18,3,2,1,1,4,-4,-5,1,-1,2
1073,1068,1068,1064,20,19,20,21,1,1,1,2,5,0,4,1,-1,-1
506,501,496,496,18,19,18,19,1,3,3,1,5,5,0,-1,1,-1
946,946,946,942,13,16,15,16,1,3,2,1,0,0,4,-3,1,-1
562,557,557,557,14,14,15,13,1,3,1,1,5,0,0,0,-1,2
815,810,810,815,21,19,20,21,2,1,1,1,5,0,-5,2,-1,-1
642,637,642,642,13,14,12,13,3,1,2,1,5,-5,0,-1,2,-1
928,923,923,923,14,14,13,13,1,2,3,1,5,0,0,0,1,0
384,379,379,379,17,16,18,18,3,2,1,1,5,0,0,1,-2,0
1026,1021,1007,1003,13,14,15,16,3,3,1,2,5,14,4,-1,-1,-1
651,651,651,651,13,16,15,16,1,3,2,1,0,0,0,-3,1,-1
365,360,360,356,13,14,12,13,2,2,2,2,5,0,4,-1,2,-1
815,810,806,806,18,17,18,19,1,2,3,1,5,4,0,1,-1,-1
417,407,417,407,20,19,20,21,1,6,2,2,10,-10,10,1,-1,-1
1045,1040,1040,1036,13,14,15,13,3,3,1,3,5,0,4,-1,-1,2
881,881,876,876,14,17,15,16,2,1,1,1,0,5,0,-3,2,-1
853,848,843,839,14,17,15,16,2,1,2,1,5,5,4,-3,2,-1
600,393,393,389,21,19,20,21,1,2,2,1,207,0,4,2,-1,-1
468,473,468,459,20,19,20,21,3,1,1,2,-5,5,9,1,-1,-1
496,501,496,492,14,14,13,13,1,1,2,2,-5,5,4,0,1,0
876,867,862,867,14,14,15,13,1,2,2,1,9,5,-5,0,-1,2
421,412,417,417,17,19,18,18,2,5,1,1,9,-5,0,-2,1,0
609,604,600,600,18,17,18,16,1,1,2,1,5,4,0,1,-1,2
576,562,562,562,18,19,18,18,1,5,1,1,14,0,0,-1,1,0
918,914,918,918,14,17,15,16,2,2,1,1,4,-4,0,-3,2,-1
665,660,660,665,17,16,18,18,3,3,1,3,5,0,-5,1,-2,0
187,182,182,182,18,17,18,19,1,1,1,1,5,0,0,1,-1,-1
946,946,946,942,17,16,18,16,1,1,2,1,0,0,4,1,-2,2
853,848,853,843,18,17,18,18,1,1,2,2,5,-5,10,1,-1,0
1078,1073,1073,1073,17,16,18,16,1,2,1,1,5,0,0,1,-2,2
257,253,253,248,18,17,18,16,1,1,2,4,4,0,5,1,-1,2
979,974,979,974,17,16,15,16,1,2,1,2,5,-5,5,1,1,-1
843,843,839,839,18,19,18,18,3,1,3,2,0,4,0,-1,1,0
824,824,824,820,18,17,18,16,1,3,2,2,0,0,4,1,-1,2
407,403,407,407,17,16,15,16,1,2,1,1,4,-4,0,1,1,-1
853,843,834,829,14,17,15,16,2,1,2,2,10,9,5,-3,2,-1
928,918,923,923,18,19,18,19,1,2,3,1,10,-5,0,-1,1,-1
600,595,595,590,18,19,18,19,1,3,2,1,5,0,5,-1,1,-1
328,323,328,323,14,14,15,16,1,2,1,2,5,-5,5,0,-1,-1
670,670,670,670,20,19,20,21,1,1,1,1,0,0,0,1,-1,-1
703,693,698,698,13,14,12,13,1,2,2,1,10,-5,0,-1,2,-1
276,276,271,267,18,17,18,16,2,3,1,4,0,5,4,1,-1,2
707,703,703,703,17,16,15,16,2,2,2,2,4,0,0,1,1,-1
1054,1054,1054,1050,17,16,15,16,3,1,2,1,0,0,4,1,1,-1
984,974,974,974,13,14,12,13,2,2,1,3,10,0,0,-1,2,-1
515,515,515,510,14,14,13,13,2,1,1,2,0,0,5,0,1,0
323,323,323,323,18,19,18,19,1,1,2,3,0,0,0,-1,1,-1
787,754,754,754,14,14,15,13,1,2,2,1,33,0,0,0,-1,2
318,309,304,300,14,14,13,13,2,3,4,2,9,5,4,0,1,0
623,623,623,632,14,14,13,13,1,1,2,2,0,0,-9,0,1,0
928,918,923,918,18,19,18,19,1,2,1,2,10,-5,5,-1,1,-1
450,407,454,445,20,19,20,21,1,1,4,2,43,-47,9,1,-1,-1
295,295,295,290,18,19,18,19,1,2,2,1,0,0,5,-1,1,-1
248,239,239,239,18,19,18,18,1,2,2,1,9,0,0,-1,1,0
1064,1054,1054,1054,13,14,15,13,3,2,3,4,10,0,0,-1,-1,2
689,689,684,684,20,19,20,21,1,1,1,1,0,5,0,1,-1,-1
843,843,839,839,21,19,20,21,2,1,1,1,0,4,0,2,-1,-1
689,618,614,609,13,14,15,13,1,1,2,2,71,4,5,-1,-1,2
876,871,867,857,18,19,18,18,2,1,1,2,5,4,10,-1,1,0
745,740,736,740,20,19,20,21,1,1,1,1,5,4,-4,1,-1,-1
623,618,623,618,14,14,15,13,1,1,1,3,5,-5,5,0,-1,2
614,600,595,595,14,14,15,13,2,3,2,1,14,5,0,0,-1,2
942,937,937,942,17,19,18,18,2,1,3,1,5,0,-5,-2,1,0
224,220,224,220,14,14,15,16,2,2,4,1,4,-4,4,0,-1,-1
989,989,989,989,17,16,18,16,1,2,4,1,0,0,0,1,-2,2
487,492,496,487,14,14,13,13,1,3,1,1,-5,-4,9,0,1,0
600,496,492,496,14,17,15,16,2,2,1,1,104,4,-4,-3,2,-1
679,670,674,674,20,19,18,18,3,2,3,1,9,-4,0,1,1,0
862,857,862,857,14,17,15,16,1,2,2,1,5,-5,5,-3,2,-1
482,478,478,473,18,19,18,18,1,1,2,1,4,0,5,-1,1,0
590,586,590,590,21,19,20,19,2,3,2,1,4,-4,0,2,-1,1
731,731,731,731,17,16,18,16,1,2,1,1,0,0,0,1,-2,2
464,459,459,459,17,16,18,18,2,2,1,1,5,0,0,1,-2,0
731,721,820,726,17,16,20,16,1,1,1,1,10,-99,94,1,-4,4
524,520,520,515,14,17,15,16,3,3,2,2,4,0,5,-3,2,-1
665,660,660,656,17,16,18,16,1,2,2,1,5,0,4,1,-2,2
876,867,867,862,18,17,18,18,1,2,1,1,9,0,5,1,-1,0
403,398,403,398,17,16,18,16,3,2,2,1,5,-5,5,1,-2,2
1017,1007,1007,1007,17,16,15,16,2,2,1,1,10,0,0,1,1,-1
342,342,342,337,17,19,18,18,2,3,2,2,0,0,5,-2,1,0
693,693,689,693,20,19,20,21,1,1,1,1,0,4,-4,1,-1,-1
262,262,262,257,18,19,18,18,1,1,3,2,0,0,5,-1,1,0
970,965,965,956,17,16,18,16,1,4,2,2,5,0,9,1,-2,2
239,248,243,239,14,14,15,13,3,1,2,4,-9,5,4,0,-1,2
665,660,660,660,17,16,18,18,2,2,2,1,5,0,0,1,-2,0
590,586,581,586,21,19,20,21,1,1,1,1,4,5,-5,2,-1,-1
436,431,426,426,13,14,12,13,3,1,1,1,5,5,0,-1,2,-1
412,403,403,393,20,19,20,21,1,2,2,2,9,0,10,1,-1,-1
201,196,196,196,14,17,15,16,3,2,2,1,5,0,0,-3,2,-1
445,440,445,436,17,16,18,18,3,2,2,2,5,-5,9,1,-2,0
642,637,637,632,13,14,12,13,1,3,2,1,5,0,5,-1,2,-1
834,829,820,820,18,17,18,19,1,2,1,1,5,9,0,1,-1,-1
224,215,215,210,14,17,15,16,1,2,2,2,9,0,5,-3,2,-1
553,553,553,548,14,14,13,13,3,2,3,1,0,0,5,0,1,0
646,642,642,642,17,19,18,18,3,2,3,1,4,0,0,-2,1,0
379,379,374,374,17,16,15,16,2,1,2,1,0,5,0,1,1,-1
881,867,862,867,14,14,15,13,3,3,1,1,14,5,-5,0,-1,2
506,510,506,501,18,17,18,19,2,3,2,1,-4,4,5,1,-1,-1
290,290,286,290,14,14,13,13,2,3,3,1,0,4,-4,0,1,0
1064,1064,1064,1064,13,14,15,13,3,3,1,2,0,0,0,-1,-1,2
750,750,750,745,17,16,18,18,1,2,1,2,0,0,5,1,-2,0
1059,1059,1059,1054,13,14,12,13,3,3,3,1,0,0,5,-1,2,-1
192,182,187,187,18,19,18,19,2,2,2,1,10,-5,0,-1,1,-1
323,318,318,318,18,17,18,16,1,2,1,3,5,0,0,1,-1,2
450,440,436,440,17,16,18,16,1,2,3,1,10,4,-4,1,-2,2
356,351,351,356,13,14,15,16,1,2,1,1,5,0,-5,-1,-1,-1
450,445,459,468,20,19,18,18,1,1,2,1,5,-14,-9,1,1,0
543,646,539,539,18,16,18,18,4,1,1,1,-103,107,0,2,-2,0
679,670,674,665,13,14,12,13,2,2,2,2,9,-4,9,-1,2,-1
337,328,328,328,13,14,13,13,2,1,1,1,9,0,0,-1,1,0
187,182,196,182,21,19,21,21,3,1,3,1,5,-14,14,2,-2,0
571,571,571,567,21,19,20,21,3,1,1,2,0,0,4,2,-1,-1
524,524,524,524,14,14,15,13,2,1,2,2,0,0,0,0,-1,2
674,670,674,670,13,14,12,13,1,2,5,1,4,-4,4,-1,2,-1
407,412,407,407,17,19,18,18,3,1,2,1,-5,5,0,-2,1,0
262,262,262,262,18,17,18,18,1,3,3,1,0,0,0,1,-1,0
951,937,937,932,13,14,15,13,1,2,2,1,14,0,5,-1,-1,2
295,295,295,290,18,19,18,19,2,1,2,1,0,0,5,-1,1,-1
871,862,857,857,18,19,18,18,1,3,1,1,9,5,0,-1,1,0
267,267,267,267,14,14,13,13,1,1,3,5,0,0,0,0,1,0
318,318,323,318,14,17,15,16,2,2,2,3,0,-5,5,-3,2,-1
187,182,182,182,18,19,18,19,2,1,1,1,5,0,0,-1,1,-1
1064,1064,1059,1059,13,16,15,16,1,1,1,1,0,5,0,-3,1,-1
651,646,651,651,17,16,15,16,1,2,2,1,5,-5,0,1,1,-1
342,337,337,323,13,14,12,13,1,1,2,2,5,0,14,-1,2,-1
468,468,473,468,13,14,12,13,1,1,2,2,0,-5,5,-1,2,-1
510,506,506,506,18,19,18,19,1,1,1,1,4,0,0,-1,1,-1
736,731,736,792,20,19,20,19,2,1,5,1,5,-5,-56,1,-1,1
867,862,862,857,14,14,15,13,1,1,1,2,5,0,5,0,-1,2
257,192,196,196,18,17,18,19,2,2,1,1,65,-4,0,1,-1,-1
562,557,557,553,18,17,18,18,3,2,1,3,5,0,4,1,-1,0
426,412,403,403,13,14,12,13,1,3,1,1,14,9,0,-1,2,-1
614,600,590,595,14,14,13,13,1,2,2,1,14,10,-5,0,1,0
651,646,646,646,20,19,20,18,2,3,1,1,5,0,0,1,-1,2
384,379,379,379,17,16,18,18,1,5,1,1,5,0,0,1,-2,0
421,421,421,421,20,19,20,18,3,3,1,1,0,0,0,1,-1,2
614,609,604,600,18,19,18,19,1,2,1,1,5,5,4,-1,1,-1
304,290,290,281,14,14,15,13,1,3,2,1,14,0,9,0,-1,2
248,243,239,234,14,17,15,16,2,1,2,1,5,4,5,-3,2,-1
496,496,492,496,18,19,18,19,1,1,3,1,0,4,-4,-1,1,-1
286,281,281,281,14,14,13,13,1,2,2,1,5,0,0,0,1,0
853,843,848,848,21,19,20,18,1,1,1,1,10,-5,0,2,-1,2
374,370,374,374,17,16,18,18,3,2,2,3,4,-4,0,1,-2,0
337,337,337,332,13,14,12,13,1,1,2,1,0,0,5,-1,2,-1
182,1078,1078,1078,21,19,20,21,1,1,1,1,-896,0,0,2,-1,-1
379,374,374,370,17,16,15,16,2,2,1,2,5,0,4,1,1,-1
1073,1068,1078,1068,13,14,15,13,2,1,2,3,5,-10,10,-1,-1,2
731,731,726,726,20,19,20,21,2,1,2,1,0,5,0,1,-1,-1
745,745,745,745,13,14,12,13,1,3,2,1,0,0,0,-1,2,-1
1007,993,989,989,13,14,12,13,1,2,3,1,14,4,0,-1,2,-1
689,674,689,684,20,19,20,18,2,2,2,1,15,-15,5,1,-1,2
262,262,257,262,18,17,18,16,2,1,3,3,0,5,-5,1,-1,2
581,571,571,567,14,14,15,13,1,1,2,3,10,0,4,0,-1,2
909,904,909,904,18,17,18,16,3,1,1,1,5,-5,5,1,-1,2
609,600,590,586,14,14,13,13,2,1,1,2,9,10,4,0,1,0
318,309,314,309,21,19,21,19,2,2,1,1,9,-5,5,2,-2,2
468,464,464,464,13,14,12,13,2,2,2,1,4,0,0,-1,2,-1
1031,1017,1017,1012,17,19,18,18,1,2,2,1,14,0,5,-2,1,0
848,848,848,843,21,19,20,18,2,1,1,2,0,0,5,2,-1,2
586,567,567,562,18,19,18,18,3,2,3,1,19,0,5,-1,1,0
403,398,393,393,17,16,18,16,2,1,1,2,5,5,0,1,-2,2
351,342,346,342,13,14,12,13,2,3,2,1,9,-4,4,-1,2,-1
300,295,300,295,14,14,13,13,3,3,2,2,5,-5,5,0,1,0
309,304,304,304,18,19,18,19,3,2,4,1,5,0,0,-1,1,-1
356,351,351,351,20,19,20,21,3,1,1,1,5,0,0,1,-1,-1
323,304,300,304,14,14,13,13,3,1,1,1,19,4,-4,0,1,0
886,881,881,881,18,19,18,19,1,2,1,1,5,0,0,-1,1,-1
792,792,792,792,18,17,18,19,3,1,2,1,0,0,0,1,-1,-1
248,243,243,243,14,14,15,16,2,3,1,1,5,0,0,0,-1,-1
501,496,496,496,21,19,21,19,3,2,1,1,5,0,0,2,-2,2
323,300,300,300,14,14,15,13,1,1,1,1,23,0,0,0,-1,2
201,187,187,192,18,17,18,19,3,2,3,1,14,0,-5,1,-1,-1
398,393,398,398,20,19,20,21,1,2,1,1,5,-5,0,1,-1,-1
871,871,867,867,14,17,15,16,2,3,2,4,0,4,0,-3,2,-1
867,857,857,857,21,19,20,18,1,3,1,1,10,0,0,2,-1,2
857,857,857,857,14,14,15,13,3,1,4,1,0,0,0,0,-1,2
220,215,215,210,14,17,15,16,1,2,1,2,5,0,5,-3,2,-1
421,412,421,412,20,19,20,18,4,2,1,2,9,-9,9,1,-1,2
820,815,820,815,18,19,18,19,2,2,2,1,5,-5,5,-1,1,-1
506,496,693,482,18,19,20,19,3,5,1,1,10,-197,211,-1,-1,1
374,365,365,365,13,16,15,16,2,2,3,1,9,0,0,-3,1,-1
867,867,862,862,14,14,15,16,3,3,3,1,0,5,0,0,-1,-1
445,440,436,436,13,16,15,16,2,1,3,1,5,4,0,-3,1,-1
1017,1012,1012,1012,20,19,20,21,3,3,1,1,5,0,0,1,-1,-1
951,951,951,951,17,19,18,18,2,2,3,1,0,0,0,-2,1,0
998,993,998,993,20,19,20,18,1,2,2,2,5,-5,5,1,-1,2
548,543,539,543,18,17,18,18,2,2,1,1,5,4,-4,1,-1,0
590,590,586,586,14,14,13,13,4,3,3,2,0,4,0,0,1,0
426,421,421,417,13,14,15,13,1,2,2,2,5,0,4,-1,-1,2
510,492,482,482,14,14,13,13,2,2,1,1,18,10,0,0,1,0
703,698,703,703,20,19,20,21,3,1,2,3,5,-5,0,1,-1,-1
539,534,684,529,21,19,23,21,2,1,1,1,5,-150,155,2,-4,2
843,834,834,834,14,17,15,16,2,1,1,1,9,0,0,-3,2,-1
796,801,796,796,21,19,21,19,3,5,1,3,-5,5,0,2,-2,2
562,553,553,553,18,17,18,16,1,1,2,1,9,0,0,1,-1,2
600,595,600,600,14,17,15,16,1,2,4,1,5,-5,0,-3,2,-1
234,224,229,220,14,14,15,16,1,4,4,2,10,-5,9,0,-1,-1
229,224,215,215,21,19,20,21,1,1,1,1,5,9,0,2,-1,-1
834,824,824,824,18,17,18,19,1,2,3,1,10,0,0,1,-1,-1
576,571,576,567,14,14,15,13,1,1,1,2,5,-5,9,0,-1,2
201,192,192,187,14,17,15,16,3,2,1,3,9,0,5,-3,2,-1
839,829,824,829,14,14,13,13,1,3,3,3,10,5,-5,0,1,0
642,637,642,637,17,16,18,18,1,2,2,1,5,-5,5,1,-2,0
998,989,998,998,20,19,20,21,1,4,1,1,9,-9,0,1,-1,-1
815,810,815,810,21,19,20,21,3,1,2,1,5,-5,5,2,-1,-1
398,389,389,393,17,19,18,18,3,2,3,3,9,0,-4,-2,1,0
464,454,459,459,13,14,12,13,3,2,2,2,10,-5,0,-1,2,-1
637,632,637,637,20,19,20,18,1,2,1,1,5,-5,0,1,-1,2
768,764,759,754,20,19,18,18,3,3,2,2,4,5,5,1,1,0
492,492,492,492,14,14,15,16,2,3,2,1,0,0,0,0,-1,-1
726,717,721,717,13,14,12,13,2,4,2,2,9,-4,4,-1,2,-1
1031,1026,1026,1036,20,19,20,18,3,2,1,1,5,0,-10,1,-1,2
215,215,210,215,18,17,18,19,2,1,1,1,0,5,-5,1,-1,-1
759,750,745,736,17,16,15,16,2,1,1,2,9,5,9,1,1,-1
267,257,262,262,18,19,18,18,1,1,1,3,10,-5,0,-1,1,0
506,506,501,501,14,17,15,16,1,1,1,1,0,5,0,-3,2,-1
918,914,909,909,18,17,18,16,3,4,3,1,4,5,0,1,-1,2
318,314,314,309,14,14,13,13,2,3,2,3,4,0,5,0,1,0
342,337,337,332,20,19,18,18,2,1,1,2,5,0,5,1,1,0
1031,1026,1026,1026,13,16,15,16,2,2,1,1,5,0,0,-3,1,-1
1059,1059,192,206,20,19,21,21,2,1,1,2,0,867,-14,1,-2,0
707,703,703,703,20,19,18,18,1,2,2,1,4,0,0,1,1,0
356,351,351,351,17,16,15,16,2,4,1,1,5,0,0,1,1,-1
848,843,834,834,14,17,15,16,2,2,1,1,5,9,0,-3,2,-1
796,787,787,787,18,17,18,19,3,2,1,1,9,0,0,1,-1,-1
932,923,923,923,17,17,18,19,1,3,1,1,9,0,0,0,-1,-1
318,318,318,314,14,14,15,13,4,3,2,1,0,0,4,0,-1,2
506,646,496,492,18,14,18,19,2,1,2,2,-140,150,4,4,-4,-1
576,567,567,571,21,19,20,18,3,2,1,1,9,0,-4,2,-1,2
1031,1017,1021,1021,17,16,15,16,1,2,2,1,14,-4,0,1,1,-1
290,281,276,271,14,14,15,16,1,1,2,2,9,5,5,0,-1,-1
342,332,323,323,20,19,18,19,2,1,1,2,10,9,0,1,1,-1
754,750,745,745,17,16,15,16,1,3,2,1,4,5,0,1,1,-1
1007,1003,1003,1003,13,14,15,13,1,4,1,1,4,0,0,-1,-1,2
904,895,881,890,21,19,20,19,3,1,3,1,9,14,-9,2,-1,1
215,210,206,201,14,14,15,13,2,2,1,2,5,4,5,0,-1,2
510,506,506,506,14,17,15,16,3,1,1,3,4,0,0,-3,2,-1
689,684,679,689,20,19,20,18,1,1,1,1,5,5,-10,1,-1,2
928,918,928,932,21,19,21,18,1,2,1,1,10,-10,-4,2,-2,3
960,960,956,956,13,14,12,13,2,3,1,1,0,4,0,-1,2,-1
604,600,604,604,21,19,20,19,2,2,2,1,4,-4,0,2,-1,1
450,440,440,431,13,14,12,13,1,3,2,1,10,0,9,-1,2,-1
586,576,576,567,14,14,15,16,2,1,2,1,10,0,9,0,-1,-1
464,454,454,454,20,19,20,18,1,2,1,1,10,0,0,1,-1,2
843,843,848,843,18,19,18,18,4,2,2,1,0,-5,5,-1,1,0
224,210,206,206,14,14,13,13,2,2,1,1,14,4,0,0,1,0
923,900,918,937,14,17,15,16,2,2,2,1,23,-18,-19,-3,2,-1
543,534,529,524,14,14,15,16,1,2,3,2,9,5,5,0,-1,-1
187,182,1078,1078,18,19,18,18,1,1,1,1,5,-896,0,-1,1,0
276,271,276,267,14,17,15,16,3,2,2,2,5,-5,9,-3,2,-1
1003,993,998,993,17,16,18,16,2,1,2,2,10,-5,5,1,-2,2
271,267,267,257,18,17,18,16,2,2,4,2,4,0,10,1,-1,2
824,820,815,815,14,14,13,13,3,1,1,1,4,5,0,0,1,0
192,182,182,182,18,19,18,19,3,1,1,1,10,0,0,-1,1,-1
337,332,328,323,13,14,15,16,2,1,1,2,5,4,5,-1,-1,-1
224,224,224,220,21,19,20,21,2,1,1,2,0,0,4,2,-1,-1
318,314,309,309,18,17,18,16,1,1,1,2,4,5,0,1,-1,2
740,740,736,736,20,19,18,18,2,1,3,2,0,4,0,1,1,0
956,951,946,946,20,19,20,21,1,1,1,1,5,5,0,1,-1,-1
342,276,286,276,17,17,18,18,1,2,5,2,66,-10,10,0,-1,0
764,750,750,750,13,16,15,16,2,2,1,3,14,0,0,-3,1,-1
426,421,421,421,17,19,18,18,1,2,1,1,5,0,0,-2,1,0
529,529,524,524,18,19,18,19,2,1,3,2,0,5,0,-1,1,-1
318,314,318,314,14,14,13,13,1,2,2,2,4,-4,4,0,1,0
979,974,984,989,17,19,18,18,1,2,1,1,5,-10,-5,-2,1,0
792,787,787,787,21,19,21,21,1,2,1,1,5,0,0,2,-2,0
239,234,234,229,14,14,15,16,1,2,1,2,5,0,5,0,-1,-1
707,698,693,693,17,19,18,18,3,1,1,1,9,5,0,-2,1,0
1059,1050,1045,1045,20,19,20,18,1,3,1,1,9,5,0,1,-1,2
206,196,201,201,14,14,13,13,2,2,1,2,10,-5,0,0,1,0
586,576,581,576,14,14,15,13,1,2,2,1,10,-5,5,0,-1,2
974,979,965,970,20,19,18,18,2,5,1,1,-5,14,-5,1,1,0
600,595,586,586,18,19,18,19,1,3,1,1,5,9,0,-1,1,-1
196,182,187,182,14,14,15,13,1,2,2,1,14,-5,5,0,-1,2
824,820,820,815,14,14,15,13,2,1,1,2,4,0,5,0,-1,2
206,187,192,192,18,19,18,19,3,2,1,2,19,-5,0,-1,1,-1
468,464,464,468,13,14,12,13,3,2,2,1,4,0,-4,-1,2,-1
946,937,937,932,13,14,12,13,1,1,2,1,9,0,5,-1,2,-1
567,567,567,562,14,14,13,13,3,2,2,2,0,0,5,0,1,0
360,356,360,360,20,19,20,18,1,2,1,1,4,-4,0,1,-1,2
1059,1054,1054,1050,20,19,18,18,3,2,2,2,5,0,4,1,1,0
1059,1054,1050,1050,17,16,15,16,2,1,2,1,5,4,0,1,1,-1
740,689,679,674,13,14,15,13,2,2,3,1,51,10,5,-1,-1,2
759,750,750,750,17,16,18,18,3,2,1,1,9,0,0,1,-2,0
210,206,206,206,14,14,15,13,4,3,2,2,4,0,0,0,-1,2
389,374,374,374,13,14,15,13,1,2,2,2,15,0,0,-1,-1,2
426,421,426,417,13,14,15,13,2,3,3,4,5,-5,9,-1,-1,2
923,914,914,909,14,17,15,16,1,3,2,1,9,0,5,-3,2,-1
890,881,890,886,14,17,15,16,2,1,2,1,9,-9,4,-3,2,-1
773,764,759,759,13,14,12,13,2,1,1,2,9,5,0,-1,2,-1
895,895,895,895,14,14,15,16,1,2,1,1,0,0,0,0,-1,-1
257,248,239,229,14,14,15,13,1,4,1,2,9,9,10,0,-1,2
651,646,646,646,13,14,12,13,1,2,3,1,5,0,0,-1,2,-1
590,586,581,586,18,19,18,19,1,2,1,1,4,5,-5,-1,1,-1
1031,1031,1026,1026,20,19,18,18,1,1,2,1,0,5,0,1,1,0
337,332,328,328,13,14,15,13,2,1,1,1,5,4,0,-1,-1,2
890,890,890,886,14,14,15,13,2,3,2,3,0,0,4,0,-1,2
1031,1026,1031,1031,13,14,12,13,2,2,2,2,5,-5,0,-1,2,-1
773,773,778,768,13,14,15,13,1,2,2,1,0,-5,10,-1,-1,2
201,201,196,196,14,14,15,16,2,3,1,1,0,5,0,0,-1,-1
262,257,262,257,14,14,13,13,2,2,2,2,5,-5,5,0,1,0
210,206,201,201,18,17,18,19,3,2,1,1,4,5,0,1,-1,-1
286,286,286,281,14,14,13,13,2,3,4,2,0,0,5,0,1,0
796,787,787,782,18,17,18,19,4,2,1,2,9,0,5,1,-1,-1
478,473,468,468,13,14,15,13,2,1,1,1,5,5,0,-1,-1,2
300,295,295,295,21,19,20,21,1,1,1,1,5,0,0,2,-1,-1
614,604,609,609,14,17,15,16,3,3,2,1,10,-5,0,-3,2,-1
745,740,740,876,17,16,18,18,4,2,1,1,5,0,-136,1,-2,0
379,379,374,370,20,19,18,18,2,3,3,2,0,5,4,1,1,0
1021,1012,1017,1012,20,19,20,18,1,1,2,2,9,-5,5,1,-1,2
487,464,450,450,14,14,15,13,2,2,1,1,23,14,0,0,-1,2
848,848,848,843,14,17,15,16,1,2,2,2,0,0,5,-3,2,-1
253,234,234,229,14,14,15,13,1,2,2,2,19,0,5,0,-1,2
431,417,426,426,13,14,12,13,2,2,1,2,14,-9,0,-1,2,-1
754,745,740,745,13,14,15,13,2,2,2,2,9,5,-5,-1,-1,2
989,989,989,984,17,16,15,16,3,2,2,2,0,0,5,1,1,-1
853,853,848,848,18,19,18,18,1,3,1,2,0,5,0,-1,1,0
379,379,374,374,20,19,18,18,1,5,1,1,0,5,0,1,1,0
684,679,679,679,17,16,18,18,2,2,1,1,5,0,0,1,-2,0
459,454,454,450,17,16,18,18,3,2,2,1,5,0,4,1,-2,0
834,829,248,824,18,19,23,19,2,1,1,1,5,581,-576,-1,-4,4
970,956,965,960,13,14,12,13,1,2,1,1,14,-9,5,-1,2,-1
586,586,586,586,14,14,15,16,4,2,2,1,0,0,0,0,-1,-1
689,684,689,684,20,19,20,18,1,1,1,2,5,-5,5,1,-1,2
764,759,754,750,20,19,20,18,1,3,1,2,5,5,4,1,-1,2
642,642,637,637,13,14,12,13,2,2,1,3,0,5,0,-1,2,-1
900,895,895,890,18,19,18,19,1,1,2,2,5,0,5,-1,1,-1
529,520,524,524,18,17,18,19,3,4,2,1,9,-4,0,1,-1,-1
614,609,609,614,14,17,15,16,3,2,1,2,5,0,-5,-3,2,-1
876,862,867,862,18,19,18,18,1,2,1,2,14,-5,5,-1,1,0
351,346,346,346,13,14,12,13,3,3,2,5,5,0,0,-1,2,-1
801,796,792,792,14,14,13,13,3,3,1,2,5,4,0,0,1,0
224,215,220,215,14,14,15,13,2,2,4,2,9,-5,5,0,-1,2
201,196,192,192,21,19,21,19,1,2,1,2,5,4,0,2,-2,2
754,754,750,750,13,14,12,13,2,2,1,1,0,4,0,-1,2,-1
890,895,890,886,14,14,13,13,2,3,2,2,-5,5,4,0,1,0
993,989,989,989,20,19,20,18,1,1,1,2,4,0,0,1,-1,2
318,295,286,276,14,14,15,13,1,3,1,1,23,9,10,0,-1,2
496,492,487,487,14,14,13,13,1,3,3,2,4,5,0,0,1,0
501,496,501,496,18,19,18,19,2,2,2,1,5,-5,5,-1,1,-1
215,206,206,206,14,14,13,13,2,2,3,2,9,0,0,0,1,0
553,548,553,548,14,14,13,13,2,2,2,1,5,-5,5,0,1,0
1036,1036,1031,1036,17,16,18,16,1,3,3,3,0,5,-5,1,-2,2
520,515,515,510,18,19,18,19,1,2,2,3,5,0,5,-1,1,-1
482,473,473,473,14,16,15,16,2,2,2,1,9,0,0,-2,1,-1
450,440,431,431,13,14,12,13,3,2,1,1,10,9,0,-1,2,-1
862,857,857,853,14,17,15,16,3,1,1,2,5,0,4,-3,2,-1
210,201,201,196,14,14,13,13,1,6,2,1,9,0,5,0,1,0
942,937,937,937,17,16,15,16,3,2,2,2,5,0,0,1,1,-1
431,421,431,436,17,16,18,16,3,3,3,1,10,-10,-5,1,-2,2
1045,1040,1040,1036,20,19,20,18,1,1,1,2,5,0,4,1,-1,2
520,520,515,515,14,14,13,13,2,3,2,2,0,5,0,0,1,0
684,684,684,679,13,16,15,16,2,2,3,1,0,0,5,-3,1,-1
829,815,815,815,14,14,15,13,2,2,2,2,14,0,0,0,-1,2
234,229,229,229,18,17,18,19,1,2,1,1,5,0,0,1,-1,-1
1026,1021,1012,1012,13,14,15,16,3,3,3,2,5,9,0,-1,-1,-1
993,989,993,989,20,19,20,18,2,2,2,2,4,-4,4,1,-1,2
1026,1017,1012,1012,13,14,15,13,5,1,4,1,9,5,0,-1,-1,2
609,604,600,600,21,19,20,19,2,2,1,1,5,4,0,2,-1,1
543,534,534,534,18,17,18,18,1,2,3,1,9,0,0,1,-1,0
703,703,698,698,20,19,20,18,2,1,1,1,0,5,0,1,-1,2
351,346,346,346,13,16,15,16,3,2,2,1,5,0,0,-3,1,-1
1059,1054,1045,1054,20,19,18,18,1,1,2,1,5,9,-9,1,1,0
914,909,909,909,18,17,18,19,1,1,1,1,5,0,0,1,-1,-1
984,984,984,979,17,16,18,16,3,1,1,1,0,0,5,1,-2,2
707,703,703,703,13,14,12,13,1,2,1,1,4,0,0,-1,2,-1
374,370,370,370,13,16,15,16,1,1,1,1,4,0,0,-3,1,-1
956,951,946,946,20,19,18,18,2,1,1,1,5,5,0,1,1,0
562,553,543,543,14,14,15,13,1,3,3,2,9,10,0,0,-1,2
539,534,534,529,14,14,13,13,2,1,2,1,5,0,5,0,1,0
876,867,857,857,14,14,13,13,1,3,3,1,9,10,0,0,1,0
267,267,262,262,18,19,18,18,1,2,1,2,0,5,0,-1,1,0
923,918,923,923,18,19,18,19,3,2,4,1,5,-5,0,-1,1,-1
586,571,567,562,18,17,18,16,2,2,1,2,15,4,5,1,-1,2
571,562,557,548,18,17,15,18,3,3,3,3,9,5,9,1,2,-3
478,473,473,468,13,14,15,13,2,3,2,1,5,0,5,-1,-1,2
937,932,937,932,17,16,15,16,1,1,2,1,5,-5,5,1,1,-1
314,300,576,290,14,17,15,16,2,3,1,2,14,-276,286,-3,2,-1
417,412,412,407,17,16,18,16,3,3,1,2,5,0,5,1,-2,2
389,384,384,384,13,14,12,13,3,3,3,3,5,0,0,-1,2,-1
843,843,843,839,14,17,15,16,1,2,2,2,0,0,4,-3,2,-1
323,323,323,323,18,19,18,19,2,1,2,1,0,0,0,-1,1,-1
609,609,600,600,18,17,18,19,2,1,2,1,0,9,0,1,-1,-1
843,839,839,839,14,17,15,16,1,1,2,1,4,0,0,-3,2,-1
309,300,295,295,14,14,15,13,2,3,1,3,9,5,0,0,-1,2
637,623,628,628,20,19,21,21,2,2,1,1,14,-5,0,1,-2,0
773,768,768,764,13,14,15,13,1,3,2,1,5,0,4,-1,-1,2
239,239,239,234,21,19,20,21,2,1,1,2,0,0,5,2,-1,-1
895,881,886,886,14,14,13,13,1,2,1,3,14,-5,0,0,1,0
520,520,520,515,14,14,15,13,2,1,2,1,0,0,5,0,-1,2
1059,1054,1054,1050,17,16,18,16,1,3,3,2,5,0,4,1,-2,2
1012,1003,1003,998,13,14,15,13,2,2,2,2,9,0,5,-1,-1,2
1045,1045,1045,1040,17,16,18,18,1,1,3,2,0,0,5,1,-2,0
932,923,928,923,17,17,18,19,1,2,1,2,9,-5,5,0,-1,-1
857,848,848,848,14,14,15,13,2,1,2,2,9,0,0,0,-1,2
914,909,909,909,21,19,21,19,2,1,1,1,5,0,0,2,-2,2
656,646,646,642,13,14,12,13,2,3,1,2,10,0,4,-1,2,-1
595,595,590,590,21,19,20,19,2,2,1,3,0,5,0,2,-1,1
750,745,750,750,20,19,20,21,1,2,2,1,5,-5,0,1,-1,-1
890,886,886,886,18,17,18,19,1,2,1,1,4,0,0,1,-1,-1
581,581,581,581,18,17,18,16,1,2,1,1,0,0,0,1,-1,2
389,398,384,384,17,16,18,16,1,2,3,3,-9,14,0,1,-2,2
281,271,271,271,18,19,18,18,3,1,1,1,10,0,0,-1,1,0
464,464,464,464,17,16,18,16,1,2,1,1,0,0,0,1,-2,2
1036,1021,1012,1012,13,14,12,13,1,2,1,2,15,9,0,-1,2,-1
590,581,590,600,14,17,15,16,2,1,1,1,9,-9,-10,-3,2,-1
614,614,614,614,14,14,15,13,2,2,3,3,0,0,0,0,-1,2
337,328,337,337,20,19,20,21,2,1,2,1,9,-9,0,1,-1,-1
337,323,328,328,20,19,18,19,2,2,1,1,14,-5,0,1,1,-1
989,979,989,984,20,19,20,21,3,1,3,3,10,-10,5,1,-1,-1
703,698,703,703,20,19,20,18,3,1,2,1,5,-5,0,1,-1,2
407,398,398,393,13,14,15,13,1,2,2,3,9,0,5,-1,-1,2
895,890,890,890,14,14,13,13,1,3,1,2,5,0,0,0,1,0
712,712,707,712,13,14,12,13,1,4,1,1,0,5,-5,-1,2,-1
389,384,379,384,20,19,20,18,2,3,1,1,5,5,-5,1,-1,2
1040,1040,1040,1040,13,14,15,13,1,3,2,1,0,0,0,-1,-1,2
600,586,590,586,21,19,20,21,3,2,2,1,14,-4,4,2,-1,-1
417,412,412,412,13,14,12,13,1,1,1,1,5,0,0,-1,2,-1
562,548,539,534,18,17,18,18,1,2,5,2,14,9,5,1,-1,0
979,974,979,965,13,14,12,13,2,3,4,2,5,-5,14,-1,2,-1
239,239,239,234,14,14,13,13,1,2,1,2,0,0,5,0,1,0
853,834,815,806,14,14,13,13,3,3,1,1,19,19,9,0,1,0
267,262,262,286,18,19,18,19,2,2,2,1,5,0,-24,-1,1,-1
337,332,328,323,17,16,15,16,2,1,2,2,5,4,5,1,1,-1
618,604,604,604,14,14,13,13,2,2,1,1,14,0,0,0,1,0
276,271,267,262,18,17,18,18,3,3,1,2,5,4,5,1,-1,0
693,684,689,689,20,19,20,18,3,2,1,2,9,-5,0,1,-1,2
201,182,192,182,14,14,13,13,3,2,2,1,19,-10,10,0,1,0
937,942,942,937,13,14,15,13,1,3,2,2,-5,0,5,-1,-1,2
698,693,693,693,20,19,20,21,3,1,1,1,5,0,0,1,-1,-1
923,914,909,909,14,14,13,13,1,2,2,1,9,5,0,0,1,0
1012,1012,1017,1012,20,19,20,18,1,1,1,1,0,-5,5,1,-1,2
862,857,853,843,14,14,15,13,3,2,1,2,5,4,10,0,-1,2
374,370,370,365,17,16,18,18,3,1,1,1,4,0,5,1,-2,0
998,993,989,989,17,16,15,16,1,3,3,1,5,4,0,1,1,-1
750,740,745,740,20,19,20,21,2,2,1,1,10,-5,5,1,-1,-1
989,984,984,989,13,14,15,13,2,3,1,3,5,0,-5,-1,-1,2
576,571,571,571,18,19,18,18,1,1,3,1,5,0,0,-1,1,0
1059,1059,1059,1054,13,14,12,13,1,3,1,2,0,0,5,-1,2,-1
229,220,220,220,14,14,15,16,1,4,2,1,9,0,0,0,-1,-1
637,632,632,632,17,19,18,18,1,1,1,1,5,0,0,-2,1,0
839,824,824,824,14,14,13,13,1,2,1,1,15,0,0,0,1,0
820,806,815,820,14,14,15,13,2,2,2,1,14,-9,-5,0,-1,2
431,426,426,431,20,19,20,21,1,2,1,1,5,0,-5,1,-1,-1
998,989,534,974,17,16,15,16,3,2,1,2,9,455,-440,1,1,-1
914,909,909,904,21,19,21,19,1,3,1,2,5,0,5,2,-2,2
243,234,229,229,14,14,13,13,3,1,1,2,9,5,0,0,1,0
914,909,909,909,21,19,21,21,2,2,1,1,5,0,0,2,-2,0
562,529,557,557,18,14,18,16,1,1,1,2,33,-28,0,4,-4,2
482,473,473,473,14,14,15,16,1,2,1,1,9,0,0,0,-1,-1
520,510,515,515,14,14,15,13,1,2,1,1,10,-5,0,0,-1,2
360,356,356,351,20,19,20,21,2,3,2,1,4,0,5,1,-1,-1
853,853,848,848,21,19,20,21,2,3,1,1,0,5,0,2,-1,-1
843,834,839,834,14,14,15,13,1,2,2,1,9,-5,5,0,-1,2
300,290,286,290,18,17,18,19,2,2,1,1,10,4,-4,1,-1,-1
960,956,960,956,17,16,15,16,3,1,2,1,4,-4,4,1,1,-1
543,534,529,529,14,14,13,13,3,3,1,1,9,5,0,0,1,0
979,970,970,970,13,14,15,13,2,2,2,1,9,0,0,-1,-1,2
482,473,478,473,18,19,18,18,1,2,2,1,9,-5,5,-1,1,0
759,754,750,750,17,16,18,16,6,2,2,1,5,4,0,1,-2,2
342,332,337,328,20,19,18,19,1,2,2,1,10,-5,9,1,1,-1
623,614,623,618,18,17,18,19,2,4,2,2,9,-9,5,1,-1,-1
684,679,684,679,17,16,15,16,2,1,1,1,5,-5,5,1,1,-1
553,557,557,553,21,19,20,21,2,1,1,1,-4,0,4,2,-1,-1
904,904,904,904,14,14,13,13,3,3,1,1,0,0,0,0,1,0
600,586,576,571,14,14,13,13,3,2,2,1,14,10,5,0,1,0
1059,1054,1050,1050,17,16,18,16,2,1,2,3,5,4,0,1,-2,2
510,506,510,510,18,19,18,19,3,3,1,1,4,-4,0,-1,1,-1
295,290,286,286,14,14,13,13,2,3,1,2,5,4,0,0,1,0
482,473,473,487,14,14,15,13,1,2,2,1,9,0,-14,0,-1,2
843,839,839,834,14,14,15,16,1,3,2,2,4,0,5,0,-1,-1
534,515,510,506,18,19,18,19,3,1,3,1,19,5,4,-1,1,-1
220,206,206,206,21,19,20,21,1,2,1,2,14,0,0,2,-1,-1
853,843,839,839,14,17,15,16,1,1,1,2,10,4,0,-3,2,-1
543,543,534,534,14,14,15,13,1,1,1,2,0,9,0,0,-1,2
539,534,534,539,14,14,15,13,1,3,1,1,5,0,-5,0,-1,2
379,370,370,374,20,19,20,18,2,2,1,1,9,0,-4,1,-1,2
1031,1026,1021,1017,20,19,18,18,3,1,1,2,5,5,4,1,1,0
871,871,871,871,21,19,20,21,2,2,1,1,0,0,0,2,-1,-1
937,923,928,918,20,19,18,19,2,2,2,2,14,-5,10,1,1,-1
553,534,539,534,18,17,18,18,1,2,2,1,19,-5,5,1,-1,0
834,834,829,829,21,19,20,19,1,1,1,2,0,5,0,2,-1,1
1050,1050,1045,1040,17,16,18,18,1,1,2,2,0,5,5,1,-2,0
614,614,609,609,21,19,21,19,2,1,1,3,0,5,0,2,-2,2
468,473,468,468,13,16,15,16,1,3,5,1,-5,5,0,-3,1,-1
857,857,857,853,18,17,18,16,3,1,4,2,0,0,4,1,-1,2
820,815,810,806,18,17,18,16,1,1,2,2,5,5,4,1,-1,2
876,867,871,871,21,19,20,18,2,1,2,1,9,-4,0,2,-1,2
520,510,506,506,14,17,15,16,2,1,1,1,10,4,0,-3,2,-1
731,731,726,726,20,19,18,18,3,2,1,3,0,5,0,1,1,0
229,229,224,229,14,17,15,16,1,3,3,1,0,5,-5,-3,2,-1
890,890,890,886,14,17,15,16,2,2,2,3,0,0,4,-3,2,-1
900,881,881,881,18,17,18,16,3,2,2,1,19,0,0,1,-1,2
946,942,946,937,13,14,15,16,3,1,3,4,4,-4,9,-1,-1,-1
239,234,234,229,14,14,13,13,1,3,1,3,5,0,5,0,1,0
651,656,651,651,20,19,20,18,1,1,1,2,-5,5,0,1,-1,2
1036,1036,1031,1036,20,19,20,18,1,1,3,1,0,5,-5,1,-1,2
979,974,970,970,17,16,18,16,2,2,3,1,5,4,0,1,-2,2
989,979,974,974,13,14,15,16,2,3,2,3,10,5,0,-1,-1,-1
398,398,398,398,13,16,15,16,3,1,1,1,0,0,0,-3,1,-1
750,740,745,745,20,19,18,18,2,2,1,1,10,-5,0,1,1,0
773,764,759,768,13,14,15,13,3,2,1,1,9,5,-9,-1,-1,2
787,773,773,773,18,19,18,18,4,2,1,2,14,0,0,-1,1,0
759,759,754,754,13,14,15,13,1,5,2,1,0,5,0,-1,-1,2
1007,1003,1003,1003,20,19,20,21,2,2,2,3,4,0,0,1,-1,-1
740,736,740,731,13,14,15,13,1,1,3,2,4,-4,9,-1,-1,2
886,876,871,871,14,14,13,13,1,3,1,1,10,5,0,0,1,0
374,370,370,365,17,16,18,18,2,1,2,1,4,0,5,1,-2,0
796,792,787,782,14,14,15,13,1,3,1,2,4,5,5,0,-1,2
876,871,871,862,14,14,13,13,2,1,2,2,5,0,9,0,1,0
848,839,839,839,18,17,18,16,2,2,3,2,9,0,0,1,-1,2
464,459,464,464,17,16,18,18,1,2,3,1,5,-5,0,1,-2,0
571,567,562,562,21,19,20,21,1,2,1,2,4,5,0,2,-1,-1
1026,1017,1026,1026,17,19,18,18,1,2,3,2,9,-9,0,-2,1,0
881,857,857,857,14,17,15,16,2,2,1,1,24,0,0,-3,2,-1
642,642,642,637,20,19,20,21,3,3,1,1,0,0,5,1,-1,-1
548,539,539,534,14,17,15,16,2,4,2,1,9,0,5,-3,2,-1
736,721,721,721,17,16,18,18,1,1,1,1,15,0,0,1,-2,0
703,693,698,693,20,19,20,18,2,2,3,1,10,-5,5,1,-1,2
623,623,618,618,21,19,21,21,3,1,1,1,0,5,0,2,-2,0
740,736,731,731,17,16,18,18,2,1,3,1,4,5,0,1,-2,0
487,487,487,473,14,14,13,13,3,2,2,1,0,0,14,0,1,0
576,567,567,562,18,19,18,18,2,2,1,2,9,0,5,-1,1,0
374,365,370,374,20,19,18,18,2,2,1,1,9,-5,-4,1,1,0
1059,1054,1059,1054,13,16,15,16,2,4,2,2,5,-5,5,-3,1,-1
356,351,351,351,13,16,15,16,2,3,1,3,5,0,0,-3,1,-1
224,220,210,210,18,17,18,16,3,3,1,1,4,10,0,1,-1,2
1026,1012,1017,1012,17,16,18,18,2,3,3,2,14,-5,5,1,-2,0
932,923,923,923,13,14,13,13,1,2,1,2,9,0,0,-1,1,0
1026,1021,1021,1017,13,14,12,13,1,3,2,2,5,0,4,-1,2,-1
900,895,900,900,21,19,20,19,1,1,6,1,5,-5,0,2,-1,1
1036,1026,1026,1026,20,19,20,18,1,3,1,3,10,0,0,1,-1,2
646,632,637,632,13,14,15,13,1,1,2,1,14,-5,5,-1,-1,2
450,450,440,445,17,16,15,16,2,1,1,2,0,10,-5,1,1,-1
281,271,271,267,14,14,15,13,3,1,1,2,10,0,4,0,-1,2
942,937,937,932,20,19,18,18,4,1,2,1,5,0,5,1,1,0
450,445,445,445,17,16,18,16,3,2,1,1,5,0,0,1,-2,2
506,506,501,501,18,17,18,16,2,1,3,1,0,5,0,1,-1,2
215,201,206,192,21,19,20,19,3,2,1,2,14,-5,14,2,-1,1
829,829,829,824,18,19,18,19,2,1,2,1,0,0,5,-1,1,-1
450,440,445,454,13,14,15,13,2,2,4,1,10,-5,-9,-1,-1,2
679,674,684,693,20,19,20,18,3,1,1,1,5,-10,-9,1,-1,2
459,445,445,450,13,14,12,13,2,2,1,1,14,0,-5,-1,2,-1
393,389,384,389,20,19,18,18,1,1,1,3,4,5,-5,1,1,0
862,853,857,857,21,19,20,18,2,2,1,1,9,-4,0,2,-1,2
867,862,862,857,14,17,15,16,2,3,1,2,5,0,5,-3,2,-1
192,192,192,187,14,14,15,13,1,2,2,2,0,0,5,0,-1,2
196,192,196,192,14,17,15,16,1,2,2,1,4,-4,4,-3,2,-1
384,374,370,370,13,16,15,16,2,1,3,2,10,4,0,-3,1,-1
290,286,281,276,21,19,20,18,3,5,2,1,4,5,5,2,-1,2
942,932,942,946,13,14,12,13,3,2,2,3,10,-10,-4,-1,2,-1
370,370,370,365,13,14,15,13,1,1,2,1,0,0,5,-1,-1,2
271,262,253,253,18,19,18,18,1,1,1,3,9,9,0,-1,1,0
407,403,398,403,13,14,12,13,2,1,3,1,4,5,-5,-1,2,-1
421,412,407,417,13,14,12,13,1,3,3,2,9,5,-10,-1,2,-1
1021,1012,1012,1007,17,19,18,18,1,2,2,2,9,0,5,-2,1,0
370,356,365,365,20,19,20,18,2,2,1,2,14,-9,0,1,-1,2
736,736,736,740,13,14,15,13,3,2,3,5,0,0,-4,-1,-1,2
871,857,862,857,21,19,20,21,1,1,2,1,14,-5,5,2,-1,-1
787,782,782,782,14,14,13,13,2,2,1,1,5,0,0,0,1,0
510,510,510,506,14,14,13,13,2,1,3,2,0,0,4,0,1,0
389,384,389,384,20,19,18,18,1,3,1,2,5,-5,5,1,1,0
721,721,721,721,13,16,15,16,1,3,3,2,0,0,0,-3,1,-1
295,567,290,290,14,17,15,16,1,1,2,2,-272,277,0,-3,2,-1
750,750,745,745,20,19,20,21,1,3,1,1,0,5,0,1,-1,-1
187,182,1078,182,18,17,18,16,1,2,2,1,5,-896,896,1,-1,2
342,337,337,332,13,14,15,13,1,2,2,1,5,0,5,-1,-1,2
848,848,848,843,18,19,18,18,1,1,2,1,0,0,5,-1,1,0
1078,1064,1059,1059,20,19,20,18,2,1,1,1,14,5,0,1,-1,2
646,646,646,642,13,14,12,13,1,1,2,2,0,0,4,-1,2,-1
843,829,829,824,14,14,15,16,3,3,1,1,14,0,5,0,-1,-1
754,754,754,750,20,19,18,18,3,1,1,1,0,0,4,1,1,0
923,904,904,510,14,17,15,13,1,1,2,1,19,0,394,-3,2,2
384,379,379,374,17,16,15,16,2,2,2,2,5,0,5,1,1,-1
286,286,290,286,21,19,20,19,4,3,1,1,0,-4,4,2,-1,1
843,834,834,834,18,19,18,18,2,1,2,1,9,0,0,-1,1,0
679,674,679,674,13,16,15,16,1,1,4,2,5,-5,5,-3,1,-1
881,871,867,857,14,14,15,13,2,1,2,2,10,4,10,0,-1,2
923,914,918,914,14,14,13,13,1,2,2,5,9,-4,4,0,1,0
918,904,900,895,14,14,15,13,2,3,3,2,14,4,5,0,-1,2
923,914,914,909,18,19,18,19,2,1,1,2,9,0,5,-1,1,-1
487,473,473,468,14,16,15,16,1,2,2,2,14,0,5,-2,1,-1
445,445,450,445,20,19,20,18,2,3,2,1,0,-5,5,1,-1,2
464,459,454,454,17,16,18,18,1,1,3,2,5,5,0,1,-2,0
454,450,450,450,13,14,15,13,3,3,2,3,4,0,0,-1,-1,2
384,379,374,374,17,16,15,16,2,2,2,3,5,5,0,1,1,-1
196,196,196,192,14,14,15,13,2,3,1,3,0,0,4,0,-1,2
412,403,407,398,13,14,15,16,2,2,2,2,9,-4,9,-1,-1,-1
520,510,506,510,14,14,13,13,3,2,4,2,10,4,-4,0,1,0
374,370,365,365,20,19,20,21,1,3,1,2,4,5,0,1,-1,-1
407,407,407,407,20,19,20,18,1,3,2,3,0,0,0,1,-1,2
834,829,824,801,14,14,15,9,1,3,1,1,5,5,23,0,-1,6
300,295,295,281,21,19,20,21,1,2,2,2,5,0,14,2,-1,-1
871,862,862,862,14,17,15,16,2,2,2,2,9,0,0,-3,2,-1
192,187,187,187,18,17,18,16,1,3,3,2,5,0,0,1,-1,2
998,993,993,993,17,16,18,18,4,1,2,1,5,0,0,1,-2,0
614,614,609,609,18,17,18,16,2,1,1,1,0,5,0,1,-1,2
515,510,515,506,14,17,15,16,1,2,2,2,5,-5,9,-3,2,-1
637,628,628,623,17,19,18,19,2,1,2,2,9,0,5,-2,1,-1
543,534,529,529,14,17,15,16,3,4,1,1,9,5,0,-3,2,-1
276,267,267,267,21,19,20,18,1,1,1,1,9,0,0,2,-1,2
946,946,946,951,17,19,18,18,1,1,2,1,0,0,-5,-2,1,0
473,464,464,464,17,19,18,18,2,1,1,1,9,0,0,-2,1,0
492,515,492,487,14,17,15,16,2,3,1,1,-23,23,5,-3,2,-1
384,374,379,374,13,14,12,13,1,2,1,1,10,-5,5,-1,2,-1
871,867,862,857,14,17,15,16,2,1,1,2,4,5,5,-3,2,-1
824,820,824,820,14,14,15,13,1,4,2,2,4,-4,4,0,-1,2
220,215,215,210,14,14,15,13,3,3,2,3,5,0,5,0,-1,2
909,900,900,895,14,17,15,16,2,2,1,2,9,0,5,-3,2,-1
351,346,346,346,17,16,18,18,3,2,2,1,5,0,0,1,-2,0
750,740,745,740,13,14,15,13,2,3,1,2,10,-5,5,-1,-1,2
1040,1036,1031,1031,20,19,20,18,1,2,1,1,4,5,0,1,-1,2
1073,1068,1073,1068,13,14,15,16,2,4,2,1,5,-5,5,-1,-1,-1
501,496,501,501,18,19,18,19,1,1,3,1,5,-5,0,-1,1,-1
862,862,857,853,14,14,13,13,3,3,3,1,0,5,4,0,1,0
829,829,829,834,14,14,15,13,1,3,1,3,0,0,-5,0,-1,2
478,468,464,464,13,14,15,13,1,3,2,1,10,4,0,-1,-1,2
909,904,909,904,18,19,18,19,1,2,3,1,5,-5,5,-1,1,-1
290,281,276,286,14,17,15,16,2,3,3,3,9,5,-10,-3,2,-1
501,501,501,501,21,19,21,19,2,1,1,2,0,0,0,2,-2,2
234,234,234,239,21,19,20,18,2,2,1,1,0,0,-5,2,-1,2
674,670,665,665,20,19,20,21,2,1,1,1,4,5,0,1,-1,-1
356,356,356,356,13,16,15,16,1,3,3,1,0,0,0,-3,1,-1
567,567,567,557,14,14,15,13,2,2,2,2,0,0,10,0,-1,2
586,581,581,576,14,14,15,13,3,2,2,2,5,0,5,0,-1,2
440,431,431,431,13,14,12,13,1,2,2,1,9,0,0,-1,2,-1
295,290,295,295,18,19,18,19,1,3,1,1,5,-5,0,-1,1,-1
923,914,923,918,18,19,18,19,2,3,2,1,9,-9,5,-1,1,-1
604,595,586,586,14,14,13,13,1,3,1,2,9,9,0,0,1,0
314,309,314,309,18,19,18,19,1,2,2,1,5,-5,5,-1,1,-1
801,801,801,796,14,14,15,16,1,3,3,3,0,0,5,0,-1,-1
1017,1012,1007,1007,13,14,15,13,2,3,2,2,5,5,0,-1,-1,2
276,267,267,262,18,19,18,18,1,2,2,1,9,0,5,-1,1,0
1064,614,1045,1045,17,14,15,16,3,1,1,2,450,-431,0,3,-1,-1
450,440,436,440,13,14,12,13,3,3,1,3,10,4,-4,-1,2,-1
295,295,295,295,18,19,18,19,1,2,1,2,0,0,0,-1,1,-1
900,895,900,895,14,17,15,16,2,3,2,1,5,-5,5,-3,2,-1
754,754,754,750,17,16,18,18,3,3,2,1,0,0,4,1,-2,0
600,604,609,604,14,17,15,16,2,2,2,2,-4,-5,5,-3,2,-1
431,426,431,426,17,16,18,16,2,2,1,2,5,-5,5,1,-2,2
595,595,595,595,18,19,18,19,3,1,2,3,0,0,0,-1,1,-1
300,300,295,295,18,17,18,16,2,3,3,1,0,5,0,1,-1,2
698,693,693,684,20,19,18,18,3,1,2,2,5,0,9,1,1,0
332,323,318,314,20,19,21,19,1,2,2,1,9,5,4,1,-2,2
810,796,792,787,14,14,15,13,1,3,1,2,14,4,5,0,-1,2
1064,1054,1054,1054,17,16,15,16,2,2,1,2,10,0,0,1,1,-1
1064,1059,1059,1059,17,19,18,18,1,2,3,1,5,0,0,-2,1,0
529,524,524,520,21,19,20,19,1,1,1,2,5,0,4,2,-1,1
895,890,886,886,18,19,18,19,1,2,1,1,5,4,0,-1,1,-1
520,515,510,510,14,17,15,16,3,1,1,1,5,5,0,-3,2,-1
436,431,431,431,20,19,20,18,2,2,1,2,5,0,0,1,-1,2
276,267,267,267,18,17,18,18,1,2,3,1,9,0,0,1,-1,0
1012,1003,1003,998,17,16,15,16,2,3,1,1,9,0,5,1,1,-1
224,224,220,215,14,14,13,13,3,3,1,2,0,4,5,0,1,0
651,642,642,642,20,19,20,21,2,3,1,2,9,0,0,1,-1,-1
956,951,946,946,13,14,12,13,1,3,2,1,5,5,0,-1,2,-1
806,796,801,792,18,19,18,19,1,2,2,2,10,-5,9,-1,1,-1
318,314,304,304,14,17,15,16,2,3,1,1,4,10,0,-3,2,-1
337,332,328,328,17,19,18,19,2,1,1,1,5,4,0,-2,1,-1
1045,1045,1040,1036,20,19,20,21,2,3,1,2,0,5,4,1,-1,-1
496,496,496,492,14,14,15,13,2,1,1,2,0,0,4,0,-1,2
1050,1040,1040,1040,17,16,18,18,3,2,1,1,10,0,0,1,-2,0
604,600,600,815,21,19,20,21,2,1,1,1,4,0,-215,2,-1,-1
576,576,581,576,21,19,20,21,3,2,1,2,0,-5,5,2,-1,-1
304,300,300,300,21,19,20,19,1,1,2,2,4,0,0,2,-1,1
928,923,923,914,14,14,13,13,1,2,2,2,5,0,9,0,1,0
974,970,970,970,13,16,15,16,3,2,3,1,4,0,0,-3,1,-1
871,876,876,871,21,19,20,18,4,2,1,1,-5,0,5,2,-1,2
318,318,318,318,14,14,15,13,3,2,1,2,0,0,0,0,-1,2
510,501,501,501,18,19,18,19,1,1,1,1,9,0,0,-1,1,-1
1012,1003,1007,1003,20,19,20,18,1,3,1,2,9,-4,4,1,-1,2
187,182,1073,1073,18,17,18,18,1,2,1,1,5,-891,0,1,-1,0
337,342,337,328,17,16,18,19,2,2,2,1,-5,5,9,1,-2,-1
914,909,909,909,14,14,15,13,3,2,1,2,5,0,0,0,-1,2
1040,1026,1012,998,13,14,15,13,1,1,6,2,14,14,14,-1,-1,2
740,750,736,731,17,16,18,18,3,1,1,2,-10,14,5,1,-2,0
309,300,300,300,21,19,20,19,1,3,1,1,9,0,0,2,-1,1
398,393,398,398,20,19,20,21,1,2,2,2,5,-5,0,1,-1,-1
220,215,215,215,14,17,15,16,2,3,3,1,5,0,0,-3,2,-1
1036,1031,1026,1026,13,14,12,13,1,3,1,1,5,5,0,-1,2,-1
900,895,895,895,18,17,18,16,1,1,2,1,5,0,0,1,-1,2
689,674,674,674,20,19,20,18,2,2,2,1,15,0,0,1,-1,2
576,576,571,567,21,19,20,21,1,2,1,2,0,5,4,2,-1,-1
604,604,604,604,14,14,15,16,2,2,2,2,0,0,0,0,-1,-1
778,773,778,773,17,16,15,16,1,2,2,2,5,-5,5,1,1,-1
843,829,829,824,14,14,13,13,3,2,2,2,14,0,5,0,1,0
614,609,614,614,21,19,21,19,3,3,2,1,5,-5,0,2,-2,2
1017,1012,1012,1012,20,19,20,21,3,1,1,1,5,0,0,1,-1,-1
187,1073,1068,1064,18,16,18,18,1,2,1,2,-886,5,4,2,-2,0
262,262,262,257,18,17,18,18,2,1,2,1,0,0,5,1,-1,0
595,600,595,595,18,19,18,19,4,3,3,1,-5,5,0,-1,1,-1
750,745,740,736,13,14,15,13,2,2,1,1,5,5,4,-1,-1,2
407,407,407,407,13,14,12,13,2,3,3,1,0,0,0,-1,2,-1
900,895,895,895,18,17,18,19,2,3,2,1,5,0,0,1,-1,-1
918,914,918,914,21,19,21,21,2,2,2,3,4,-4,4,2,-2,0
436,431,431,431,13,14,15,13,1,1,1,1,5,0,0,-1,-1,2
679,674,674,674,20,19,20,21,3,5,1,1,5,0,0,1,-1,-1
754,754,754,750,20,19,20,21,3,3,2,1,0,0,4,1,-1,-1
824,820,815,815,18,17,18,19,2,1,1,2,4,5,0,1,-1,-1
473,468,464,464,13,14,15,13,1,2,2,2,5,4,0,-1,-1,2
656,651,656,656,13,14,12,13,2,1,2,2,5,-5,0,-1,2,-1
271,271,271,267,14,14,15,13,1,3,2,3,0,0,4,0,-1,2
557,543,543,543,14,14,13,13,6,2,1,1,14,0,0,0,1,0
224,224,224,220,21,19,20,19,1,2,3,2,0,0,4,2,-1,1
192,182,187,187,18,17,18,16,3,1,2,1,10,-5,0,1,-1,2
201,196,196,196,14,17,15,16,1,2,1,1,5,0,0,-3,2,-1
773,768,764,764,13,14,15,16,3,3,1,1,5,4,0,-1,-1,-1
192,187,192,192,18,17,18,19,2,2,3,1,5,-5,0,1,-1,-1
220,215,210,210,14,14,13,13,2,1,1,1,5,5,0,0,1,0
862,862,862,862,14,17,15,16,2,2,2,2,0,0,0,-3,2,-1
478,478,473,478,17,16,15,16,2,1,1,1,0,5,-5,1,1,-1
1021,286,1017,1017,20,14,20,21,1,1,2,1,735,-731,0,6,-6,-1
534,524,529,529,14,14,15,16,2,1,1,3,10,-5,0,0,-1,-1
726,721,721,721,17,16,18,18,1,1,4,1,5,0,0,1,-2,0
956,942,937,942,13,14,12,13,1,2,2,1,14,5,-5,-1,2,-1
674,674,674,670,20,19,20,21,3,3,1,2,0,0,4,1,-1,-1
290,286,286,286,14,14,15,13,1,3,1,2,4,0,0,0,-1,2
1017,1012,1017,1012,17,16,15,16,1,3,2,1,5,-5,5,1,1,-1
951,942,937,932,13,14,12,13,1,3,2,2,9,5,5,-1,2,-1
904,904,900,895,14,17,15,16,2,2,3,3,0,4,5,-3,2,-1
576,571,571,576,14,14,15,13,1,2,1,1,5,0,-5,0,-1,2
815,810,810,810,21,19,20,21,3,1,1,2,5,0,0,2,-1,-1
300,290,286,281,14,17,15,16,1,3,1,2,10,4,5,-3,2,-1
215,206,196,196,18,17,18,19,3,1,3,1,9,10,0,1,-1,-1
674,660,660,660,17,19,18,18,3,1,3,2,14,0,0,-2,1,0
618,614,609,609,14,14,15,13,1,3,1,2,4,5,0,0,-1,2
759,750,754,745,20,19,20,21,3,1,3,2,9,-4,9,1,-1,-1
642,642,642,632,20,19,20,18,1,1,1,2,0,0,10,1,-1,2
590,581,581,581,14,14,13,13,1,2,2,2,9,0,0,0,1,0
923,923,918,923,14,14,13,13,2,1,1,1,0,5,-5,0,1,0
417,412,712,412,13,14,10,13,1,3,1,2,5,-300,300,-1,4,-3
215,210,210,553,14,14,15,18,1,1,2,1,5,0,-343,0,-1,-3
595,586,586,586,18,19,18,19,1,1,2,1,9,0,0,-1,1,-1
492,492,487,487,18,19,18,19,2,3,1,1,0,5,0,-1,1,-1
960,951,946,946,20,19,20,18,2,2,1,1,9,5,0,1,-1,2
867,857,853,857,14,14,13,13,3,3,2,1,10,4,-4,0,1,0
539,524,524,520,14,14,13,13,1,2,4,2,15,0,4,0,1,0
979,970,974,970,13,14,15,13,1,3,2,2,9,-4,4,-1,-1,2
707,703,698,703,20,19,20,21,2,2,1,1,4,5,-5,1,-1,-1
857,857,857,848,21,19,20,21,3,1,2,2,0,0,9,2,-1,-1
609,604,609,604,21,19,21,19,1,1,1,1,5,-5,5,2,-2,2
754,750,750,750,20,19,20,18,1,3,1,3,4,0,0,1,-1,2
215,220,215,210,14,14,13,13,3,3,1,2,-5,5,5,0,1,0
553,553,548,656,14,17,15,13,2,1,2,1,0,5,-108,-3,2,2
421,417,417,417,20,19,20,18,2,2,1,1,4,0,0,1,-1,2
956,956,956,956,20,19,20,18,1,1,1,1,0,0,0,1,-1,2
290,290,295,286,21,19,20,19,3,3,1,3,0,-5,9,2,-1,1
309,300,300,300,14,14,13,13,1,3,2,1,9,0,0,0,1,0
286,281,276,276,21,19,20,21,1,3,1,1,5,5,0,2,-1,-1
618,609,604,609,14,14,15,13,1,2,3,2,9,5,-5,0,-1,2
956,951,951,946,17,19,18,18,3,3,1,2,5,0,5,-2,1,0
881,857,867,871,14,14,15,13,1,4,4,2,24,-10,-4,0,-1,2
239,234,234,234,18,17,18,18,2,2,1,1,5,0,0,1,-1,0
1059,1054,1054,1050,13,14,12,13,2,2,1,2,5,0,4,-1,2,-1
234,234,548,224,14,14,10,13,4,1,1,2,0,-314,324,0,4,-3
1031,1026,1026,1021,17,16,18,18,1,1,1,1,5,0,5,1,-2,0
637,595,609,614,17,17,18,16,2,1,1,3,42,-14,-5,0,-1,2
271,262,262,262,14,14,13,13,1,2,1,1,9,0,0,0,1,0
379,365,374,370,17,16,15,16,2,2,1,3,14,-9,4,1,1,-1
445,436,440,436,20,19,18,18,2,2,2,1,9,-4,4,1,1,0
946,942,942,937,20,19,18,18,5,3,2,1,4,0,5,1,1,0
239,239,229,229,18,19,18,19,1,1,3,1,0,10,0,-1,1,-1
539,539,539,543,18,17,18,18,4,2,1,1,0,0,-4,1,-1,0
314,314,304,309,18,17,18,19,1,1,3,1,0,10,-5,1,-1,-1
304,304,304,300,18,19,18,19,1,1,2,2,0,0,4,-1,1,-1
731,721,721,717,17,19,18,18,3,2,1,2,10,0,4,-2,1,0
210,206,210,210,18,17,18,19,2,4,1,1,4,-4,0,1,-1,-1
248,234,229,229,14,14,13,13,3,2,1,1,14,5,0,0,1,0
740,736,736,731,13,14,12,13,1,1,4,2,4,0,5,-1,2,-1
1026,1017,1017,1021,17,16,15,16,2,1,3,1,9,0,-4,1,1,-1
468,459,454,459,13,14,15,16,2,2,2,1,9,5,-5,-1,-1,-1
482,464,454,454,14,14,12,13,1,1,1,3,18,10,0,0,2,-1
848,848,848,843,21,19,20,21,1,1,1,1,0,0,5,2,-1,-1
403,393,389,393,13,14,15,13,2,2,1,3,10,4,-4,-1,-1,2
810,815,806,810,14,17,15,16,2,1,1,1,-5,9,-4,-3,2,-1
440,440,436,436,20,19,20,21,1,1,1,1,0,4,0,1,-1,-1
501,501,496,492,18,19,18,19,2,1,3,1,0,5,4,-1,1,-1
182,1078,1078,1078,14,14,13,13,1,1,1,1,-896,0,0,0,1,0
820,815,810,815,18,17,18,16,1,3,1,3,5,5,-5,1,-1,2
707,703,703,698,13,14,12,13,2,2,2,2,4,0,5,-1,2,-1
571,571,576,576,21,19,20,21,2,1,1,1,0,-5,0,2,-1,-1
351,346,346,346,13,14,12,13,2,1,1,1,5,0,0,-1,2,-1
824,820,815,815,18,17,18,19,3,3,1,2,4,5,0,1,-1,-1
923,918,923,918,14,17,15,16,2,2,2,2,5,-5,5,-3,2,-1
951,937,928,928,13,14,15,13,4,3,2,1,14,9,0,-1,-1,2
257,257,257,257,21,19,20,18,3,1,1,1,0,0,0,2,-1,2
829,824,824,820,18,17,18,16,4,2,1,4,5,0,4,1,-1,2
576,567,562,562,14,17,15,16,1,1,2,1,9,5,0,-3,2,-1
600,590,595,590,14,14,13,13,1,3,2,3,10,-5,5,0,1,0
979,970,965,965,20,19,18,18,3,3,1,1,9,5,0,1,1,0
989,984,984,984,13,16,15,16,2,1,1,1,5,0,0,-3,1,-1
965,956,951,942,17,16,15,16,2,2,2,2,9,5,9,1,1,-1
206,206,201,201,18,19,18,19,2,1,1,1,0,5,0,-1,1,-1
239,234,234,234,14,14,13,13,3,2,1,1,5,0,0,0,1,0
881,876,876,871,14,14,13,13,2,3,3,1,5,0,5,0,1,0
379,374,379,379,13,16,15,16,1,2,2,3,5,-5,0,-3,1,-1
670,670,665,665,13,16,15,16,3,3,1,1,0,5,0,-3,1,-1
759,754,750,750,13,14,15,16,2,1,1,3,5,4,0,-1,-1,-1
1054,1050,1045,1045,17,16,18,18,3,1,1,1,4,5,0,1,-2,0
984,979,984,979,17,16,18,16,2,1,1,2,5,-5,5,1,-2,2
782,782,778,262,14,14,15,11,2,2,1,1,0,4,516,0,-1,4
829,829,824,824,18,17,18,19,3,3,1,2,0,5,0,1,-1,-1
923,918,918,914,14,17,15,16,2,2,1,3,5,0,4,-3,2,-1
389,389,379,384,17,19,18,18,1,1,1,1,0,10,-5,-2,1,0
276,271,257,253,14,14,13,13,2,3,1,4,5,14,4,0,1,0
595,576,571,581,14,14,13,13,1,2,4,3,19,5,-10,0,1,0
440,431,431,426,17,16,15,16,3,2,3,3,9,0,5,1,1,-1
201,220,201,201,14,14,15,13,1,1,1,1,-19,19,0,0,-1,2
787,782,778,773,14,17,15,16,1,1,1,3,5,4,5,-3,2,-1
248,243,253,257,18,17,18,18,2,1,6,1,5,-10,-4,1,-1,0
815,815,810,810,18,19,18,19,1,1,1,1,0,5,0,-1,1,-1
248,248,243,248,14,14,15,16,2,3,1,1,0,5,-5,0,-1,-1
431,426,421,421,13,14,12,13,2,1,3,2,5,5,0,-1,2,-1
1078,1068,1064,1064,17,16,18,18,2,1,2,2,10,4,0,1,-2,0
1031,1031,1026,1031,20,19,20,18,3,1,1,1,0,5,-5,1,-1,2
660,656,656,651,20,19,18,18,1,3,2,1,4,0,5,1,1,0
478,464,464,473,13,14,12,13,2,1,1,1,14,0,-9,-1,2,-1
520,520,515,515,18,19,18,19,1,2,1,1,0,5,0,-1,1,-1
989,989,984,984,17,16,15,16,1,1,1,2,0,5,0,1,1,-1
1064,1064,1068,1059,13,14,15,13,2,3,2,2,0,-4,9,-1,-1,2
548,543,543,539,14,14,15,13,2,4,3,2,5,0,4,0,-1,2
698,689,684,684,17,16,18,16,2,1,1,1,9,5,0,1,-2,2
239,229,229,229,14,14,13,13,3,4,1,1,10,0,0,0,1,0
951,951,951,951,20,19,18,18,1,5,2,2,0,0,0,1,1,0
642,637,632,632,20,19,20,18,3,2,1,1,5,5,0,1,-1,2
782,773,778,773,21,19,20,21,2,2,1,2,9,-5,5,2,-1,-1
309,304,300,304,14,14,13,13,1,3,3,4,5,4,-4,0,1,0
182,182,928,1078,14,17,15,16,1,1,1,1,0,-746,-150,-3,2,-1
309,300,300,300,14,17,15,16,1,2,1,2,9,0,0,-3,2,-1
257,229,229,224,14,14,13,13,3,2,2,4,28,0,5,0,1,0
843,843,843,839,18,19,18,18,2,2,3,2,0,0,4,-1,1,0
904,900,900,900,14,14,15,13,1,2,2,2,4,0,0,0,-1,2
707,698,703,689,20,19,18,18,3,3,1,2,9,-5,14,1,1,0
309,304,304,295,14,14,13,13,2,3,2,2,5,0,9,0,1,0
909,909,909,909,21,19,21,21,2,1,1,2,0,0,0,2,-2,0
614,604,614,609,14,17,15,16,1,2,2,3,10,-10,5,-3,2,-1
890,886,890,886,18,17,18,16,1,1,2,2,4,-4,4,1,-1,2
979,979,984,974,13,14,15,13,3,3,2,1,0,-5,10,-1,-1,2
426,421,421,417,17,16,18,18,3,4,3,2,5,0,4,1,-2,0
693,693,698,703,20,19,20,18,3,3,2,1,0,-5,-5,1,-1,2
810,806,801,801,14,14,15,13,3,1,1,1,4,5,0,0,-1,2
1021,1017,1017,1017,17,16,18,16,1,1,1,1,4,0,0,1,-2,2
187,182,182,182,14,17,15,16,3,2,1,1,5,0,0,-3,2,-1
731,726,726,726,13,14,12,13,1,2,2,1,5,0,0,-1,2,-1
848,848,843,843,14,17,15,16,1,3,1,1,0,5,0,-3,2,-1
182,1078,1078,1073,18,19,18,18,2,1,1,2,-896,0,5,-1,1,0
543,534,539,534,14,14,13,13,2,2,2,1,9,-5,5,0,1,0
684,674,684,684,17,16,15,16,2,2,2,1,10,-10,0,1,1,-1
1036,1026,1026,1026,20,19,18,18,2,1,1,2,10,0,0,1,1,0
801,787,792,792,21,19,21,19,1,2,3,1,14,-5,0,2,-2,2
609,609,609,600,14,14,13,13,1,3,4,5,0,0,9,0,1,0
618,614,614,614,21,19,21,21,4,2,1,1,4,0,0,2,-2,0
529,520,515,510,14,17,15,16,1,1,2,1,9,5,5,-3,2,-1
895,881,876,881,18,17,18,16,2,1,1,1,14,5,-5,1,-1,2
881,871,876,876,14,14,15,16,1,4,2,1,10,-5,0,0,-1,-1
651,646,637,623,13,14,12,13,1,3,2,2,5,9,14,-1,2,-1
468,459,543,464,13,14,15,13,1,2,2,1,9,-84,79,-1,-1,2
473,464,459,459,17,16,15,16,2,5,1,3,9,5,0,1,1,-1
998,993,993,993,13,14,15,13,2,1,3,2,5,0,0,-1,-1,2
773,768,618,768,17,16,15,18,2,2,1,1,5,150,-150,1,1,-3
567,567,562,557,14,14,13,13,2,3,2,3,0,5,5,0,1,0
220,220,215,210,14,14,13,13,2,5,2,2,0,5,5,0,1,0
843,839,843,843,21,19,20,18,3,4,3,1,4,-4,0,2,-1,2
464,464,468,459,13,14,15,13,3,3,2,1,0,-4,9,-1,-1,2
398,389,393,398,17,16,18,16,2,2,1,2,9,-4,-5,1,-2,2
848,834,928,820,18,17,23,16,1,4,1,1,14,-94,108,1,-6,7
271,271,271,271,14,17,15,16,1,2,2,1,0,0,0,-3,2,-1
993,984,989,984,17,16,15,16,2,2,2,3,9,-5,5,1,1,-1
482,473,468,468,21,19,20,18,1,2,1,1,9,5,0,2,-1,2
1059,1054,1059,1054,20,19,18,18,1,1,2,1,5,-5,5,1,1,0
524,510,815,510,14,17,15,16,3,3,1,1,14,-305,305,-3,2,-1
1036,1021,1026,1021,20,19,20,21,2,3,1,2,15,-5,5,1,-1,-1
857,853,853,853,18,19,18,18,1,2,1,1,4,0,0,-1,1,0
379,374,370,374,20,19,18,18,2,1,1,1,5,4,-4,1,1,0
374,365,365,365,17,16,18,18,2,1,1,1,9,0,0,1,-2,0
829,824,824,824,21,19,20,21,3,2,2,1,5,0,0,2,-1,-1
590,576,571,576,18,19,18,18,1,3,1,1,14,5,-5,-1,1,0
824,824,820,820,14,14,13,13,3,3,1,1,0,4,0,0,1,0
426,421,426,426,13,14,12,13,2,2,2,2,5,-5,0,-1,2,-1
942,932,928,928,13,14,15,16,2,1,1,1,10,4,0,-1,-1,-1
417,412,412,412,17,16,15,16,2,2,1,1,5,0,0,1,1,-1
918,909,909,909,14,14,15,13,3,2,3,2,9,0,0,0,-1,2
459,454,450,450,20,19,18,18,1,2,1,1,5,4,0,1,1,0
295,295,304,290,18,19,18,19,2,2,6,3,0,-9,14,-1,1,-1
379,374,370,365,20,19,20,21,3,3,1,2,5,4,5,1,-1,-1
370,360,351,351,13,14,12,13,2,3,3,1,10,9,0,-1,2,-1
487,478,478,473,18,19,18,18,3,1,1,2,9,0,5,-1,1,0
496,492,492,492,14,17,15,16,2,1,1,1,4,0,0,-3,2,-1
1031,1017,1021,1021,17,16,15,16,1,1,3,2,14,-4,0,1,1,-1
267,262,262,267,18,19,18,18,2,2,3,1,5,0,-5,-1,1,0
651,646,646,646,17,16,18,18,1,2,1,2,5,0,0,1,-2,0
810,796,801,801,18,19,18,19,2,2,2,1,14,-5,0,-1,1,-1
670,660,665,665,13,14,12,13,1,3,1,1,10,-5,0,-1,2,-1
309,309,304,304,18,17,18,19,2,2,1,2,0,5,0,1,-1,-1
965,960,960,960,13,14,12,13,1,3,2,1,5,0,0,-1,2,-1
656,642,646,646,20,19,20,18,2,2,1,1,14,-4,0,1,-1,2
759,754,759,754,17,19,18,18,1,1,2,2,5,-5,5,-2,1,0
881,876,876,876,21,19,20,18,2,1,1,1,5,0,0,2,-1,2
548,539,539,539,14,14,13,13,2,2,2,1,9,0,0,0,1,0
1068,1068,1068,1068,20,19,20,18,1,1,1,1,0,0,0,1,-1,2
571,567,562,567,18,17,18,18,2,2,2,3,4,5,-5,1,-1,0
731,726,721,721,17,19,18,18,1,2,1,1,5,5,0,-2,1,0
464,454,464,468,17,16,18,18,1,7,5,1,10,-10,-4,1,-2,0
318,314,314,314,21,19,21,21,1,2,1,1,4,0,0,2,-2,0
196,192,192,192,14,17,15,16,1,2,2,1,4,0,0,-3,2,-1
993,989,984,979,20,19,20,21,3,1,1,1,4,5,5,1,-1,-1
403,393,398,403,17,16,18,18,1,2,2,1,10,-5,-5,1,-2,0
656,656,651,651,17,16,18,18,1,1,1,1,0,5,0,1,-2,0
478,468,473,473,17,16,18,16,2,2,1,1,10,-5,0,1,-2,2
295,365,295,290,14,14,15,13,2,3,1,1,-70,70,5,0,-1,2
281,281,276,276,21,19,20,21,1,1,3,1,0,5,0,2,-1,-1
956,946,946,951,13,14,12,13,2,2,1,1,10,0,-5,-1,2,-1
1007,1003,1003,998,17,19,18,18,1,1,2,2,4,0,5,-2,1,0
773,773,773,773,17,16,18,16,1,1,1,3,0,0,0,1,-2,2
468,468,459,857,17,16,18,13,3,3,3,1,0,9,-398,1,-2,5
974,956,960,970,13,14,12,13,1,2,2,2,18,-4,-10,-1,2,-1
810,801,796,796,18,17,18,19,3,1,1,2,9,5,0,1,-1,-1
323,323,328,323,14,14,13,13,2,2,2,2,0,-5,5,0,1,0
731,731,731,721,13,16,15,16,1,2,2,1,0,0,10,-3,1,-1
984,974,979,984,13,14,12,13,2,1,2,1,10,-5,-5,-1,2,-1
759,750,740,736,13,14,12,13,2,1,4,3,9,10,4,-1,2,-1
567,562,562,557,18,17,18,16,3,4,2,2,5,0,5,1,-1,2
281,281,281,300,14,14,15,13,2,3,2,1,0,0,-19,0,-1,2
304,309,309,300,14,14,15,13,2,3,2,2,-5,0,9,0,-1,2
1012,1007,1007,1003,20,19,18,18,2,3,1,1,5,0,4,1,1,0
989,984,989,998,20,19,18,18,2,3,1,1,5,-5,-9,1,1,0
656,646,646,646,13,14,15,13,2,2,3,2,10,0,0,-1,-1,2
970,974,965,965,17,16,18,18,1,4,1,1,-4,9,0,1,-2,0
576,571,571,567,18,19,18,18,1,2,3,2,5,0,4,-1,1,0
951,946,956,960,20,19,20,21,1,2,1,1,5,-10,-4,1,-1,-1
215,201,201,201,18,19,18,19,1,4,3,1,14,0,0,-1,1,-1
215,215,215,215,21,19,20,21,1,1,1,1,0,0,0,2,-1,-1
187,1073,1073,1073,14,14,12,13,1,3,3,1,-886,0,0,0,2,-1
548,543,543,543,14,14,13,13,1,3,3,1,5,0,0,0,1,0
468,464,464,459,17,16,18,18,2,1,2,2,4,0,5,1,-2,0
881,876,881,881,21,19,20,21,2,2,1,1,5,-5,0,2,-1,-1
609,604,609,604,14,14,13,13,2,2,2,1,5,-5,5,0,1,0
529,520,515,510,18,17,18,19,3,2,1,3,9,5,5,1,-1,-1
1031,1021,1026,1031,17,19,18,18,1,1,1,1,10,-5,-5,-2,1,0
1059,1050,1050,1054,20,19,20,21,2,2,3,1,9,0,-4,1,-1,-1
937,932,928,923,13,14,15,13,2,1,1,2,5,4,5,-1,-1,2
295,281,281,281,14,14,13,13,1,2,1,4,14,0,0,0,1,0
960,951,951,946,17,16,18,18,2,1,1,2,9,0,5,1,-2,0
473,459,459,454,20,19,18,18,4,2,2,2,14,0,5,1,1,0
421,407,407,412,13,16,15,16,2,1,1,1,14,0,-5,-3,1,-1
1012,1007,1007,1007,13,14,12,13,2,3,4,1,5,0,0,-1,2,-1
1036,1031,1026,1021,20,19,20,21,1,1,3,1,5,5,5,1,-1,-1
224,220,281,215,14,14,13,13,2,3,1,1,4,-61,66,0,1,0
440,436,431,426,20,19,18,18,3,1,2,1,4,5,5,1,1,0
904,900,900,900,14,14,15,13,2,2,1,1,4,0,0,0,-1,2
914,914,914,909,18,19,18,19,2,2,2,1,0,0,5,-1,1,-1
646,637,632,632,13,14,15,13,1,2,1,2,9,5,0,-1,-1,2
436,426,421,426,20,19,18,18,2,1,1,3,10,5,-5,1,1,0
660,656,656,651,20,19,20,21,3,1,2,2,4,0,5,1,-1,-1
318,314,314,314,14,17,15,16,1,3,2,1,4,0,0,-3,2,-1
365,360,360,365,20,19,18,18,1,3,1,1,5,0,-5,1,1,0
196,196,206,196,18,17,18,19,3,1,1,1,0,-10,10,1,-1,-1
314,309,328,309,21,19,21,19,1,2,1,1,5,-19,19,2,-2,2
974,970,960,960,13,14,15,16,1,2,2,1,4,10,0,-1,-1,-1
192,182,1078,1073,14,14,13,13,1,2,1,2,10,-896,5,0,1,0
286,1021,1026,1026,14,14,15,13,1,2,1,1,-735,-5,0,0,-1,2
937,918,918,928,13,14,15,13,1,3,1,1,19,0,-10,-1,-1,2
220,210,210,206,14,14,15,13,3,2,1,1,10,0,4,0,-1,2
567,557,562,562,14,17,15,16,3,1,1,2,10,-5,0,-3,2,-1
764,768,759,759,17,16,15,16,2,1,1,1,-4,9,0,1,1,-1
764,754,750,745,13,14,15,13,1,2,2,2,10,4,5,-1,-1,2
909,909,909,914,14,17,15,16,2,2,1,3,0,0,-5,-3,2,-1
482,487,478,473,14,14,15,13,2,1,1,2,-5,9,5,0,-1,2
1036,1031,1026,1026,17,19,18,18,1,1,1,2,5,5,0,-2,1,0
318,309,309,304,14,17,15,16,2,2,1,2,9,0,5,-3,2,-1
468,464,454,445,17,16,15,16,2,3,1,2,4,10,9,1,1,-1
1021,1021,1021,1017,17,19,18,18,1,1,1,2,0,0,4,-2,1,0
698,693,693,689,20,19,20,18,3,2,2,1,5,0,4,1,-1,2
492,482,478,478,14,14,13,13,3,1,2,1,10,4,0,0,1,0
210,201,201,201,18,17,18,19,1,1,1,3,9,0,0,1,-1,-1
609,604,600,600,21,19,20,19,1,1,1,1,5,4,0,2,-1,1
628,623,618,618,14,14,13,13,1,3,3,2,5,5,0,0,1,0
890,886,886,886,18,19,20,19,3,3,1,1,4,0,0,-1,-1,1
679,674,679,674,13,16,15,16,1,1,2,1,5,-5,5,-3,1,-1
318,314,314,314,18,19,18,19,3,1,1,3,4,0,0,-1,1,-1
614,609,609,609,14,17,15,16,2,1,1,1,5,0,0,-3,2,-1
974,974,974,970,13,14,15,16,1,3,2,2,0,0,4,-1,-1,-1
295,300,295,295,21,19,20,19,1,3,1,3,-5,5,0,2,-1,1
215,215,215,215,14,14,13,13,2,2,2,1,0,0,0,0,1,0
271,267,267,267,14,14,15,16,3,3,1,1,4,0,0,0,-1,-1
951,942,946,946,20,19,20,21,1,1,1,1,9,-4,0,1,-1,-1
1007,1003,1007,1007,20,19,20,21,1,1,2,1,4,-4,0,1,-1,-1
304,295,295,290,14,14,13,13,2,3,4,1,9,0,5,0,1,0
520,510,506,506,14,17,15,16,1,1,2,2,10,4,0,-3,2,-1
243,239,239,239,18,17,18,18,1,1,1,1,4,0,0,1,-1,0
693,689,684,684,17,16,15,16,3,3,2,1,4,5,0,1,1,-1
946,942,937,937,20,19,20,18,2,1,1,1,4,5,0,1,-1,2
417,417,417,412,17,16,18,18,3,3,2,2,0,0,5,1,-2,0
403,398,393,393,20,19,20,21,2,2,3,1,5,5,0,1,-1,-1
792,787,778,773,14,14,13,13,1,3,2,2,5,9,5,0,1,0
956,951,946,946,20,19,20,21,3,3,1,1,5,5,0,1,-1,-1
365,360,360,360,13,16,15,16,1,1,1,2,5,0,0,-3,1,-1
224,224,224,224,18,19,18,19,1,1,3,1,0,0,0,-1,1,-1
923,918,918,918,14,14,13,13,2,3,3,2,5,0,0,0,1,0
187,187,187,187,18,17,18,16,3,2,1,2,0,0,0,1,-1,2
501,492,492,496,14,14,15,13,3,2,1,3,9,0,-4,0,-1,2
1003,1003,1003,998,13,14,12,13,1,1,2,2,0,0,5,-1,2,-1
281,276,276,271,14,17,15,16,3,4,2,3,5,0,5,-3,2,-1
1059,1050,1054,1050,20,19,20,18,3,1,1,3,9,-4,4,1,-1,2
182,1078,1078,1078,21,19,20,21,1,1,1,1,-896,0,0,2,-1,-1
192,187,187,187,18,19,18,19,2,1,2,1,5,0,0,-1,1,-1
886,871,867,862,18,19,18,18,3,3,2,1,15,4,5,-1,1,0
684,674,674,670,13,14,12,13,2,3,2,2,10,0,4,-1,2,-1
276,271,267,267,14,17,15,16,2,1,1,1,5,4,0,-3,2,-1
478,478,478,478,20,19,20,18,1,1,1,1,0,0,0,1,-1,2
768,764,759,764,13,14,12,13,2,3,1,1,4,5,-5,-1,2,-1
206,192,187,182,18,17,18,19,2,1,2,1,14,5,5,1,-1,-1
1017,1017,1012,1012,13,14,15,13,2,5,1,3,0,5,0,-1,-1,2
768,759,764,764,17,16,18,16,3,2,3,2,9,-5,0,1,-2,2
1073,1064,1064,1064,20,19,20,18,2,1,1,2,9,0,0,1,-1,2
557,548,543,548,18,19,18,18,1,1,1,1,9,5,-5,-1,1,0
492,487,487,482,14,17,15,16,3,1,1,1,5,0,5,-3,2,-1
890,890,890,895,14,14,13,13,4,3,1,1,0,0,-5,0,1,0
323,318,323,318,18,19,18,19,3,2,1,1,5,-5,5,-1,1,-1
553,548,548,543,18,17,18,18,1,1,2,2,5,0,5,1,-1,0
553,548,543,543,14,17,15,16,1,1,1,2,5,5,0,-3,2,-1
871,867,867,862,18,17,18,18,2,2,3,1,4,0,5,1,-1,0
271,257,257,201,14,14,15,16,3,2,2,1,14,0,56,0,-1,-1
192,1073,1068,1064,14,14,12,13,2,1,1,2,-881,5,4,0,2,-1
609,604,600,609,18,17,18,16,2,1,1,1,5,4,-9,1,-1,2
468,464,459,459,13,14,15,13,2,3,1,1,4,5,0,-1,-1,2
712,698,693,693,13,14,15,13,3,2,1,2,14,5,0,-1,-1,2
1026,1031,1021,1021,13,16,15,16,1,1,2,1,-5,10,0,-3,1,-1
918,918,918,914,18,19,18,19,1,2,2,1,0,0,4,-1,1,-1
473,464,468,464,17,16,15,16,1,1,5,3,9,-4,4,1,1,-1
201,192,192,192,18,17,18,19,3,1,1,3,9,0,0,1,-1,-1
379,374,374,374,17,16,15,16,3,3,1,1,5,0,0,1,1,-1
515,515,510,524,18,17,18,19,1,3,1,1,0,5,-14,1,-1,-1
314,314,309,314,14,17,15,16,2,1,1,2,0,5,-5,-3,2,-1
407,407,450,403,13,14,15,16,3,1,1,2,0,-43,47,-1,-1,-1
304,281,267,267,14,14,13,13,1,2,2,1,23,14,0,0,1,0
318,304,300,300,18,17,18,16,2,2,1,1,14,4,0,1,-1,2
1078,1073,1073,1073,13,14,12,13,1,2,3,2,5,0,0,-1,2,-1
993,989,984,979,13,14,12,13,3,3,1,3,4,5,5,-1,2,-1
642,646,642,642,17,16,18,18,1,3,1,1,-4,4,0,1,-2,0
567,557,562,557,14,14,15,13,3,2,2,1,10,-5,5,0,-1,2
337,323,328,337,13,14,15,13,1,2,1,1,14,-5,-9,-1,-1,2
220,220,220,215,18,19,18,19,2,1,1,2,0,0,5,-1,1,-1
759,750,745,740,20,19,20,18,1,1,1,1,9,5,5,1,-1,2
267,262,262,262,14,14,13,13,3,1,1,1,5,0,0,0,1,0
918,914,914,914,18,19,18,19,1,1,1,1,4,0,0,-1,1,-1
234,229,229,229,14,14,13,13,1,3,2,1,5,0,0,0,1,0
876,867,862,862,18,17,18,16,2,1,1,3,9,5,0,1,-1,2
1026,1031,1026,1031,20,19,18,18,1,3,3,1,-5,5,-5,1,1,0
998,998,1003,993,17,16,15,16,1,2,2,2,0,-5,10,1,1,-1
909,904,909,909,18,19,21,19,1,1,1,1,5,-5,0,-1,-2,2
989,979,984,984,13,14,15,13,2,2,2,1,10,-5,0,-1,-1,2
614,609,609,604,18,19,18,19,1,1,2,1,5,0,5,-1,1,-1
196,196,192,187,14,17,15,16,1,1,2,2,0,4,5,-3,2,-1
239,239,239,239,18,17,18,16,2,2,2,1,0,0,0,1,-1,2
674,670,670,670,17,16,15,16,2,1,2,1,4,0,0,1,1,-1
998,989,979,984,13,14,12,13,1,2,3,1,9,10,-5,-1,2,-1
726,712,707,698,13,16,15,16,1,1,2,1,14,5,9,-3,1,-1
810,810,806,810,14,17,15,16,2,2,3,1,0,4,-4,-3,2,-1
267,271,267,267,21,19,20,21,1,1,1,2,-4,4,0,2,-1,-1
478,707,712,707,20,16,15,16,1,2,2,1,-229,-5,5,4,1,-1
595,590,590,586,18,19,18,19,1,1,2,2,5,0,4,-1,1,-1
618,609,609,609,14,14,13,13,1,2,2,2,9,0,0,0,1,0
234,210,220,220,14,14,13,13,1,1,2,2,24,-10,0,0,1,0
1017,1017,1017,1017,20,19,20,21,1,1,2,1,0,0,0,1,-1,-1
754,745,740,740,20,19,20,21,1,2,2,1,9,5,0,1,-1,-1
276,271,276,271,14,17,15,16,1,1,1,2,5,-5,5,-3,2,-1
740,731,736,736,13,14,15,13,2,2,1,1,9,-5,0,-1,-1,2
290,281,281,281,18,19,18,19,2,1,1,2,9,0,0,-1,1,-1
342,332,337,332,20,19,18,18,3,1,2,1,10,-5,5,1,1,0
989,984,989,979,17,16,15,16,1,3,2,2,5,-5,10,1,1,-1
210,201,206,196,14,14,15,13,3,3,2,3,9,-5,10,0,-1,2
510,501,501,506,21,19,21,21,3,2,1,4,9,0,-5,2,-2,0
989,979,970,970,13,14,12,13,1,2,1,1,10,9,0,-1,2,-1
473,473,478,473,17,16,15,16,1,1,2,2,0,-5,5,1,1,-1
614,609,604,609,14,14,15,13,2,1,2,2,5,5,-5,0,-1,2
778,773,773,778,20,19,18,18,1,1,1,1,5,0,-5,1,1,0
529,529,524,524,14,14,13,13,2,1,1,2,0,5,0,0,1,0
1012,1007,1003,1003,17,16,15,16,3,3,3,1,5,4,0,1,1,-1
829,820,820,824,14,17,15,16,3,2,2,1,9,0,-4,-3,2,-1
782,782,778,773,18,17,18,18,2,1,1,2,0,4,5,1,-1,0
557,557,553,553,14,14,13,13,1,1,1,2,0,4,0,0,1,0
1003,998,998,993,13,16,15,16,1,1,1,2,5,0,5,-3,1,-1
304,379,295,290,14,19,15,16,1,1,2,2,-75,84,5,-5,4,-1
960,960,960,956,17,16,15,16,3,1,2,1,0,0,4,1,1,-1
496,496,496,492,18,19,18,19,1,3,2,1,0,0,4,-1,1,-1
829,829,829,824,21,19,20,21,2,1,2,1,0,0,5,2,-1,-1
201,192,192,192,18,17,18,19,1,2,1,1,9,0,0,1,-1,-1
309,295,290,295,14,14,13,13,3,3,1,3,14,5,-5,0,1,0
693,684,679,670,13,14,12,13,1,3,2,2,9,5,9,-1,2,-1
407,403,398,398,17,19,18,18,2,3,3,1,4,5,0,-2,1,0
506,492,496,496,14,17,15,16,3,2,2,1,14,-4,0,-3,2,-1
656,656,660,656,13,14,15,13,2,2,2,1,0,-4,4,-1,-1,2
759,750,750,745,13,14,15,13,2,2,1,2,9,0,5,-1,-1,2
1017,1017,1012,1017,13,16,15,16,1,1,3,4,0,5,-5,-3,1,-1
693,684,689,684,13,14,15,13,2,2,2,1,9,-5,5,-1,-1,2
328,318,323,323,18,17,18,16,1,2,1,2,10,-5,0,1,-1,2
454,450,450,445,13,14,12,13,1,3,2,1,4,0,5,-1,2,-1
436,431,421,421,17,16,15,16,1,1,2,1,5,10,0,1,1,-1
881,881,876,881,14,14,15,13,2,3,1,3,0,5,-5,0,-1,2
918,914,909,914,18,19,18,19,1,3,1,1,4,5,-5,-1,1,-1
1003,1003,1003,1007,17,19,18,18,1,2,1,1,0,0,-4,-2,1,0
295,286,281,276,18,19,18,18,3,2,1,2,9,5,5,-1,1,0
895,895,895,890,18,19,18,19,2,1,2,2,0,0,5,-1,1,-1
614,609,609,600,14,17,15,16,1,3,3,2,5,0,9,-3,2,-1
196,187,196,196,21,19,21,19,1,2,2,3,9,-9,0,2,-2,2
984,974,979,979,20,19,18,18,4,2,1,3,10,-5,0,1,1,0
689,684,684,679,20,19,20,18,1,2,1,2,5,0,5,1,-1,2
506,501,496,496,18,17,18,19,1,1,2,2,5,5,0,1,-1,-1
539,534,534,534,14,14,15,13,1,2,3,2,5,0,0,0,-1,2
632,623,623,623,20,19,18,19,1,2,1,1,9,0,0,1,1,-1
834,829,834,829,14,17,15,16,2,3,2,3,5,-5,5,-3,2,-1
623,614,618,618,21,19,21,21,1,1,1,3,9,-4,0,2,-2,0
721,721,721,717,17,19,18,18,1,2,2,1,0,0,4,-2,1,0
1054,1059,1059,1059,17,16,18,18,1,2,2,1,-5,0,0,1,-2,0
736,726,726,726,20,19,20,18,3,2,1,1,10,0,0,1,-1,2
618,618,623,618,18,19,18,19,1,2,1,3,0,-5,5,-1,1,-1
510,506,506,501,14,17,15,16,1,2,1,2,4,0,5,-3,2,-1
928,918,918,914,14,14,13,13,1,3,2,1,10,0,4,0,1,0
881,881,886,881,18,17,18,16,4,1,2,5,0,-5,5,1,-1,2
946,946,942,942,13,14,15,13,1,1,1,3,0,4,0,-1,-1,2
253,243,243,239,14,17,15,16,3,1,2,2,10,0,4,-3,2,-1
604,600,604,609,14,14,13,13,2,2,3,3,4,-4,-5,0,1,0
290,290,290,286,14,14,13,13,2,2,2,2,0,0,4,0,1,0
974,984,974,970,13,14,12,13,3,1,2,2,-10,10,4,-1,2,-1
886,881,881,881,21,19,20,21,1,1,1,1,5,0,0,2,-1,-1
239,234,229,234,18,19,18,18,3,2,1,1,5,5,-5,-1,1,0
445,445,445,445,13,14,15,13,1,3,3,1,0,0,0,-1,-1,2
243,243,243,234,14,14,13,13,2,3,4,2,0,0,9,0,1,0
529,515,515,515,18,17,18,16,3,2,2,1,14,0,0,1,-1,2
323,318,318,314,14,14,13,13,3,3,1,2,5,0,4,0,1,0
257,253,253,248,21,19,20,18,1,1,1,3,4,0,5,2,-1,2
548,534,534,524,14,17,15,16,2,2,1,1,14,0,10,-3,2,-1
895,876,867,871,14,14,15,13,1,1,1,1,19,9,-4,0,-1,2
909,904,909,904,21,19,21,19,2,1,1,1,5,-5,5,2,-2,2
946,937,932,937,13,14,13,13,2,3,1,1,9,5,-5,-1,1,0
726,721,717,717,17,16,18,16,3,2,2,1,5,4,0,1,-2,2
515,510,501,506,21,19,18,19,2,3,1,1,5,9,-5,2,1,-1
229,243,234,234,14,17,15,16,2,1,1,1,-14,9,0,-3,2,-1
782,773,778,773,18,19,18,18,1,2,1,2,9,-5,5,-1,1,0
810,806,806,806,14,17,15,16,2,4,3,3,4,0,0,-3,2,-1
365,365,365,365,17,16,18,16,1,2,2,1,0,0,0,1,-2,2
604,600,600,595,14,14,13,13,1,3,2,1,4,0,5,0,1,0
810,815,820,820,14,17,15,16,4,2,1,3,-5,-5,0,-3,2,-1
300,286,281,276,14,14,13,13,2,2,1,2,14,5,5,0,1,0
210,206,206,210,18,17,18,19,2,2,3,1,4,0,-4,1,-1,-1
506,501,496,496,14,14,15,16,1,1,1,1,5,5,0,0,-1,-1
707,703,703,703,17,16,18,16,1,3,2,1,4,0,0,1,-2,2
857,848,848,843,21,19,20,21,1,1,2,3,9,0,5,2,-1,-1
857,848,853,843,14,14,13,13,2,2,2,4,9,-5,10,0,1,0
595,590,595,590,18,19,18,19,2,2,1,2,5,-5,5,-1,1,-1
286,271,276,276,14,14,13,13,3,2,1,2,15,-5,0,0,1,0
253,253,243,243,14,17,15,16,3,1,1,1,0,10,0,-3,2,-1
290,286,290,286,21,19,20,19,2,2,1,1,4,-4,4,2,-1,1
360,356,351,351,13,16,15,16,1,1,2,1,4,5,0,-3,1,-1
623,623,628,628,18,19,18,19,2,2,2,1,0,-5,0,-1,1,-1
932,923,923,923,17,17,18,19,1,2,1,1,9,0,0,0,-1,-1
1021,1012,1003,998,13,14,15,16,2,3,1,2,9,9,5,-1,-1,-1
1026,1026,1026,1021,17,16,18,18,3,1,3,2,0,0,5,1,-2,0
834,824,824,824,18,17,18,16,3,3,1,2,10,0,0,1,-1,2
890,881,876,871,18,19,18,18,1,1,1,1,9,5,5,-1,1,0
815,810,806,801,14,14,13,13,1,1,1,1,5,4,5,0,1,0
220,220,220,220,14,17,15,16,2,1,2,3,0,0,0,-3,2,-1
440,436,426,426,17,16,18,16,3,1,1,4,4,10,0,1,-2,2
698,689,689,684,17,16,18,16,1,1,2,2,9,0,5,1,-2,2
473,468,459,464,17,19,18,18,2,1,1,2,5,9,-5,-2,1,0
459,450,450,450,17,16,18,16,3,2,1,1,9,0,0,1,-2,2
515,515,515,515,18,19,18,19,3,1,2,1,0,0,0,-1,1,-1
557,553,553,557,14,17,15,16,1,2,2,1,4,0,-4,-3,2,-1
637,623,628,623,20,19,18,19,2,2,2,2,14,-5,5,1,1,-1
253,248,253,239,14,17,15,16,1,3,2,4,5,-5,14,-3,2,-1
210,210,206,206,14,14,15,13,2,1,1,3,0,4,0,0,-1,2
473,468,464,459,20,19,20,18,1,3,2,1,5,4,5,1,-1,2
506,501,501,501,18,17,18,19,1,1,1,3,5,0,0,1,-1,-1
426,426,417,412,13,14,15,13,3,1,3,2,0,9,5,-1,-1,2
937,932,932,932,20,19,18,18,1,1,1,2,5,0,0,1,1,0
857,853,843,843,14,14,15,13,1,3,3,3,4,10,0,0,-1,2
557,553,557,557,14,14,13,13,1,3,2,1,4,-4,0,0,1,0
182,1073,1073,1068,14,14,15,13,2,2,1,3,-891,0,5,0,-1,2
581,571,576,576,21,19,20,18,1,2,1,1,10,-5,0,2,-1,2
651,637,628,623,13,14,15,13,2,1,2,2,14,9,5,-1,-1,2
450,440,440,440,13,14,12,13,2,2,1,1,10,0,0,-1,2,-1
239,224,210,206,14,17,15,16,2,2,1,2,15,14,4,-3,2,-1
248,234,234,229,14,14,13,13,2,1,1,3,14,0,5,0,1,0
393,389,389,389,13,14,15,13,2,2,1,2,4,0,0,-1,-1,2
820,815,815,810,18,17,18,19,1,3,2,3,5,0,5,1,-1,-1
248,239,234,234,18,17,18,18,1,2,1,1,9,5,0,1,-1,0
445,436,431,426,20,19,20,21,2,3,2,1,9,5,5,1,-1,-1
782,773,773,773,14,14,12,13,2,2,1,2,9,0,0,0,2,-1
487,407,398,403,14,14,15,16,2,1,1,1,80,9,-5,0,-1,-1
937,923,928,923,13,14,15,16,1,2,1,2,14,-5,5,-1,-1,-1
707,703,703,703,13,16,15,16,3,1,1,1,4,0,0,-3,1,-1
665,651,656,646,13,14,15,13,1,2,2,1,14,-5,10,-1,-1,2
871,853,853,853,14,17,15,16,1,4,1,2,18,0,0,-3,2,-1
1036,1031,1031,1031,13,14,15,13,1,4,3,1,5,0,0,-1,-1,2
389,384,384,374,20,19,20,18,1,1,2,3,5,0,10,1,-1,2
1012,1007,1003,1026,20,19,18,18,2,1,1,1,5,4,-23,1,1,0
820,815,820,815,21,19,20,21,6,2,1,1,5,-5,5,2,-1,-1
679,670,670,670,13,16,15,16,2,2,2,2,9,0,0,-3,1,-1
309,304,304,304,18,19,18,19,1,3,2,3,5,0,0,-1,1,-1
548,543,539,534,14,14,15,13,1,1,1,3,5,4,5,0,-1,2
665,656,651,642,13,14,12,13,3,2,2,2,9,5,9,-1,2,-1
876,871,867,867,18,19,18,18,1,1,2,1,5,4,0,-1,1,0
717,717,717,721,13,14,15,13,3,3,1,3,0,0,-4,-1,-1,2
1054,1045,1040,1040,13,14,12,13,2,2,1,3,9,5,0,-1,2,-1
750,740,750,745,20,19,20,18,3,2,2,1,10,-10,5,1,-1,2
604,600,600,600,14,14,13,13,1,3,1,3,4,0,0,0,1,0
857,853,853,853,18,17,18,16,4,3,2,1,4,0,0,1,-1,2
1007,993,989,998,13,14,12,13,2,3,1,1,14,4,-9,-1,2,-1
848,839,843,839,21,19,20,21,1,3,2,1,9,-4,4,2,-1,-1
651,646,642,642,20,19,20,18,1,3,1,1,5,4,0,1,-1,2
360,346,342,346,13,16,15,16,3,1,1,3,14,4,-4,-3,1,-1
370,360,365,360,13,14,12,13,3,2,2,1,10,-5,5,-1,2,-1
271,271,267,262,14,14,15,13,1,1,3,1,0,4,5,0,-1,2
698,693,689,689,17,16,18,16,3,3,3,1,5,4,0,1,-2,2
365,360,360,360,13,14,12,13,1,3,2,1,5,0,0,-1,2,-1
529,524,515,510,18,17,18,19,2,1,1,1,5,9,5,1,-1,-1
1036,1031,1031,1031,20,19,20,18,2,2,1,1,5,0,0,1,-1,2
286,276,271,271,18,19,18,18,1,1,1,2,10,5,0,-1,1,0
740,731,731,731,17,16,18,16,3,2,3,1,9,0,0,1,-2,2
440,436,436,436,20,19,20,21,1,1,1,1,4,0,0,1,-1,-1
951,946,951,946,20,19,20,21,2,1,2,1,5,-5,5,1,-1,-1
806,801,801,796,21,19,21,21,1,3,2,2,5,0,5,2,-2,0
389,379,379,379,17,19,18,18,2,2,1,1,10,0,0,-2,1,0
979,965,290,974,13,14,18,13,2,2,1,1,14,675,-684,-1,-4,5
857,853,698,853,14,17,20,16,2,1,1,2,4,155,-155,-3,-3,4
750,750,745,745,20,19,18,18,3,1,1,2,0,5,0,1,1,0
342,337,337,332,17,16,15,16,4,3,2,1,5,0,5,1,1,-1
389,393,384,379,13,14,12,13,2,3,3,1,-4,9,5,-1,2,-1
712,698,698,693,13,14,15,13,1,2,1,2,14,0,5,-1,-1,2
965,970,974,979,17,16,18,18,2,1,1,1,-5,-4,-5,1,-2,0
721,712,712,712,13,16,15,16,1,2,1,2,9,0,0,-3,1,-1
614,600,604,604,18,17,18,19,3,5,1,1,14,-4,0,1,-1,-1
698,689,693,693,20,19,20,21,1,1,1,3,9,-4,0,1,-1,-1
492,487,487,487,14,14,13,13,3,1,3,2,5,0,0,0,1,0
1017,1007,1012,1007,17,16,18,18,2,1,1,2,10,-5,5,1,-2,0
431,426,426,421,20,19,20,21,1,2,1,2,5,0,5,1,-1,-1
923,928,928,923,18,19,18,19,2,1,2,3,-5,0,5,-1,1,-1
956,951,951,946,17,16,18,18,1,1,1,2,5,0,5,1,-2,0
1078,1068,1068,1068,17,16,18,18,2,3,1,5,10,0,0,1,-2,0
309,304,304,309,18,17,18,16,4,1,1,3,5,0,-5,1,-1,2
581,562,567,876,14,14,15,11,1,1,1,1,19,-5,-309,0,-1,4
937,923,923,914,17,17,18,19,3,2,2,1,14,0,9,0,-1,-1
646,642,642,642,17,16,18,18,3,1,1,1,4,0,0,1,-2,0
839,829,829,829,14,14,13,13,1,4,1,3,10,0,0,0,1,0
965,960,960,956,20,19,20,21,2,1,2,1,5,0,4,1,-1,-1
487,487,482,487,18,19,21,19,2,3,1,1,0,5,-5,-1,-2,2
192,187,182,182,14,14,15,13,1,3,1,1,5,5,0,0,-1,2
332,328,323,323,20,19,18,19,1,1,2,1,4,5,0,1,1,-1
886,881,881,876,18,17,18,18,1,3,2,1,5,0,5,1,-1,0
295,286,286,286,14,14,13,13,2,2,3,1,9,0,0,0,1,0
426,421,426,421,17,16,18,18,1,3,2,1,5,-5,5,1,-2,0
473,473,468,464,13,14,15,16,3,3,1,2,0,5,4,-1,-1,-1
637,632,628,628,13,14,15,13,2,1,1,1,5,4,0,-1,-1,2
974,974,970,965,17,16,15,16,1,5,2,2,0,4,5,1,1,-1
510,506,506,501,18,19,18,19,1,3,1,1,4,0,5,-1,1,-1
182,182,1073,1073,14,14,12,13,2,1,1,2,0,-891,0,0,2,-1
1036,1031,1031,1031,17,19,18,18,3,2,1,1,5,0,0,-2,1,0
267,257,262,257,18,17,18,18,2,2,1,2,10,-5,5,1,-1,0
914,909,904,904,14,17,15,16,5,1,1,2,5,5,0,-3,2,-1
492,487,487,482,18,19,18,19,1,3,2,2,5,0,5,-1,1,-1
571,567,567,567,14,17,15,16,1,1,1,1,4,0,0,-3,2,-1
515,501,492,487,14,14,15,13,1,1,2,2,14,9,5,0,-1,2
895,890,890,890,18,19,18,19,1,1,1,2,5,0,0,-1,1,-1
853,848,853,848,14,14,13,13,1,3,2,1,5,-5,5,0,1,0
956,956,951,951,17,19,18,18,3,1,1,1,0,5,0,-2,1,0
792,787,787,787,14,17,15,16,3,3,2,1,5,0,0,-3,2,-1
937,923,937,923,13,14,12,13,2,2,2,3,14,-14,14,-1,2,-1
628,618,623,614,14,14,13,13,1,3,2,1,10,-5,9,0,1,0
965,890,890,890,17,17,18,16,2,3,3,1,75,0,0,0,-1,2
515,510,515,515,14,17,15,16,2,2,1,1,5,-5,0,-3,2,-1
956,956,956,956,17,16,18,16,1,2,3,2,0,0,0,1,-2,2
656,646,651,646,13,14,15,13,1,2,2,2,10,-5,5,-1,-1,2
595,576,562,562,18,19,18,18,2,2,3,2,19,14,0,-1,1,0
778,773,778,782,20,19,18,19,2,1,1,1,5,-5,-4,1,1,-1
1021,1021,1021,1017,13,14,12,13,3,4,2,2,0,0,4,-1,2,-1
1021,1017,1017,1017,17,16,18,18,1,2,3,1,4,0,0,1,-2,0
909,904,904,909,18,19,18,19,2,1,1,1,5,0,-5,-1,1,-1
187,1078,1073,1078,18,16,18,18,2,1,1,1,-891,5,-5,2,-2,0
937,932,937,932,13,14,12,13,3,1,2,1,5,-5,5,-1,2,-1
1040,1031,1026,1026,20,19,18,18,1,1,1,3,9,5,0,1,1,0
759,745,745,736,13,14,15,13,3,1,2,2,14,0,9,-1,-1,2
764,750,754,750,13,14,15,13,2,3,1,3,14,-4,4,-1,-1,2
942,937,937,937,13,14,12,13,1,3,2,1,5,0,0,-1,2,-1
520,510,510,510,14,17,15,16,3,2,1,1,10,0,0,-3,2,-1
300,300,337,300,18,19,18,19,1,1,1,2,0,-37,37,-1,1,-1
557,548,689,548,18,19,23,18,1,2,1,1,9,-141,141,-1,-4,5
304,309,309,304,14,17,15,16,2,4,2,1,-5,0,5,-3,2,-1
614,604,604,600,14,14,15,13,1,1,3,1,10,0,4,0,-1,2
196,192,192,192,14,17,15,16,1,2,1,3,4,0,0,-3,2,-1
412,403,403,403,17,16,18,16,1,2,1,1,9,0,0,1,-2,2
1054,1050,1050,1045,13,16,15,16,1,1,2,1,4,0,5,-3,1,-1
562,567,567,571,14,14,15,13,2,1,1,1,-5,0,-4,0,-1,2
820,810,806,810,14,17,15,16,2,1,3,3,10,4,-4,-3,2,-1
412,403,403,417,20,19,20,21,2,2,3,1,9,0,-14,1,-1,-1
262,257,257,253,14,14,15,13,2,2,1,3,5,0,4,0,-1,2
843,834,834,829,18,17,18,16,3,3,2,2,9,0,5,1,-1,2
745,740,731,740,20,19,18,18,2,3,1,2,5,9,-9,1,1,0
567,562,567,562,14,14,13,13,2,2,2,1,5,-5,5,0,1,0
637,637,637,637,20,19,18,18,2,1,2,2,0,0,0,1,1,0
1012,1003,1003,1003,17,16,15,16,2,1,2,1,9,0,0,1,1,-1
553,553,557,557,14,17,15,16,2,2,4,1,0,-4,0,-3,2,-1
960,951,956,951,13,14,15,13,1,2,2,1,9,-5,5,-1,-1,2
215,206,201,201,18,17,18,19,3,1,1,1,9,5,0,1,-1,-1
773,768,764,764,17,16,15,16,3,1,2,1,5,4,0,1,1,-1
754,750,750,745,17,19,18,18,1,3,6,1,4,0,5,-2,1,0
473,468,468,468,20,19,20,21,3,2,1,1,5,0,0,1,-1,-1
524,510,506,496,14,14,15,16,1,4,2,2,14,4,10,0,-1,-1
876,871,867,862,14,14,15,13,3,1,3,2,5,4,5,0,-1,2
543,534,529,524,18,19,18,19,3,1,1,1,9,5,5,-1,1,-1
689,684,689,684,17,16,18,18,1,2,1,2,5,-5,5,1,-2,0
506,496,492,496,14,17,15,16,1,3,1,1,10,4,-4,-3,2,-1
604,595,604,600,18,17,18,16,3,1,2,1,9,-9,4,1,-1,2
360,365,360,360,13,16,15,16,3,3,1,1,-5,5,0,-3,1,-1
712,707,707,703,13,16,15,16,1,2,2,2,5,0,4,-3,1,-1
206,206,206,206,21,19,20,21,1,1,1,1,0,0,0,2,-1,-1
548,539,539,534,18,17,18,16,2,2,3,1,9,0,5,1,-1,2
224,220,220,215,18,17,18,19,3,1,1,1,4,0,5,1,-1,-1
323,318,328,328,14,14,15,13,2,4,2,1,5,-10,0,0,-1,2
848,843,834,834,14,14,15,13,2,1,1,4,5,9,0,0,-1,2
895,886,881,886,14,14,13,13,1,2,2,3,9,5,-5,0,1,0
824,820,820,820,18,19,18,19,1,1,1,3,4,0,0,-1,1,-1
890,886,886,886,18,17,18,16,3,3,3,2,4,0,0,1,-1,2
557,543,543,543,21,19,20,21,1,3,4,1,14,0,0,2,-1,-1
309,300,295,300,14,14,13,13,3,2,3,1,9,5,-5,0,1,0
267,257,262,257,18,19,18,18,3,2,4,1,10,-5,5,-1,1,0
196,196,192,192,14,14,13,13,1,1,3,5,0,4,0,0,1,0
637,623,628,623,13,14,15,13,2,2,1,2,14,-5,5,-1,-1,2
1003,998,993,993,17,16,15,16,1,3,1,1,5,5,0,1,1,-1
257,243,239,239,18,17,18,16,3,1,1,3,14,4,0,1,-1,2
318,314,304,304,14,14,13,13,1,3,2,2,4,10,0,0,1,0
1017,1012,1017,1017,20,19,20,18,2,2,1,1,5,-5,0,1,-1,2
754,750,750,754,20,19,20,18,1,2,1,1,4,0,-4,1,-1,2
726,721,717,717,13,14,12,13,1,4,2,1,5,4,0,-1,2,-1
764,754,754,764,17,16,18,16,1,2,1,1,10,0,-10,1,-2,2
646,637,637,637,17,16,18,18,2,2,3,1,9,0,0,1,-2,0
342,332,337,337,13,14,15,16,1,2,2,3,10,-5,0,-1,-1,-1
773,773,778,778,20,19,18,18,1,3,2,1,0,-5,0,1,1,0
426,417,421,426,13,14,15,13,1,1,2,1,9,-4,-5,-1,-1,2
960,951,951,951,13,14,12,13,1,1,3,2,9,0,0,-1,2,-1
684,674,679,674,13,14,12,13,4,2,3,2,10,-5,5,-1,2,-1
689,679,679,674,17,19,18,18,2,1,1,2,10,0,5,-2,1,0
562,553,548,548,18,19,18,18,1,1,1,2,9,5,0,-1,1,0
928,923,918,918,21,19,21,21,1,3,1,1,5,5,0,2,-2,0
998,993,1007,1007,20,19,20,21,2,1,2,1,5,-14,0,1,-1,-1
942,932,942,937,13,14,15,13,1,2,4,1,10,-10,5,-1,-1,2
393,379,379,370,20,19,20,18,2,2,2,1,14,0,9,1,-1,2
262,257,262,262,18,17,18,16,2,2,1,1,5,-5,0,1,-1,2
909,900,900,895,14,14,15,16,2,2,2,2,9,0,5,0,-1,-1
651,637,646,651,13,14,15,16,3,1,1,1,14,-9,-5,-1,-1,-1
1064,1054,1050,1050,13,14,12,13,1,2,3,1,10,4,0,-1,2,-1
717,712,712,712,17,16,15,16,1,2,2,3,5,0,0,1,1,-1
642,632,637,632,17,19,18,18,2,2,2,1,10,-5,5,-2,1,0
351,342,346,342,13,16,15,16,1,2,1,2,9,-4,4,-3,1,-1
210,206,206,206,21,19,20,21,2,4,1,1,4,0,0,2,-1,-1
374,370,370,370,20,19,20,18,1,2,1,1,4,0,0,1,-1,2
224,215,220,215,18,19,18,19,1,2,1,2,9,-5,5,-1,1,-1
1017,1017,1017,1017,20,19,18,18,3,1,1,1,0,0,0,1,1,0
1040,1040,1040,1040,17,16,15,16,1,2,1,2,0,0,0,1,1,-1
1040,1040,1040,1036,13,16,15,16,3,1,2,2,0,0,4,-3,1,-1
773,768,768,768,17,16,18,16,2,3,3,2,5,0,0,1,-2,2
492,487,478,473,14,14,15,13,2,2,1,2,5,9,5,0,-1,2
576,562,557,557,14,14,13,13,1,2,2,1,14,5,0,0,1,0
632,632,646,646,17,19,18,18,1,1,1,2,0,-14,0,-2,1,0
1036,1036,1036,1036,13,14,12,13,2,1,2,3,0,0,0,-1,2,-1
262,253,257,262,18,19,18,18,3,2,1,1,9,-4,-5,-1,1,0
764,646,651,656,20,19,18,18,1,1,4,1,118,-5,-5,1,1,0
1064,1059,1059,1059,13,14,15,13,2,1,1,1,5,0,0,-1,-1,2
960,956,960,956,17,16,15,16,3,1,2,1,4,-4,4,1,1,-1
417,407,407,403,20,19,18,18,3,2,2,2,10,0,4,1,1,0
464,454,459,459,13,14,12,13,1,3,1,1,10,-5,0,-1,2,-1
295,290,281,276,14,14,15,16,1,1,3,2,5,9,5,0,-1,-1
787,782,773,773,14,17,15,16,3,2,1,2,5,9,0,-3,2,-1
1068,1064,1059,1054,20,19,20,21,1,3,2,1,4,5,5,1,-1,-1
473,468,468,468,20,19,20,18,4,2,1,1,5,0,0,1,-1,2
389,384,379,379,20,19,20,21,1,1,1,1,5,5,0,1,-1,-1
192,182,182,182,18,19,18,19,3,2,1,1,10,0,0,-1,1,-1
595,586,590,595,21,19,20,21,1,1,1,2,9,-4,-5,2,-1,-1
712,707,712,707,20,19,20,18,1,2,2,1,5,-5,5,1,-1,2
820,810,815,810,14,17,15,16,1,2,1,1,10,-5,5,-3,2,-1
674,670,689,703,20,19,20,21,2,1,1,1,4,-19,-14,1,-1,-1
721,717,717,764,20,19,20,18,2,3,1,1,4,0,-47,1,-1,2
871,862,862,867,21,19,20,21,1,3,1,1,9,0,-5,2,-1,-1
553,553,553,548,14,14,15,16,2,3,2,1,0,0,5,0,-1,-1
286,276,271,271,18,17,18,18,1,2,1,1,10,5,0,1,-1,0
778,773,768,764,20,19,20,21,2,1,2,2,5,5,4,1,-1,-1
318,309,304,309,18,17,18,16,1,3,1,2,9,5,-5,1,-1,2
534,529,524,529,18,17,18,19,2,2,1,1,5,5,-5,1,-1,-1
881,876,890,871,18,19,18,18,3,1,1,2,5,-14,19,-1,1,0
271,271,262,262,21,19,20,18,1,1,1,1,0,9,0,2,-1,2
787,782,792,782,14,14,13,13,1,2,2,1,5,-10,10,0,1,0
595,590,586,586,14,17,15,16,5,3,1,1,5,4,0,-3,2,-1
792,782,787,787,21,19,21,19,2,1,2,1,10,-5,0,2,-2,2
515,506,510,510,14,14,13,13,2,1,4,1,9,-4,0,0,1,0
604,600,600,600,14,14,15,16,1,2,2,1,4,0,0,0,-1,-1
459,454,454,454,17,16,18,18,3,1,1,1,5,0,0,1,-2,0
618,623,623,618,14,17,15,16,2,2,1,2,-5,0,5,-3,2,-1
290,290,290,286,18,17,18,19,1,1,3,1,0,0,4,1,-1,-1
965,951,946,946,13,14,12,13,2,2,3,1,14,5,0,-1,2,-1
473,459,454,450,17,16,18,18,2,2,2,2,14,5,4,1,-2,0
848,843,843,843,21,19,20,18,3,1,1,2,5,0,0,2,-1,2
501,487,482,482,14,14,13,13,2,2,1,1,14,5,0,0,1,0
600,595,600,595,14,14,15,13,2,2,2,2,5,-5,5,0,-1,2
187,182,1078,1078,18,17,18,18,1,2,1,1,5,-896,0,1,-1,0
773,764,764,764,20,19,20,21,2,3,3,1,9,0,0,1,-1,-1
782,787,782,782,14,17,15,16,1,1,1,1,-5,5,0,-3,2,-1
979,965,960,960,13,14,12,13,2,2,1,1,14,5,0,-1,2,-1
1007,1007,1003,998,13,14,15,16,3,3,3,2,0,4,5,-1,-1,-1
960,895,890,890,13,14,13,13,2,2,1,1,65,5,0,-1,1,0
810,810,810,806,14,17,15,16,1,4,4,2,0,0,4,-3,2,-1
857,853,853,857,21,19,20,18,1,1,1,3,4,0,-4,2,-1,2
782,782,782,782,18,19,18,19,2,2,1,1,0,0,0,-1,1,-1
890,886,886,886,14,17,15,16,3,2,1,2,4,0,0,-3,2,-1
1054,1045,1073,1050,13,14,12,13,1,2,1,3,9,-28,23,-1,2,-1
290,286,290,286,14,14,13,13,2,2,2,1,4,-4,4,0,1,0
445,440,440,440,13,14,15,16,1,3,1,2,5,0,0,-1,-1,-1
440,440,440,436,13,14,12,13,1,1,2,3,0,0,4,-1,2,-1
679,674,679,679,13,16,15,16,3,3,2,1,5,-5,0,-3,1,-1
393,384,379,384,13,14,15,13,3,1,1,1,9,5,-5,-1,-1,2
768,759,764,768,20,19,18,18,3,2,2,3,9,-5,-4,1,1,0
679,670,674,670,20,19,20,21,2,2,2,2,9,-4,4,1,-1,-1
843,843,839,834,14,17,15,16,1,3,1,1,0,4,5,-3,2,-1
309,309,304,304,21,19,20,21,1,1,3,2,0,5,0,2,-1,-1
628,618,614,614,14,14,15,13,1,1,2,1,10,4,0,0,-1,2
717,717,717,712,17,16,15,16,3,1,1,3,0,0,5,1,1,-1
618,614,614,614,14,14,15,13,1,5,1,1,4,0,0,0,-1,2
693,679,679,679,13,14,12,13,2,2,3,1,14,0,0,-1,2,-1
623,618,618,614,14,14,13,13,1,1,2,2,5,0,4,0,1,0
510,506,510,510,21,19,20,21,1,2,2,1,4,-4,0,2,-1,-1
642,632,637,642,20,19,18,18,1,2,1,1,10,-5,-5,1,1,0
618,614,614,609,21,19,21,19,2,2,1,1,4,0,5,2,-2,2
224,215,215,215,21,19,20,21,2,1,1,1,9,0,0,2,-1,-1
365,360,360,356,17,16,15,16,2,1,2,3,5,0,4,1,1,-1
210,210,206,206,14,14,15,16,3,2,2,2,0,4,0,0,-1,-1
609,604,600,595,14,14,15,13,1,2,2,3,5,4,5,0,-1,2
806,801,801,801,18,17,18,16,3,3,1,1,5,0,0,1,-1,2
674,670,665,665,13,14,12,13,2,2,4,1,4,5,0,-1,2,-1
590,581,576,581,14,14,13,13,3,3,3,3,9,5,-5,0,1,0
492,487,487,487,18,19,21,19,2,1,1,1,5,0,0,-1,-2,2
764,754,754,750,17,16,18,18,2,2,4,1,10,0,4,1,-2,0
234,224,220,220,18,17,18,16,2,3,4,2,10,4,0,1,-1,2
759,750,754,750,20,19,20,21,5,2,1,1,9,-4,4,1,-1,-1
923,904,895,895,14,17,15,16,3,2,2,1,19,9,0,-3,2,-1
1068,1073,1068,1068,13,14,15,13,1,3,1,1,-5,5,0,-1,-1,2
787,782,787,792,18,17,15,16,3,1,2,1,5,-5,-5,1,2,-1
478,473,473,473,20,19,18,18,1,2,1,2,5,0,0,1,1,0
1021,1017,1012,1012,17,16,18,18,1,3,1,2,4,5,0,1,-2,0
201,206,201,206,21,19,21,19,2,1,2,1,-5,5,-5,2,-2,2
764,754,750,750,13,14,12,13,2,2,3,3,10,4,0,-1,2,-1
820,829,824,820,14,14,13,13,2,3,2,1,-9,5,4,0,1,0
510,496,492,487,14,14,13,13,1,2,5,2,14,4,5,0,1,0
436,431,421,417,20,19,20,21,3,1,1,1,5,10,4,1,-1,-1
548,543,543,543,21,19,20,18,1,1,3,1,5,0,0,2,-1,2
286,281,286,281,18,19,18,19,1,2,2,1,5,-5,5,-1,1,-1
923,918,918,918,21,19,21,19,2,2,1,1,5,0,0,2,-2,2
506,496,496,496,18,19,18,19,1,2,3,1,10,0,0,-1,1,-1
810,801,806,806,18,19,18,19,3,2,1,1,9,-5,0,-1,1,-1
426,417,417,417,17,16,18,18,2,1,3,1,9,0,0,1,-2,0
778,773,787,792,20,19,21,21,2,2,1,2,5,-14,-5,1,-2,0
346,346,346,342,13,14,15,13,1,2,2,1,0,0,4,-1,-1,2
506,501,501,496,18,19,18,19,2,2,3,2,5,0,5,-1,1,-1
450,440,440,445,20,19,20,18,2,1,1,1,10,0,-5,1,-1,2
712,707,707,707,13,14,15,13,2,1,1,2,5,0,0,-1,-1,2
689,689,693,684,20,19,20,21,3,1,2,1,0,-4,9,1,-1,-1
815,815,815,815,14,14,13,13,1,1,1,2,0,0,0,0,1,0
946,942,942,946,13,14,15,13,1,1,3,2,4,0,-4,-1,-1,2
979,979,974,974,17,16,15,16,1,3,2,2,0,5,0,1,1,-1
989,993,993,993,17,16,18,16,1,2,3,1,-4,0,0,1,-2,2
1040,1031,1031,1031,13,16,15,16,3,2,1,1,9,0,0,-3,1,-1
909,904,904,904,21,19,20,21,3,2,1,1,5,0,0,2,-1,-1
412,407,403,403,20,19,20,18,2,2,2,1,5,4,0,1,-1,2
820,806,810,810,21,19,20,19,3,2,1,2,14,-4,0,2,-1,1
684,679,674,674,13,14,15,16,3,2,1,1,5,5,0,-1,-1,-1
454,436,436,440,20,19,20,21,2,1,4,1,18,0,-4,1,-1,-1
651,637,632,637,13,16,15,16,2,2,1,1,14,5,-5,-3,1,-1
342,332,328,328,13,14,13,13,2,2,1,1,10,4,0,-1,1,0
229,220,243,220,14,14,13,13,2,2,2,1,9,-23,23,0,1,0
909,904,900,904,21,19,20,19,1,1,1,1,5,4,-4,2,-1,1
843,843,839,834,14,14,15,16,1,1,3,1,0,4,5,0,-1,-1
295,290,295,290,14,17,15,16,1,3,2,1,5,-5,5,-3,2,-1
1007,998,993,993,13,14,15,13,2,3,2,2,9,5,0,-1,-1,2
496,487,482,487,14,14,15,13,2,1,1,1,9,5,-5,0,-1,2
717,712,712,712,13,14,15,13,2,1,2,1,5,0,0,-1,-1,2
346,342,342,337,20,19,20,21,1,2,2,2,4,0,5,1,-1,-1
946,942,942,937,13,14,12,13,1,2,2,2,4,0,5,-1,2,-1
998,998,993,993,20,19,18,18,3,1,1,1,0,5,0,1,1,0
337,323,328,323,17,17,15,16,3,2,1,2,14,-5,5,0,2,-1
206,192,192,196,14,14,13,13,4,1,1,1,14,0,-4,0,1,0
834,834,839,834,18,19,18,18,2,1,2,2,0,-5,5,-1,1,0
496,492,492,492,18,17,18,19,1,2,3,2,4,0,0,1,-1,-1
848,843,839,839,21,19,20,18,2,2,1,1,5,4,0,2,-1,2
586,576,571,571,21,19,20,18,2,1,1,1,10,5,0,2,-1,2
787,782,773,773,21,19,20,21,2,2,1,2,5,9,0,2,-1,-1
182,1073,1068,1064,21,19,20,21,2,2,1,2,-891,5,4,2,-1,-1
421,417,421,421,20,19,20,18,1,2,2,1,4,-4,0,1,-1,2
651,651,651,646,13,16,15,16,1,1,1,2,0,0,5,-3,1,-1
374,374,370,374,13,14,12,13,1,1,3,1,0,4,-4,-1,2,-1
960,956,956,956,20,19,20,18,1,1,1,1,4,0,0,1,-1,2
187,1068,1064,1059,14,14,12,13,1,2,3,1,-881,4,5,0,2,-1
773,768,773,773,20,19,20,21,1,2,2,1,5,-5,0,1,-1,-1
712,703,703,703,20,19,20,18,3,1,1,1,9,0,0,1,-1,2
323,318,314,309,14,14,15,13,2,1,1,1,5,4,5,0,-1,2
834,834,834,834,18,19,18,18,1,1,1,1,0,0,0,-1,1,0
482,473,473,468,14,14,12,13,1,2,1,1,9,0,5,0,2,-1
1003,998,993,993,13,14,12,13,2,3,3,1,5,5,0,-1,2,-1
192,182,192,187,14,14,13,13,1,2,2,2,10,-10,5,0,1,0
206,206,206,206,14,14,15,13,2,1,3,1,0,0,0,0,-1,2
248,243,239,239,14,14,13,13,1,2,1,2,5,4,0,0,1,0
281,281,271,271,18,17,18,18,1,1,3,1,0,10,0,1,-1,0
801,792,792,792,21,19,21,21,1,2,3,3,9,0,0,2,-2,0
374,370,370,370,17,16,18,16,3,2,1,1,4,0,0,1,-2,2
206,206,201,201,21,19,21,19,1,1,1,1,0,5,0,2,-2,2
651,646,651,646,17,16,18,16,3,3,2,2,5,-5,5,1,-2,2
914,909,909,909,21,19,21,21,2,2,1,1,5,0,0,2,-2,0
651,642,646,642,20,19,20,18,1,2,2,1,9,-4,4,1,-1,2
318,314,309,314,18,17,18,16,2,1,3,1,4,5,-5,1,-1,2
529,524,524,524,21,19,20,21,2,1,2,1,5,0,0,2,-1,-1
796,782,778,778,18,19,18,18,2,2,2,1,14,4,0,-1,1,0
768,764,768,768,13,14,15,13,3,2,3,1,4,-4,0,-1,-1,2
454,450,445,440,13,14,12,13,2,2,1,1,4,5,5,-1,2,-1
459,454,459,450,20,19,20,18,3,1,2,2,5,-5,9,1,-1,2
787,782,782,782,21,19,21,19,1,1,1,1,5,0,0,2,-2,2
590,595,600,600,14,14,13,13,4,2,3,1,-5,-5,0,0,1,0
937,932,923,928,13,14,15,13,2,1,1,1,5,9,-5,-1,-1,2
623,618,618,614,14,14,15,13,3,1,3,1,5,0,4,0,-1,2
239,234,229,229,14,14,13,13,3,1,2,1,5,5,0,0,1,0
834,824,834,834,14,14,15,16,2,2,1,1,10,-10,0,0,-1,-1
192,187,187,187,18,17,18,19,1,3,1,2,5,0,0,1,-1,-1
393,389,393,398,20,19,18,18,1,3,1,1,4,-4,-5,1,1,0
707,703,693,689,13,14,12,13,1,3,1,1,4,10,4,-1,2,-1
693,689,693,693,17,19,18,18,2,2,1,1,4,-4,0,-2,1,0
923,914,914,914,14,14,13,13,3,1,1,2,9,0,0,0,1,0
609,604,609,609,18,17,18,19,2,2,1,1,5,-5,0,1,-1,-1
970,965,960,960,13,14,15,13,1,3,1,5,5,5,0,-1,-1,2
267,248,243,243,14,14,15,13,1,2,1,1,19,5,0,0,-1,2
989,979,979,974,17,16,18,18,2,3,3,2,10,0,5,1,-2,0
642,637,637,637,13,14,15,13,1,2,3,1,5,0,0,-1,-1,2
389,389,379,374,13,14,12,13,2,1,1,3,0,10,5,-1,2,-1
323,323,323,323,18,17,18,19,2,3,3,1,0,0,0,1,-1,-1
914,904,900,895,21,19,20,21,1,3,1,4,10,4,5,2,-1,-1
824,824,824,820,14,14,13,13,2,3,1,3,0,0,4,0,1,0
848,848,839,843,18,19,18,18,2,3,3,1,0,9,-4,-1,1,0
201,196,192,192,14,14,13,13,1,2,2,1,5,4,0,0,1,0
829,829,820,820,14,14,13,13,1,3,1,3,0,9,0,0,1,0
768,759,768,768,17,19,18,18,1,2,1,1,9,-9,0,-2,1,0
482,473,468,468,21,19,20,21,1,1,1,1,9,5,0,2,-1,-1
871,801,796,796,18,17,15,16,1,1,1,3,70,5,0,1,2,-1
360,360,356,351,13,14,12,13,2,3,1,1,0,4,5,-1,2,-1
1021,1017,1021,1017,17,16,18,18,1,1,4,1,4,-4,4,1,-2,0
609,609,609,614,14,17,15,16,2,2,1,1,0,0,-5,-3,2,-1
1040,1036,1036,1040,20,19,20,21,2,1,1,3,4,0,-4,1,-1,-1
374,379,374,374,13,14,12,13,3,3,2,2,-5,5,0,-1,2,-1
646,646,646,642,17,19,18,18,2,1,2,1,0,0,4,-2,1,0
609,604,609,609,18,19,18,19,1,2,2,2,5,-5,0,-1,1,-1
510,506,506,496,14,14,13,13,1,3,1,4,4,0,10,0,1,0
262,243,248,248,14,14,13,13,3,1,1,2,19,-5,0,0,1,0
571,567,571,571,14,14,15,13,1,2,1,1,4,-4,0,0,-1,2
450,440,445,445,13,14,15,13,2,2,2,1,10,-5,0,-1,-1,2
576,576,576,576,14,17,15,16,2,1,2,1,0,0,0,-3,2,-1
201,192,196,196,18,19,18,19,4,2,1,2,9,-4,0,-1,1,-1
1054,1040,1050,1050,20,19,20,18,2,1,1,1,14,-10,0,1,-1,2
1017,1012,1007,1007,17,16,18,16,1,4,1,2,5,5,0,1,-2,2
637,618,637,642,13,14,15,13,2,2,2,3,19,-19,-5,-1,-1,2
787,787,787,782,21,19,21,21,2,2,2,1,0,0,5,2,-2,0
1040,1036,1040,1036,13,16,15,16,1,1,2,1,4,-4,4,-3,1,-1
445,436,440,440,20,19,18,18,2,2,3,1,9,-4,0,1,1,0
262,248,257,253,14,14,15,16,1,2,1,2,14,-9,4,0,-1,-1
1068,1059,1064,1059,13,14,12,13,2,2,3,1,9,-5,5,-1,2,-1
773,768,764,764,17,16,18,16,1,1,1,2,5,4,0,1,-2,2
886,886,886,876,14,14,13,13,2,1,1,2,0,0,10,0,1,0
196,192,192,192,14,14,13,13,1,3,1,3,4,0,0,0,1,0
459,445,445,445,13,14,15,13,2,4,1,2,14,0,0,-1,-1,2
862,857,857,857,21,19,20,21,1,1,1,1,5,0,0,2,-1,-1
698,698,693,693,20,19,18,18,2,3,2,1,0,5,0,1,1,0
646,642,642,642,13,14,15,13,1,2,3,3,4,0,0,-1,-1,2
314,309,314,314,18,17,18,16,3,2,2,1,5,-5,0,1,-1,2
234,234,229,229,21,19,20,21,3,1,1,1,0,5,0,2,-1,-1
309,304,300,300,21,19,20,21,3,3,1,1,5,4,0,2,-1,-1
1012,1012,1007,1012,17,16,18,16,1,3,1,1,0,5,-5,1,-2,2
1007,1003,1003,1003,17,19,18,18,2,2,3,2,4,0,0,-2,1,0
632,604,604,604,17,17,15,16,1,1,1,2,28,0,0,0,2,-1
1068,1068,1068,1064,20,19,20,21,1,2,2,1,0,0,4,1,-1,-1
937,928,923,918,20,19,21,21,2,1,2,1,9,5,5,1,-2,0
857,853,857,853,21,19,20,18,3,1,2,3,4,-4,4,2,-1,2
417,412,412,412,13,14,15,13,2,2,1,3,5,0,0,-1,-1,2
529,529,529,524,14,14,15,13,2,2,2,2,0,0,5,0,-1,2
590,590,586,581,18,17,18,16,3,3,3,4,0,4,5,1,-1,2
815,810,810,806,18,17,18,16,2,1,3,3,5,0,4,1,-1,2
370,365,360,365,20,19,20,18,1,2,1,1,5,5,-5,1,-1,2
412,407,403,403,20,19,18,18,2,1,2,1,5,4,0,1,1,0
487,482,478,478,21,19,20,21,1,2,1,1,5,4,0,2,-1,-1
590,576,571,571,18,19,18,18,2,2,1,2,14,5,0,-1,1,0
736,736,736,736,20,19,20,21,1,1,1,1,0,0,0,1,-1,-1
487,473,468,464,21,19,20,18,2,2,1,1,14,5,4,2,-1,2
768,778,773,778,13,16,15,16,1,1,1,1,-10,5,-5,-3,1,-1
271,257,257,257,14,14,13,13,1,2,3,1,14,0,0,0,1,0
553,548,548,543,14,14,13,13,1,1,2,5,5,0,5,0,1,0
384,374,365,365,17,16,15,16,1,3,1,1,10,9,0,1,1,-1
398,393,393,393,17,16,18,18,3,1,1,1,5,0,0,1,-2,0
539,534,534,534,18,17,18,18,3,1,1,1,5,0,0,1,-1,0
862,862,862,862,14,14,15,13,3,3,1,3,0,0,0,0,-1,2
342,342,342,337,13,16,15,16,1,4,3,1,0,0,5,-3,1,-1
360,365,360,351,20,19,20,18,1,1,1,2,-5,5,9,1,-1,2
520,515,515,510,14,14,15,13,3,2,2,1,5,0,5,0,-1,2
487,482,487,487,21,19,21,21,1,2,1,1,5,-5,0,2,-2,0
946,951,946,946,13,14,12,13,1,3,1,2,-5,5,0,-1,2,-1
1012,1012,1017,1012,20,19,20,21,1,1,2,1,0,-5,5,1,-1,-1
379,370,365,360,17,16,18,16,1,2,1,1,9,5,5,1,-2,2
595,590,586,586,18,19,18,19,2,1,1,1,5,4,0,-1,1,-1
581,581,581,576,14,14,15,13,2,2,3,2,0,0,5,0,-1,2
890,886,886,890,18,17,18,16,3,3,1,1,4,0,-4,1,-1,2
206,196,201,201,14,14,13,13,1,1,2,3,10,-5,0,0,1,0
656,651,646,646,13,14,12,13,1,3,2,1,5,5,0,-1,2,-1
857,853,848,848,14,17,15,16,3,1,3,1,4,5,0,-3,2,-1
651,651,651,642,20,19,18,18,1,3,2,2,0,0,9,1,1,0
839,834,839,839,18,17,18,18,3,2,1,1,5,-5,0,1,-1,0
736,731,736,736,17,16,15,16,1,2,2,1,5,-5,0,1,1,-1
314,314,309,314,18,17,18,19,2,1,1,2,0,5,-5,1,-1,-1
1036,1026,1031,1031,17,16,18,16,2,2,1,1,10,-5,0,1,-2,2
220,220,224,215,14,17,15,16,3,3,2,2,0,-4,9,-3,2,-1
726,726,721,721,13,16,15,16,1,2,1,1,0,5,0,-3,1,-1
951,942,942,942,17,19,18,18,3,1,1,1,9,0,0,-2,1,0
937,937,923,928,13,14,13,13,1,1,1,1,0,14,-5,-1,1,0
473,468,468,468,20,19,20,21,1,2,1,3,5,0,0,1,-1,-1
773,768,768,768,20,19,20,18,1,2,2,1,5,0,0,1,-1,2
581,571,571,571,18,19,20,18,3,1,1,2,10,0,0,-1,-1,2
1073,1073,1078,1068,13,16,15,16,2,1,1,1,0,-5,10,-3,1,-1
248,234,229,229,14,14,13,13,1,1,1,1,14,5,0,0,1,0
754,750,750,745,17,16,18,18,3,2,3,2,4,0,5,1,-2,0
595,590,590,586,18,19,18,19,3,1,1,2,5,0,4,-1,1,-1
576,571,571,571,18,19,18,18,3,1,2,1,5,0,0,-1,1,0
867,857,857,848,14,14,13,13,1,3,2,2,10,0,9,0,1,0
886,876,871,867,18,19,18,18,2,2,1,1,10,5,4,-1,1,0
290,286,281,281,14,17,15,16,3,3,1,1,4,5,0,-3,2,-1
586,576,590,586,21,19,20,21,1,3,2,2,10,-14,4,2,-1,-1
398,389,393,389,13,14,12,13,3,2,1,2,9,-4,4,-1,2,-1
557,782,562,557,14,14,15,16,2,1,2,2,-225,220,5,0,-1,-1
956,956,956,956,13,14,15,13,1,1,3,5,0,0,0,-1,-1,2
1026,1021,1021,1021,17,16,15,16,1,2,3,1,5,0,0,1,1,-1
660,646,646,651,13,14,15,13,1,2,1,3,14,0,-5,-1,-1,2
1059,1045,1050,1050,17,16,18,18,2,2,1,1,14,-5,0,1,-2,0
337,323,328,323,13,14,15,13,1,2,1,2,14,-5,5,-1,-1,2
792,773,773,768,14,16,15,16,3,2,2,1,19,0,5,-2,1,-1
984,974,974,974,17,16,15,16,1,2,1,1,10,0,0,1,1,-1
1059,1050,1050,1050,17,16,18,16,1,2,1,2,9,0,0,1,-2,2
529,534,529,529,21,19,20,19,1,1,2,1,-5,5,0,2,-1,1
567,567,567,562,18,19,18,18,2,1,1,2,0,0,5,-1,1,0
773,764,764,759,20,19,20,18,4,2,1,1,9,0,5,1,-1,2
806,796,796,801,18,19,18,19,3,2,1,3,10,0,-5,-1,1,-1
904,904,904,956,21,19,20,21,1,4,2,3,0,0,-52,2,-1,-1
426,421,421,426,20,19,20,21,1,2,1,1,5,0,-5,1,-1,-1
501,496,492,496,14,14,13,13,1,4,1,1,5,4,-4,0,1,0
759,750,745,745,13,14,15,13,2,3,3,2,9,5,0,-1,-1,2
417,407,407,403,17,19,18,18,1,2,1,2,10,0,4,-2,1,0
651,642,651,646,17,19,18,18,2,2,2,1,9,-9,5,-2,1,0
182,1073,1073,1073,14,16,15,16,2,2,1,1,-891,0,0,-2,1,-1
318,318,314,304,18,17,18,16,1,3,2,2,0,4,10,1,-1,2
834,829,834,839,18,17,18,18,2,2,3,1,5,-5,-5,1,-1,0
768,764,768,764,20,19,18,18,1,2,2,1,4,-4,4,1,1,0
210,210,206,210,14,14,15,13,2,2,1,3,0,4,-4,0,-1,2
923,923,918,923,21,19,21,19,2,1,1,1,0,5,-5,2,-2,2
220,206,656,220,14,17,15,16,2,2,1,2,14,-450,436,-3,2,-1
436,431,431,426,17,16,15,16,2,2,2,2,5,0,5,1,1,-1
848,839,834,839,14,14,15,16,2,3,2,1,9,5,-5,0,-1,-1
857,843,848,843,14,14,13,13,3,2,2,3,14,-5,5,0,1,0
745,740,745,740,13,14,12,13,1,2,2,3,5,-5,5,-1,2,-1
876,867,871,871,21,19,20,21,3,1,1,1,9,-4,0,2,-1,-1
857,853,848,843,18,17,18,18,1,1,1,2,4,5,5,1,-1,0
286,281,286,286,14,17,15,16,2,4,1,1,5,-5,0,-3,2,-1
271,257,248,243,14,14,15,13,1,4,1,2,14,9,5,0,-1,2
1068,1064,1073,848,17,16,18,13,1,2,3,1,4,-9,225,1,-2,5
895,890,890,895,18,19,18,19,2,3,1,1,5,0,-5,-1,1,-1
286,281,290,286,14,14,15,16,1,4,2,1,5,-9,4,0,-1,-1
736,731,731,731,17,16,15,16,1,2,3,3,5,0,0,1,1,-1
243,239,243,239,18,19,18,18,2,1,3,2,4,-4,4,-1,1,0
431,421,426,426,20,19,18,18,4,2,2,1,10,-5,0,1,1,0
365,356,351,351,13,14,12,13,1,3,1,1,9,5,0,-1,2,-1
979,979,979,974,13,14,15,13,2,1,2,2,0,0,5,-1,-1,2
960,946,951,951,13,14,12,13,1,2,4,2,14,-5,0,-1,2,-1
623,618,623,623,18,17,18,19,1,2,2,1,5,-5,0,1,-1,-1
482,482,478,473,14,17,15,16,2,2,1,3,0,4,5,-3,2,-1
342,337,332,332,20,19,20,21,1,2,1,2,5,5,0,1,-1,-1
529,524,595,539,18,17,18,18,1,3,1,4,5,-71,56,1,-1,0
914,909,914,909,21,19,21,19,1,2,2,1,5,-5,5,2,-2,2
553,548,543,543,14,17,15,16,3,4,1,2,5,5,0,-3,2,-1
946,942,946,946,20,19,20,21,3,1,1,1,4,-4,0,1,-1,-1
900,895,895,895,18,19,20,19,1,2,1,1,5,0,0,-1,-1,1
403,389,398,393,13,14,15,16,2,4,2,2,14,-9,5,-1,-1,-1
773,778,773,773,20,19,20,21,1,1,3,3,-5,5,0,1,-1,-1
351,342,337,342,13,14,15,13,1,3,1,1,9,5,-5,-1,-1,2
314,309,309,309,14,14,13,13,3,2,1,1,5,0,0,0,1,0
628,618,614,614,18,17,18,19,1,2,2,2,10,4,0,1,-1,-1
1031,1031,1036,1036,13,16,15,16,1,1,1,2,0,-5,0,-3,1,-1
993,993,989,984,17,16,18,16,2,2,1,1,0,4,5,1,-2,2
1031,1021,1026,1017,13,14,15,13,2,2,2,2,10,-5,9,-1,-1,2
881,876,876,876,18,19,18,18,1,1,2,1,5,0,0,-1,1,0
506,487,496,496,14,17,15,16,2,2,3,1,19,-9,0,-3,2,-1
309,300,300,300,14,14,13,13,2,2,1,2,9,0,0,0,1,0
253,243,248,243,18,19,18,18,1,2,2,4,10,-5,5,-1,1,0
581,576,576,576,14,14,15,16,4,1,3,2,5,0,0,0,-1,-1
295,295,290,295,18,17,18,19,4,1,1,1,0,5,-5,1,-1,-1
487,468,464,459,18,16,18,16,1,3,2,2,19,4,5,2,-2,2
370,365,365,360,13,14,15,13,1,3,3,1,5,0,5,-1,-1,2
1054,1040,1031,1026,13,14,15,13,3,3,2,1,14,9,5,-1,-1,2
604,604,604,604,14,17,15,16,1,1,1,1,0,0,0,-3,2,-1
810,810,806,806,14,17,15,16,1,1,2,5,0,4,0,-3,2,-1
890,876,876,871,14,17,15,16,2,1,1,2,14,0,5,-3,2,-1
300,290,290,290,14,17,15,16,1,4,2,1,10,0,0,-3,2,-1
398,389,393,384,20,19,20,18,1,2,1,2,9,-4,9,1,-1,2
782,768,764,764,21,19,20,21,1,1,1,1,14,4,0,2,-1,-1
187,1078,1068,1064,14,14,12,13,1,1,2,1,-891,10,4,0,2,-1
759,754,759,754,13,14,15,13,2,2,2,2,5,-5,5,-1,-1,2
234,229,229,229,18,17,18,16,1,3,1,1,5,0,0,1,-1,2
262,257,253,248,14,14,15,13,3,1,3,2,5,4,5,0,-1,2
717,707,712,712,13,14,15,16,2,3,1,3,10,-5,0,-1,-1,-1
243,243,243,243,18,19,18,18,1,2,1,1,0,0,0,-1,1,0
496,487,496,492,18,17,18,16,2,2,2,1,9,-9,4,1,-1,2
750,740,731,736,13,14,15,16,1,3,1,1,10,9,-5,-1,-1,-1
323,323,323,318,14,14,13,13,2,2,2,2,0,0,5,0,1,0
979,970,965,965,17,19,18,18,1,2,1,1,9,5,0,-2,1,0
374,370,365,365,13,14,12,13,3,2,3,2,4,5,0,-1,2,-1
304,286,286,286,14,17,15,16,3,2,3,1,18,0,0,-3,2,-1
337,323,318,314,13,14,13,13,1,2,1,2,14,5,4,-1,1,0
871,871,867,867,18,17,18,18,2,2,1,1,0,4,0,1,-1,0
379,374,379,384,20,19,20,18,1,1,2,1,5,-5,-5,1,-1,2
614,604,614,614,14,14,15,13,1,2,2,3,10,-10,0,0,-1,2
496,492,501,496,18,19,18,19,2,1,2,1,4,-9,5,-1,1,-1
782,778,778,778,18,16,18,18,2,1,1,1,4,0,0,2,-2,0
271,271,271,267,14,14,13,13,2,3,2,2,0,0,4,0,1,0
707,703,703,703,13,14,15,13,2,3,1,1,4,0,0,-1,-1,2
984,984,979,974,20,19,20,21,1,1,1,2,0,5,5,1,-1,-1
534,529,529,534,14,14,15,13,2,2,1,3,5,0,-5,0,-1,2
684,684,684,689,13,16,15,16,1,2,3,1,0,0,-5,-3,1,-1
1036,1031,1031,1031,17,16,18,16,1,3,1,1,5,0,0,1,-2,2
328,309,304,309,21,19,20,19,1,2,1,1,19,5,-5,2,-1,1
586,576,571,571,21,19,20,18,1,3,1,3,10,5,0,2,-1,2
487,473,478,473,18,19,18,18,3,2,2,1,14,-5,5,-1,1,0
314,314,318,314,21,19,21,19,2,2,2,2,0,-4,4,2,-2,2
318,314,318,318,18,17,18,19,2,2,5,1,4,-4,0,1,-1,-1
932,932,928,923,13,14,15,13,1,2,1,1,0,4,5,-1,-1,2
239,239,239,234,14,17,15,16,3,2,2,1,0,0,5,-3,2,-1
510,496,487,492,14,14,13,13,3,2,3,2,14,9,-5,0,1,0
609,600,604,604,18,19,18,19,1,4,1,1,9,-4,0,-1,1,-1
220,210,215,210,14,17,15,16,1,2,2,3,10,-5,5,-3,2,-1
553,539,529,529,14,14,15,13,1,3,1,3,14,10,0,0,-1,2
356,351,346,346,13,14,12,13,6,3,3,2,5,5,0,-1,2,-1
492,501,496,492,14,14,13,13,2,1,2,1,-9,5,4,0,1,0
956,951,951,951,17,16,18,16,3,1,2,2,5,0,0,1,-2,2
848,843,843,843,18,17,18,16,2,2,1,1,5,0,0,1,-1,2
379,379,370,379,13,14,15,13,1,3,3,1,0,9,-9,-1,-1,2
862,857,857,853,18,17,18,16,1,3,1,2,5,0,4,1,-1,2
510,510,510,506,18,17,18,19,2,1,2,2,0,0,4,1,-1,-1
895,895,890,890,18,17,18,19,2,1,1,1,0,5,0,1,-1,-1
557,548,548,548,18,19,20,18,1,1,2,1,9,0,0,-1,-1,2
1026,1017,1012,1017,13,14,12,13,1,1,1,1,9,5,-5,-1,2,-1
370,360,365,365,17,16,15,16,1,2,1,1,10,-5,0,1,1,-1
782,773,773,773,21,19,20,21,1,1,1,3,9,0,0,2,-1,-1
187,187,187,182,14,14,15,13,2,1,2,1,0,0,5,0,-1,2
857,853,853,848,14,14,15,13,2,3,2,3,4,0,5,0,-1,2
618,618,623,623,18,19,18,19,2,2,1,3,0,-5,0,-1,1,-1
839,834,834,834,14,17,15,16,2,3,3,2,5,0,0,-3,2,-1
989,984,984,984,17,16,18,18,2,3,3,1,5,0,0,1,-2,0
824,824,824,820,21,19,20,21,2,1,1,2,0,0,4,2,-1,-1
323,323,318,318,21,19,21,19,2,1,1,1,0,5,0,2,-2,2
210,196,192,192,14,14,13,13,1,2,2,3,14,4,0,0,1,0
196,192,192,196,14,14,13,13,1,2,3,1,4,0,-4,0,1,0
750,740,820,745,20,19,18,18,2,2,1,1,10,-80,75,1,1,0
1068,1073,1073,1073,13,14,15,16,1,2,1,3,-5,0,0,-1,-1,-1
440,440,440,445,13,14,12,13,2,3,3,1,0,0,-5,-1,2,-1
796,787,792,792,18,19,18,19,2,1,2,3,9,-5,0,-1,1,-1
942,937,932,932,17,16,18,18,2,3,1,1,5,5,0,1,-2,0
801,792,787,820,14,14,15,13,1,3,1,1,9,5,-33,0,-1,2
600,581,595,586,18,17,18,19,6,2,2,1,19,-14,9,1,-1,-1
253,243,248,253,21,19,20,18,1,2,2,1,10,-5,-5,2,-1,2
440,436,539,436,20,19,20,21,2,2,1,3,4,-103,103,1,-1,-1
900,909,900,904,14,17,15,16,1,2,3,1,-9,9,-4,-3,2,-1
684,674,670,665,20,19,18,18,3,2,3,2,10,4,5,1,1,0
215,210,206,210,18,17,18,19,2,2,1,3,5,4,-4,1,-1,-1
431,421,426,431,20,19,20,18,1,1,1,1,10,-5,-5,1,-1,2
1040,1036,1040,1040,13,14,12,13,2,3,2,1,4,-4,0,-1,2,-1
750,750,750,745,17,16,15,16,1,1,2,2,0,0,5,1,1,-1
609,600,595,600,14,17,15,16,3,2,3,1,9,5,-5,-3,2,-1
267,267,267,267,14,14,13,13,1,1,3,1,0,0,0,0,1,0
1059,1054,1050,1050,20,19,20,21,2,1,1,1,5,4,0,1,-1,-1
342,337,342,337,17,16,18,18,1,1,2,2,5,-5,5,1,-2,0
1064,1059,1064,1054,13,14,15,13,2,1,7,4,5,-5,10,-1,-1,2
370,370,365,365,13,14,15,13,2,3,1,1,0,5,0,-1,-1,2
426,421,421,417,17,16,15,16,3,1,1,2,5,0,4,1,1,-1
206,201,192,196,14,14,13,13,1,3,1,2,5,9,-4,0,1,0
993,984,989,984,17,16,15,16,1,3,2,1,9,-5,5,1,1,-1
820,810,810,801,14,14,13,13,2,3,2,2,10,0,9,0,1,0
492,609,478,487,14,14,15,13,1,1,1,1,-117,131,-9,0,-1,2
295,290,290,286,18,19,18,19,1,2,4,1,5,0,4,-1,1,-1
548,543,539,534,18,19,18,18,2,1,1,1,5,4,5,-1,1,0
1031,1017,1017,1012,20,19,18,18,1,2,3,1,14,0,5,1,1,0
632,632,632,623,13,14,13,13,1,2,1,2,0,0,9,-1,1,0
473,464,459,459,20,19,20,21,3,2,1,2,9,5,0,1,-1,-1
595,586,586,576,14,14,15,13,3,3,3,2,9,0,10,0,-1,2
210,210,210,206,18,17,18,19,2,3,3,1,0,0,4,1,-1,-1
300,290,290,286,14,17,15,16,3,2,1,2,10,0,4,-3,2,-1
614,609,623,614,14,17,15,16,2,2,1,2,5,-14,9,-3,2,-1
839,834,839,839,14,17,15,16,2,2,3,1,5,-5,0,-3,2,-1
557,557,557,557,18,19,20,18,2,2,1,1,0,0,0,-1,-1,2
928,928,923,918,18,17,18,19,1,1,1,1,0,5,5,1,-1,-1
792,792,792,787,14,14,15,13,1,4,1,3,0,0,5,0,-1,2
1017,1012,1012,1003,13,14,15,13,2,1,2,2,5,0,9,-1,-1,2
965,951,951,946,13,16,15,16,1,2,3,3,14,0,5,-3,1,-1
750,754,745,750,17,16,15,16,1,3,1,1,-4,9,-5,1,1,-1
206,196,196,192,18,17,18,19,1,2,3,1,10,0,4,1,-1,-1
637,623,628,628,13,14,15,13,2,2,1,1,14,-5,0,-1,-1,2
539,529,529,524,18,17,18,19,3,1,2,2,10,0,5,1,-1,-1
623,623,623,618,14,17,15,16,2,3,1,1,0,0,5,-3,2,-1
182,182,1078,1078,18,17,18,18,2,1,2,1,0,-896,0,1,-1,0
553,548,543,543,14,14,13,13,2,4,1,2,5,5,0,0,1,0
834,824,829,824,14,14,15,13,1,2,2,1,10,-5,5,0,-1,2
618,604,604,604,14,14,13,13,3,2,1,1,14,0,0,0,1,0
754,745,745,750,13,14,12,13,1,3,3,3,9,0,-5,-1,2,-1
1045,1040,1036,1036,17,16,15,16,2,1,2,3,5,4,0,1,1,-1
665,660,656,651,13,14,15,13,2,1,1,1,5,4,5,-1,-1,2
951,946,946,946,13,14,12,13,1,2,1,4,5,0,0,-1,2,-1
253,248,243,243,14,14,15,13,3,3,1,1,5,5,0,0,-1,2
1017,1003,989,989,13,14,12,13,1,3,1,1,14,14,0,-1,2,-1
618,684,614,609,14,14,13,13,3,1,2,2,-66,70,5,0,1,0
571,571,571,571,18,17,18,18,2,1,1,1,0,0,0,1,-1,0
843,824,815,815,14,14,13,13,3,2,1,1,19,9,0,0,1,0
956,956,956,956,13,14,15,16,3,2,1,1,0,0,0,-1,-1,-1
384,379,374,379,13,14,15,13,1,2,1,1,5,5,-5,-1,-1,2
796,792,792,787,14,14,13,13,2,2,2,3,4,0,5,0,1,0
1012,1007,1007,1003,17,19,18,18,2,3,2,1,5,0,4,-2,1,0
459,454,454,450,20,19,20,18,1,1,1,2,5,0,4,1,-1,2
515,515,515,510,14,14,13,13,2,2,2,1,0,0,5,0,1,0
843,839,839,839,21,19,20,21,1,2,1,2,4,0,0,2,-1,-1
1068,1059,1059,1059,13,14,15,16,1,1,1,1,9,0,0,-1,-1,-1
736,736,736,736,20,19,20,21,2,2,2,1,0,0,0,1,-1,-1
726,717,712,721,13,14,15,16,2,1,1,2,9,5,-9,-1,-1,-1
501,501,506,501,18,19,18,19,2,2,2,3,0,-5,5,-1,1,-1
543,543,539,539,14,14,13,13,1,3,1,1,0,4,0,0,1,0
764,759,759,754,20,19,20,18,3,1,1,2,5,0,5,1,-1,2
904,890,886,876,18,17,18,18,1,1,1,4,14,4,10,1,-1,0
590,586,581,586,18,19,18,19,2,1,1,1,4,5,-5,-1,1,-1
853,848,848,853,21,19,20,18,1,2,1,1,5,0,-5,2,-1,2
750,740,745,745,20,19,18,18,4,2,3,1,10,-5,0,1,1,0
721,721,731,717,13,14,12,13,2,1,2,1,0,-10,14,-1,2,-1
417,412,417,412,20,19,18,18,1,2,2,1,5,-5,5,1,1,0
431,412,412,407,20,19,18,18,1,3,3,1,19,0,5,1,1,0
731,726,740,740,20,19,20,18,2,1,2,1,5,-14,0,1,-1,2
853,848,848,848,21,19,20,21,1,1,1,2,5,0,0,2,-1,-1
810,796,796,792,14,14,13,13,1,1,2,2,14,0,4,0,1,0
1021,1021,1021,1021,17,16,18,16,1,2,1,2,0,0,0,1,-2,2
539,534,534,534,18,17,18,18,3,1,2,1,5,0,0,1,-1,0
360,360,356,356,20,19,18,18,1,1,1,2,0,4,0,1,1,0
628,623,618,618,18,19,18,19,1,1,3,2,5,5,0,-1,1,-1
773,768,768,773,17,16,18,18,1,1,2,1,5,0,-5,1,-2,0
890,886,881,881,21,19,20,21,3,3,1,1,4,5,0,2,-1,-1
1040,1036,1040,1036,13,14,12,13,3,3,2,1,4,-4,4,-1,2,-1
515,501,492,492,14,14,13,13,1,3,1,3,14,9,0,0,1,0
942,932,932,937,13,14,13,13,3,2,1,1,10,0,-5,-1,1,0
1003,998,1003,1003,17,19,18,18,2,1,2,1,5,-5,0,-2,1,0
886,886,876,876,14,17,15,16,4,2,3,2,0,10,0,-3,2,-1
764,759,759,754,17,16,18,16,2,1,2,2,5,0,5,1,-2,2
496,496,487,487,18,19,18,19,1,1,1,1,0,9,0,-1,1,-1
843,843,843,843,18,19,18,18,2,1,6,1,0,0,0,-1,1,0
553,548,543,543,14,17,15,16,2,2,2,1,5,5,0,-3,2,-1
810,810,810,806,14,17,15,16,2,2,1,2,0,0,4,-3,2,-1
1021,1021,1017,1017,17,16,15,16,3,3,1,2,0,4,0,1,1,-1
506,496,496,496,18,19,18,19,1,2,1,1,10,0,0,-1,1,-1
576,571,571,571,14,14,15,13,1,2,1,2,5,0,0,0,-1,2
782,773,778,778,21,19,20,21,1,2,1,1,9,-5,0,2,-1,-1
759,750,754,754,20,19,20,21,2,2,3,1,9,-4,0,1,-1,-1
1064,1054,1045,1050,13,14,15,16,2,1,1,3,10,9,-5,-1,-1,-1
806,796,801,796,21,19,21,21,1,1,1,2,10,-5,5,2,-2,0
417,412,412,412,17,16,18,18,1,1,1,3,5,0,0,1,-2,0
642,646,642,642,17,19,18,18,3,1,3,2,-4,4,0,-2,1,0
740,731,731,731,17,16,15,16,2,2,3,1,9,0,0,1,1,-1
286,281,281,276,18,17,18,18,3,1,2,2,5,0,5,1,-1,0
1050,1040,332,1045,13,16,10,16,2,1,1,2,10,708,-713,-3,6,-6
342,337,337,337,17,19,18,18,3,3,3,1,5,0,0,-2,1,0
867,862,857,857,21,19,20,21,2,1,1,1,5,5,0,2,-1,-1
684,679,684,679,20,19,18,18,1,2,2,1,5,-5,5,1,1,0
215,210,210,206,21,19,20,21,2,2,1,1,5,0,4,2,-1,-1
848,839,839,839,18,19,18,18,1,3,1,1,9,0,0,-1,1,0
506,501,506,501,18,19,18,19,2,2,2,2,5,-5,5,-1,1,-1
224,215,215,210,14,14,15,13,1,2,2,2,9,0,5,0,-1,2
281,267,267,267,14,14,13,13,1,2,1,3,14,0,0,0,1,0
810,801,801,801,14,14,15,16,2,1,2,1,9,0,0,0,-1,-1
951,942,946,946,17,19,18,18,2,2,2,1,9,-4,0,-2,1,0
1068,1064,1068,1059,20,19,20,21,1,3,2,2,4,-4,9,1,-1,-1
843,843,834,829,18,17,18,16,1,3,2,1,0,9,5,1,-1,2
323,323,323,318,14,14,15,16,2,2,3,4,0,0,5,0,-1,-1
984,974,979,979,13,14,12,13,2,2,2,3,10,-5,0,-1,2,-1
698,689,689,689,13,14,15,13,2,4,2,1,9,0,0,-1,-1,2
721,712,712,712,20,19,20,21,2,2,3,1,9,0,0,1,-1,-1
660,651,651,651,13,14,15,13,1,1,1,1,9,0,0,-1,-1,2
510,510,506,506,14,17,15,16,1,2,1,1,0,4,0,-3,2,-1
201,206,196,201,14,14,15,13,1,3,1,3,-5,10,-5,0,-1,2
881,876,871,871,14,14,15,13,1,3,3,3,5,5,0,0,-1,2
445,440,440,440,13,14,12,13,1,4,1,1,5,0,0,-1,2,-1
243,239,239,239,18,17,18,18,3,2,1,1,4,0,0,1,-1,0
210,201,201,196,18,17,18,16,3,2,1,1,9,0,5,1,-1,2
276,271,271,267,18,17,18,18,1,2,1,2,5,0,4,1,-1,0
1026,1017,1012,1012,13,16,15,16,2,4,1,6,9,5,0,-3,1,-1
351,342,337,337,17,16,15,16,1,2,2,2,9,5,0,1,1,-1
642,642,637,637,17,16,15,16,1,1,3,1,0,5,0,1,1,-1
562,553,548,543,14,17,15,16,2,2,1,3,9,5,5,-3,2,-1
1068,1064,1068,1064,17,16,18,16,2,1,2,1,4,-4,4,1,-2,2
586,581,581,581,18,19,18,19,1,2,2,1,5,0,0,-1,1,-1
886,886,886,881,14,14,13,13,2,2,2,3,0,0,5,0,1,0
684,679,684,679,17,19,18,18,1,2,2,2,5,-5,5,-2,1,0
890,881,876,876,18,17,18,16,2,1,1,1,9,5,0,1,-1,2
1064,1050,1059,1059,13,16,15,16,3,2,1,1,14,-9,0,-3,1,-1
253,243,248,253,14,14,15,13,3,2,1,1,10,-5,-5,0,-1,2
853,848,848,843,21,19,20,21,1,3,1,1,5,0,5,2,-1,-1
192,187,187,182,18,19,18,19,2,1,1,1,5,0,5,-1,1,-1
923,923,923,918,14,14,13,13,1,1,3,2,0,0,5,0,1,0
510,501,501,501,14,14,15,16,1,1,1,2,9,0,0,0,-1,-1
909,904,909,904,14,14,15,13,3,2,3,1,5,-5,5,0,-1,2
206,201,201,201,18,19,18,19,3,2,2,1,5,0,0,-1,1,-1
820,815,820,810,18,17,18,16,1,1,2,1,5,-5,10,1,-1,2
895,886,886,890,18,19,18,19,2,3,3,1,9,0,-4,-1,1,-1
815,815,810,815,21,19,20,21,2,1,1,1,0,5,-5,2,-1,-1
374,360,365,365,13,14,12,13,1,2,2,3,14,-5,0,-1,2,-1
379,370,370,370,17,16,15,16,2,1,1,1,9,0,0,1,1,-1
951,946,946,942,13,14,15,13,2,3,2,1,5,0,4,-1,-1,2
604,604,609,600,21,19,21,19,2,3,4,1,0,-5,9,2,-2,2
454,454,459,454,13,14,15,13,3,2,1,3,0,-5,5,-1,-1,2
417,407,403,407,13,14,12,13,3,2,3,1,10,4,-4,-1,2,-1
1021,1012,1012,1017,17,16,18,18,2,1,1,3,9,0,-5,1,-2,0
1036,1026,1021,1017,13,14,12,13,1,1,1,2,10,5,4,-1,2,-1
937,932,937,937,20,19,18,18,3,1,3,3,5,-5,0,1,1,0
712,712,707,759,20,19,20,18,1,1,1,5,0,5,-52,1,-1,2
712,712,712,703,20,19,20,18,1,3,2,1,0,0,9,1,-1,2
590,586,586,586,21,19,20,19,1,3,1,1,4,0,0,2,-1,1
1054,1040,1045,1045,17,16,18,16,2,2,1,2,14,-5,0,1,-2,2
904,890,895,900,21,19,20,21,3,2,1,3,14,-5,-5,2,-1,-1
829,824,820,824,21,19,20,21,3,2,1,1,5,4,-4,2,-1,-1
224,220,201,201,14,14,13,13,3,2,1,2,4,19,0,0,1,0
956,946,942,942,17,16,18,16,1,1,1,1,10,4,0,1,-2,2
342,337,337,332,17,16,18,18,1,1,2,2,5,0,5,1,-2,0
740,731,726,721,17,16,18,18,2,2,2,2,9,5,5,1,-2,0
862,651,651,651,18,16,18,18,1,3,2,3,211,0,0,2,-2,0
951,946,946,946,17,19,18,18,1,2,1,1,5,0,0,-2,1,0
365,374,346,346,13,14,15,13,2,2,1,3,-9,28,0,-1,-1,2
707,707,712,712,13,14,15,16,1,2,2,3,0,-5,0,-1,-1,-1
576,576,571,571,14,14,13,13,3,3,1,2,0,5,0,0,1,0
656,646,656,651,17,16,15,16,2,1,1,1,10,-10,5,1,1,-1
895,890,886,890,18,17,18,19,2,2,3,1,5,4,-4,1,-1,-1
295,290,290,290,14,14,15,13,1,3,1,3,5,0,0,0,-1,2
276,262,257,248,14,14,15,13,1,3,3,2,14,5,9,0,-1,2
1007,965,960,960,13,16,15,16,2,1,3,1,42,5,0,-3,1,-1
201,196,196,993,14,14,13,21,2,1,2,1,5,0,-797,0,1,-8
206,201,206,206,18,17,18,19,2,4,2,1,5,-5,0,1,-1,-1
524,520,510,515,18,17,18,16,1,2,1,2,4,10,-5,1,-1,2
501,501,698,515,14,17,20,16,2,1,1,1,0,-197,183,-3,-3,4
562,553,553,553,14,17,15,16,2,2,1,1,9,0,0,-3,2,-1
721,712,717,717,13,14,12,13,1,2,3,1,9,-5,0,-1,2,-1
717,721,717,721,17,16,18,18,2,3,1,1,-4,4,-4,1,-2,0
1012,1007,1003,998,17,19,18,18,1,2,2,2,5,4,5,-2,1,0
314,309,314,309,14,14,15,16,1,2,2,1,5,-5,5,0,-1,-1
314,234,234,229,21,19,18,19,2,1,6,3,80,0,5,2,1,-1
843,834,829,829,14,17,15,16,3,3,1,1,9,5,0,-3,2,-1
295,286,281,290,14,14,15,13,4,3,1,3,9,5,-9,0,-1,2
192,187,192,192,18,19,18,19,3,2,3,1,5,-5,0,-1,1,-1
965,960,960,965,13,14,15,16,4,2,2,5,5,0,-5,-1,-1,-1
890,886,886,881,14,14,13,13,3,3,3,2,4,0,5,0,1,0
590,581,581,586,18,19,18,19,2,2,2,1,9,0,-5,-1,1,-1
970,960,965,965,20,19,20,21,2,2,1,1,10,-5,0,1,-1,-1
1054,1050,1045,1045,17,16,15,16,4,2,3,1,4,5,0,1,1,-1
496,492,487,487,14,14,15,13,3,1,1,3,4,5,0,0,-1,2
539,534,534,534,14,14,13,13,3,3,2,3,5,0,0,0,1,0
421,421,421,421,13,14,15,16,1,1,1,1,0,0,0,-1,-1,-1
820,806,796,787,14,17,15,16,1,3,1,4,14,10,9,-3,2,-1
440,436,436,426,20,19,20,21,2,1,1,2,4,0,10,1,-1,-1
1040,1031,1031,1021,13,14,12,13,1,4,2,2,9,0,10,-1,2,-1
1021,1017,1017,1017,17,16,15,16,3,2,1,3,4,0,0,1,1,-1
656,656,656,651,20,19,20,21,3,1,2,3,0,0,5,1,-1,-1
220,220,210,210,18,17,18,19,2,1,3,1,0,10,0,1,-1,-1
914,904,900,904,14,14,15,13,1,2,1,1,10,4,-4,0,-1,2
614,609,614,614,21,19,21,21,3,2,1,1,5,-5,0,2,-2,0
834,829,829,829,18,17,18,19,2,1,1,2,5,0,0,1,-1,-1
689,684,684,679,13,14,12,13,1,2,1,1,5,0,5,-1,2,-1
295,290,286,286,14,17,15,16,3,1,3,2,5,4,0,-3,2,-1
323,314,304,304,14,14,15,13,1,1,2,2,9,10,0,0,-1,2
637,623,628,623,17,17,18,19,2,2,2,1,14,-5,5,0,-1,-1
323,323,318,318,14,14,13,13,1,3,1,1,0,5,0,0,1,0
417,412,412,412,20,19,18,18,1,3,2,1,5,0,0,1,1,0
656,646,646,642,17,16,15,16,3,2,3,2,10,0,4,1,1,-1
534,534,529,529,18,17,18,19,2,1,1,2,0,5,0,1,-1,-1
876,862,857,853,14,17,15,16,2,2,1,1,14,5,4,-3,2,-1
539,529,534,534,18,19,20,18,2,2,1,1,10,-5,0,-1,-1,2
740,745,740,745,13,16,15,16,4,1,1,2,-5,5,-5,-3,1,-1
220,220,220,220,18,19,18,19,3,1,1,1,0,0,0,-1,1,-1
384,370,374,370,20,19,20,21,2,2,1,2,14,-4,4,1,-1,-1
267,257,257,253,18,19,18,18,3,1,2,1,10,0,4,-1,1,0
196,192,196,196,14,14,13,13,2,2,2,1,4,-4,0,0,1,0
384,374,374,374,13,14,15,13,3,2,3,3,10,0,0,-1,-1,2
918,914,914,918,18,19,21,19,3,1,3,3,4,0,-4,-1,-2,2
548,539,539,539,14,17,15,16,1,4,1,1,9,0,0,-3,2,-1
487,482,478,478,21,19,20,21,1,1,1,1,5,4,0,2,-1,-1
815,796,792,796,14,14,13,13,2,3,2,1,19,4,-4,0,1,0
492,487,487,487,18,17,18,16,3,1,2,3,5,0,0,1,-1,2
923,918,918,918,18,19,18,19,1,1,2,1,5,0,0,-1,1,-1
482,473,473,478,14,14,12,13,1,2,2,1,9,0,-5,0,2,-1
946,942,946,946,20,19,20,18,3,2,2,1,4,-4,0,1,-1,2
740,736,740,740,13,16,15,16,1,2,2,1,4,-4,0,-3,1,-1
876,871,867,867,18,17,18,16,1,1,5,1,5,4,0,1,-1,2
651,646,646,642,20,19,18,18,2,2,2,3,5,0,4,1,1,0
787,778,773,773,18,16,18,18,2,1,1,2,9,5,0,2,-2,0
773,759,768,764,20,19,18,18,2,1,2,2,14,-9,4,1,1,0
600,586,586,586,21,19,20,21,1,3,1,3,14,0,0,2,-1,-1
571,562,562,557,14,14,15,16,3,3,1,3,9,0,5,0,-1,-1
787,782,778,778,14,17,15,16,1,1,2,1,5,4,0,-3,2,-1
792,792,787,782,14,14,15,13,1,1,2,1,0,5,5,0,-1,2
876,862,871,867,18,17,18,18,3,2,2,1,14,-9,4,1,-1,0
806,806,801,806,18,17,18,19,2,1,3,1,0,5,-5,1,-1,-1
464,454,454,450,13,14,12,13,3,3,3,1,10,0,4,-1,2,-1
960,956,956,951,13,14,15,16,2,1,1,1,4,0,5,-1,-1,-1
956,951,942,942,20,19,20,21,2,3,1,1,5,9,0,1,-1,-1
1040,1026,1031,1031,13,14,15,16,1,3,2,1,14,-5,0,-1,-1,-1
951,942,946,946,13,14,15,13,2,1,2,1,9,-4,0,-1,-1,2
337,337,332,332,20,19,20,21,3,1,1,1,0,5,0,1,-1,-1
670,665,670,665,13,14,15,13,3,2,2,2,5,-5,5,-1,-1,2
754,736,731,731,13,14,15,13,2,2,1,3,18,5,0,-1,-1,2
951,946,946,956,20,19,20,18,2,2,1,1,5,0,-10,1,-1,2
689,684,684,679,20,19,20,18,2,1,1,2,5,0,5,1,-1,2
295,290,286,286,14,14,15,13,3,3,1,1,5,4,0,0,-1,2
417,417,412,412,13,14,12,13,4,2,1,3,0,5,0,-1,2,-1
262,257,257,262,18,17,18,18,5,2,1,1,5,0,-5,1,-1,0
328,323,318,314,14,14,13,13,1,1,2,1,5,5,4,0,1,0
548,539,529,529,21,19,20,21,1,4,1,1,9,10,0,2,-1,-1
510,501,670,496,21,19,23,19,1,3,1,1,9,-169,174,2,-4,4
1040,1040,1036,1040,17,16,15,16,1,1,1,1,0,4,-4,1,1,-1
196,192,196,201,18,17,18,19,2,3,1,2,4,-4,-5,1,-1,-1
557,548,548,553,14,17,15,16,2,1,1,2,9,0,-5,-3,2,-1
464,450,459,459,13,14,12,13,3,2,2,1,14,-9,0,-1,2,-1
271,267,267,267,14,17,15,16,2,1,2,2,4,0,0,-3,2,-1
539,524,524,534,14,14,15,13,1,2,7,1,15,0,-10,0,-1,2
731,721,726,721,20,19,20,18,2,2,1,1,10,-5,5,1,-1,2
281,286,286,286,14,17,15,16,2,1,1,1,-5,0,0,-3,2,-1
248,243,248,243,18,17,18,18,3,2,1,2,5,-5,5,1,-1,0
867,857,862,862,14,14,15,13,2,3,1,1,10,-5,0,0,-1,2
839,829,834,829,14,17,15,16,1,2,1,2,10,-5,5,-3,2,-1
257,257,257,253,18,19,18,18,2,1,2,1,0,0,4,-1,1,0
960,960,956,956,13,14,12,13,1,3,1,1,0,4,0,-1,2,-1
220,215,210,210,14,14,13,13,2,3,1,2,5,5,0,0,1,0
1054,1050,1054,1050,17,16,18,16,3,2,1,1,4,-4,4,1,-2,2
867,862,862,867,21,19,20,21,3,1,1,2,5,0,-5,2,-1,-1
257,248,253,257,14,14,15,13,2,2,3,2,9,-5,-4,0,-1,2
215,210,210,206,14,14,13,13,3,3,2,2,5,0,4,0,1,0
370,370,365,365,20,19,18,18,1,1,3,1,0,5,0,1,1,0
656,651,651,646,13,14,12,13,2,3,1,2,5,0,5,-1,2,-1
618,614,614,609,18,19,18,19,3,2,1,2,4,0,5,-1,1,-1
586,581,581,576,14,14,13,13,1,2,1,1,5,0,5,0,1,0
998,998,998,993,17,16,18,18,2,2,3,3,0,0,5,1,-2,0
960,951,956,956,17,16,15,16,2,2,1,3,9,-5,0,1,1,-1
351,351,351,346,17,16,15,16,2,3,1,1,0,0,5,1,1,-1
839,834,834,834,18,19,18,18,3,2,2,1,5,0,0,-1,1,0
1007,1003,1003,1003,17,16,18,18,5,1,1,1,4,0,0,1,-2,0
848,839,839,839,14,17,15,16,1,3,1,1,9,0,0,-3,2,-1
215,215,210,210,18,19,18,19,3,2,3,1,0,5,0,-1,1,-1
618,614,614,609,14,17,15,16,1,1,1,4,4,0,5,-3,2,-1
951,946,946,942,20,19,20,18,1,1,1,1,5,0,4,1,-1,2
942,932,923,928,13,14,13,13,2,1,2,1,10,9,-5,-1,1,0
239,234,234,234,14,14,15,13,1,2,3,3,5,0,0,0,-1,2
970,970,970,979,17,16,15,16,1,1,2,1,0,0,-9,1,1,-1
492,492,487,492,21,19,21,19,2,3,1,1,0,5,-5,2,-2,2
848,839,839,839,14,14,15,13,3,3,1,1,9,0,0,0,-1,2
703,689,684,679,17,16,18,18,3,1,1,1,14,5,5,1,-2,0
220,215,206,206,14,17,15,16,1,2,1,2,5,9,0,-3,2,-1
539,529,524,529,21,19,20,19,2,3,3,1,10,5,-5,2,-1,1
534,529,524,529,18,17,18,19,3,1,1,3,5,5,-5,1,-1,-1
562,553,557,553,18,19,18,18,1,2,2,1,9,-4,4,-1,1,0
328,323,328,323,18,17,18,19,1,2,2,1,5,-5,5,1,-1,-1
674,665,665,665,13,14,15,13,1,3,2,1,9,0,0,-1,-1,2
1050,1003,1003,998,13,14,12,13,1,2,2,3,47,0,5,-1,2,-1
384,374,370,370,20,19,18,18,3,1,1,1,10,4,0,1,1,0
567,562,562,553,14,14,15,13,2,3,1,2,5,0,9,0,-1,2
557,543,539,543,18,17,18,16,1,2,3,3,14,4,-4,1,-1,2
932,923,923,928,20,19,18,19,1,2,1,1,9,0,-5,1,1,-1
970,965,960,956,13,14,12,13,1,3,2,3,5,5,4,-1,2,-1
300,300,295,300,14,14,13,13,4,3,3,1,0,5,-5,0,1,0
871,871,867,862,21,19,20,21,2,3,1,1,0,4,5,2,-1,-1
614,609,604,600,21,19,20,21,1,3,1,2,5,5,4,2,-1,-1
281,281,271,271,14,17,15,16,2,1,1,1,0,10,0,-3,2,-1
496,492,496,496,14,17,15,16,1,1,3,1,4,-4,0,-3,2,-1
834,834,829,829,14,14,13,13,2,2,1,2,0,5,0,0,1,0
989,989,989,984,20,19,20,21,3,1,1,1,0,0,5,1,-1,-1
487,468,459,454,18,19,20,18,2,2,3,2,19,9,5,-1,-1,2
271,267,262,262,21,19,20,18,2,1,1,1,4,5,0,2,-1,2
323,314,309,309,14,14,13,13,1,2,1,1,9,5,0,0,1,0
417,412,407,407,13,14,12,13,2,1,3,3,5,5,0,-1,2,-1
745,745,745,740,20,19,20,18,1,3,1,1,0,0,5,1,-1,2
759,745,745,750,13,14,12,13,2,3,1,2,14,0,-5,-1,2,-1
300,286,295,295,21,19,20,19,1,2,1,1,14,-9,0,2,-1,1
618,609,609,609,18,17,18,16,1,3,2,1,9,0,0,1,-1,2
473,468,468,468,20,19,20,21,1,4,1,2,5,0,0,1,-1,-1
674,670,674,670,13,14,12,13,3,1,2,2,4,-4,4,-1,2,-1
1026,1017,1017,1026,13,14,15,13,2,2,1,2,9,0,-9,-1,-1,2
468,459,454,454,17,19,18,18,2,1,1,2,9,5,0,-2,1,0
881,871,876,876,18,19,18,18,3,2,1,1,10,-5,0,-1,1,0
942,937,960,974,13,14,12,13,4,4,3,3,5,-23,-14,-1,2,-1
379,370,374,370,20,19,18,18,2,4,3,1,9,-4,4,1,1,0
909,900,900,895,14,14,13,13,1,2,2,3,9,0,5,0,1,0
834,829,829,820,14,17,15,16,1,2,1,2,5,0,9,-3,2,-1
698,693,801,674,13,14,15,16,2,2,1,1,5,-108,127,-1,-1,-1
923,923,918,914,14,14,15,16,2,3,2,4,0,5,4,0,-1,-1
820,815,815,815,18,17,18,19,1,1,1,1,5,0,0,1,-1,-1
253,243,243,243,18,17,18,16,1,1,1,2,10,0,0,1,-1,2
646,642,637,642,17,16,18,18,4,3,2,1,4,5,-5,1,-2,0
665,656,656,651,20,19,20,21,2,2,3,1,9,0,5,1,-1,-1
1050,1050,1040,1040,13,14,12,13,3,1,1,2,0,10,0,-1,2,-1
829,829,824,824,14,17,15,16,1,3,2,1,0,5,0,-3,2,-1
323,323,318,318,14,17,15,16,3,1,2,4,0,5,0,-3,2,-1
703,698,698,693,13,14,15,13,1,2,1,1,5,0,5,-1,-1,2
323,309,309,314,18,17,18,16,3,2,1,3,14,0,-5,1,-1,2
482,473,473,468,14,14,15,13,1,2,1,1,9,0,5,0,-1,2
796,792,792,792,18,17,18,19,4,2,1,1,4,0,0,1,-1,-1
323,318,318,318,14,17,15,16,1,3,1,3,5,0,0,-3,2,-1
473,459,454,454,13,14,12,13,2,2,1,1,14,5,0,-1,2,-1
782,773,773,768,18,19,18,18,2,2,2,2,9,0,5,-1,1,0
759,754,754,750,17,19,18,18,3,3,3,1,5,0,4,-2,1,0
965,956,960,960,20,19,20,18,1,3,1,2,9,-4,0,1,-1,2
571,567,562,567,14,17,15,16,1,2,3,1,4,5,-5,-3,2,-1
656,656,473,646,17,16,18,16,3,1,1,1,0,183,-173,1,-2,2
843,843,834,843,18,17,18,16,1,1,3,3,0,9,-9,1,-1,2
515,515,515,510,21,19,20,21,1,2,2,3,0,0,5,2,-1,-1
989,989,984,979,17,19,18,18,1,1,1,2,0,5,5,-2,1,0
314,309,304,323,14,14,13,13,1,1,1,1,5,5,-19,0,1,0
862,848,848,848,18,17,18,18,2,2,1,2,14,0,0,1,-1,0
492,487,487,487,14,14,13,13,2,3,1,3,5,0,0,0,1,0
379,379,374,374,20,19,18,18,1,3,1,1,0,5,0,1,1,0
187,182,1078,182,14,17,15,16,2,1,1,2,5,-896,896,-3,2,-1
309,300,300,295,14,17,15,16,1,2,1,2,9,0,5,-3,2,-1
510,506,501,496,14,14,13,13,1,5,1,2,4,5,5,0,1,0
281,271,271,271,14,14,15,13,1,2,1,1,10,0,0,0,-1,2
623,623,623,623,14,14,15,13,2,2,1,2,0,0,0,0,-1,2
1017,1007,1003,998,13,14,15,13,2,1,2,3,10,4,5,-1,-1,2
276,267,267,267,14,17,15,16,1,2,1,1,9,0,0,-3,2,-1
510,506,506,510,18,19,20,19,1,1,1,1,4,0,-4,-1,-1,1
900,904,900,900,18,17,18,16,2,1,3,1,-4,4,0,1,-1,2
234,224,229,220,14,17,15,16,3,2,2,2,10,-5,9,-3,2,-1
360,356,351,351,13,14,12,13,3,6,1,2,4,5,0,-1,2,-1
637,632,637,623,13,14,15,13,1,2,2,2,5,-5,14,-1,-1,2
937,932,937,937,13,16,15,16,1,2,3,1,5,-5,0,-3,1,-1
492,492,492,487,18,17,18,16,2,1,1,1,0,0,5,1,-1,2
886,886,886,881,21,19,20,21,2,1,2,4,0,0,5,2,-1,-1
262,253,267,257,21,19,20,21,1,2,1,2,9,-14,10,2,-1,-1
890,890,886,890,14,14,13,13,1,4,1,2,0,4,-4,0,1,0
262,257,257,253,14,17,15,16,2,2,2,1,5,0,4,-3,2,-1
960,956,956,951,20,19,20,18,3,1,1,2,4,0,5,1,-1,2
970,965,970,965,20,19,18,18,1,2,2,2,5,-5,5,1,1,0
1026,1012,1017,1017,20,19,20,21,2,4,1,1,14,-5,0,1,-1,-1
951,942,942,942,17,16,18,18,1,2,1,1,9,0,0,1,-2,0
750,745,745,740,13,14,12,13,1,2,3,1,5,0,5,-1,2,-1
309,304,290,290,18,17,18,16,1,1,2,1,5,14,0,1,-1,2
684,684,693,684,13,14,12,13,1,2,2,2,0,-9,9,-1,2,-1
773,773,768,768,20,19,18,18,1,3,2,3,0,5,0,1,1,0
314,300,295,286,14,14,13,13,3,3,2,2,14,5,9,0,1,0
1059,1054,1054,1054,20,19,20,21,3,3,1,3,5,0,0,1,-1,-1
262,257,253,253,14,14,13,13,1,3,1,1,5,4,0,0,1,0
750,750,745,745,13,14,15,13,1,3,1,1,0,5,0,-1,-1,2
750,745,745,745,20,19,20,21,3,1,1,1,5,0,0,1,-1,-1
276,271,271,267,14,14,13,13,1,3,2,4,5,0,4,0,1,0
417,412,407,412,13,14,12,13,1,2,1,3,5,5,-5,-1,2,-1
417,412,407,412,20,19,18,18,1,2,1,1,5,5,-5,1,1,0
614,614,604,609,14,14,13,13,1,5,2,3,0,10,-5,0,1,0
951,951,951,946,13,14,12,13,1,2,1,1,0,0,5,-1,2,-1
374,365,365,370,13,14,12,13,3,2,3,1,9,0,-5,-1,2,-1
557,548,553,548,18,19,18,18,3,1,2,1,9,-5,5,-1,1,0
262,253,257,253,18,19,18,18,1,1,2,2,9,-4,4,-1,1,0
965,965,965,960,13,14,12,13,1,3,1,1,0,0,5,-1,2,-1
595,590,586,586,14,14,15,13,3,3,1,1,5,4,0,0,-1,2
918,914,914,909,18,17,18,16,2,3,2,1,4,0,5,1,-1,2
918,923,918,918,18,17,18,16,1,1,3,1,-5,5,0,1,-1,2
548,543,548,543,18,17,18,18,2,2,1,3,5,-5,5,1,-1,0
1073,1068,1068,1064,17,16,18,16,1,2,2,4,5,0,4,1,-2,2
389,389,384,379,17,16,18,18,1,2,1,2,0,5,5,1,-2,0
1050,1040,1040,1036,13,14,12,13,2,3,1,2,10,0,4,-1,2,-1
267,262,267,262,18,19,18,18,1,2,2,2,5,-5,5,-1,1,0
796,796,792,787,18,17,18,16,1,1,2,2,0,4,5,1,-1,2
637,623,628,618,17,17,15,16,3,2,2,2,14,-5,10,0,2,-1
796,792,796,792,18,19,18,19,3,2,2,3,4,-4,4,-1,1,-1
618,614,618,614,18,19,18,19,1,1,2,2,4,-4,4,-1,1,-1
609,604,600,595,18,19,18,19,1,3,2,1,5,4,5,-1,1,-1
300,286,286,286,14,14,15,16,3,1,2,1,14,0,0,0,-1,-1
970,970,970,970,20,19,20,18,1,1,1,2,0,0,0,1,-1,2
210,210,215,210,14,14,13,13,2,2,3,1,0,-5,5,0,1,0
365,356,356,360,13,14,12,13,2,2,3,1,9,0,-4,-1,2,-1
524,520,529,520,21,19,20,19,1,1,2,1,4,-9,9,2,-1,1
782,773,778,778,18,16,18,16,1,2,1,1,9,-5,0,2,-2,2
309,295,300,295,14,14,13,13,1,2,2,2,14,-5,5,0,1,0
224,215,210,210,14,14,13,13,3,3,1,1,9,5,0,0,1,0
318,314,365,309,14,14,15,13,2,3,1,2,4,-51,56,0,-1,2
604,595,595,590,14,17,15,16,1,1,3,2,9,0,5,-3,2,-1
796,792,792,792,18,19,18,19,1,3,2,1,4,0,0,-1,1,-1
876,876,876,876,18,17,18,18,2,2,1,1,0,0,0,1,-1,0
876,871,867,871,18,19,18,18,3,2,2,1,5,4,-4,-1,1,0
445,436,426,426,17,16,18,16,1,1,1,2,9,10,0,1,-2,2
1031,1031,1026,1026,17,19,18,18,1,1,1,2,0,5,0,-2,1,0
210,206,210,220,18,19,18,19,3,1,1,1,4,-4,-10,-1,1,-1
393,393,384,384,17,16,15,16,2,1,1,1,0,9,0,1,1,-1
993,989,989,989,13,14,15,13,3,3,3,6,4,0,0,-1,-1,2
787,768,768,768,18,19,18,18,1,2,1,1,19,0,0,-1,1,0
909,904,895,895,18,17,18,19,2,1,1,1,5,9,0,1,-1,-1
286,276,271,276,14,17,15,16,4,1,3,3,10,5,-5,-3,2,-1
421,421,421,421,20,19,20,18,4,1,1,1,0,0,0,1,-1,2
857,839,839,834,14,14,13,13,2,2,1,3,18,0,5,0,1,0
290,286,290,286,14,14,15,13,1,3,2,3,4,-4,4,0,-1,2
314,304,304,304,18,17,18,19,3,2,1,2,10,0,0,1,-1,-1
960,956,951,951,17,16,18,16,3,3,3,1,4,5,0,1,-2,2
224,210,210,210,14,17,15,16,2,2,2,1,14,0,0,-3,2,-1
501,496,501,496,14,14,13,13,2,4,2,2,5,-5,5,0,1,0
726,721,721,717,20,19,20,21,1,1,1,1,5,0,4,1,-1,-1
539,534,529,529,21,19,20,19,3,1,1,2,5,5,0,2,-1,1
806,801,796,796,14,14,13,13,3,3,1,1,5,5,0,0,1,0
182,1073,1078,1078,14,14,15,16,2,2,1,1,-891,-5,0,0,-1,-1
1017,998,993,998,13,14,15,13,1,2,1,3,19,5,-5,-1,-1,2
510,501,506,501,18,17,18,19,3,2,2,1,9,-5,5,1,-1,-1
651,642,651,642,17,16,18,18,3,2,3,1,9,-9,9,1,-2,0
974,965,970,974,13,16,15,16,1,3,2,1,9,-5,-4,-3,1,-1
534,529,520,520,18,17,18,19,2,1,3,1,5,9,0,1,-1,-1
923,928,918,923,14,14,13,13,2,1,3,1,-5,10,-5,0,1,0
229,224,229,224,21,19,20,21,2,1,2,3,5,-5,5,2,-1,-1
595,590,595,590,21,19,20,19,4,3,2,1,5,-5,5,2,-1,1
496,492,492,487,21,19,21,21,1,3,2,2,4,0,5,2,-2,0
806,801,796,792,18,17,18,19,2,5,4,2,5,5,4,1,-1,-1
839,829,815,815,18,17,18,19,2,1,1,1,10,14,0,1,-1,-1
520,520,515,515,18,17,18,16,3,2,2,1,0,5,0,1,-1,2
989,979,979,979,13,14,15,16,3,3,2,1,10,0,0,-1,-1,-1
365,356,356,356,13,14,12,13,1,4,3,1,9,0,0,-1,2,-1
904,904,904,904,21,19,20,21,2,1,3,1,0,0,0,2,-1,-1
276,271,271,267,21,19,20,18,3,1,1,2,5,0,4,2,-1,2
810,810,210,806,14,14,18,13,1,3,1,1,0,600,-596,0,-4,5
609,609,609,609,14,14,15,13,2,3,1,1,0,0,0,0,-1,2
567,557,553,557,14,14,15,16,3,2,3,1,10,4,-4,0,-1,-1
562,548,548,543,14,17,15,16,2,2,2,1,14,0,5,-3,2,-1
689,679,679,674,13,14,12,13,4,3,2,6,10,0,5,-1,2,-1
909,900,895,895,21,19,20,21,1,1,1,1,9,5,0,2,-1,-1
567,567,562,562,14,17,15,16,1,1,2,2,0,5,0,-3,2,-1
909,895,904,904,18,17,18,16,1,3,2,1,14,-9,0,1,-1,2
342,342,337,332,17,16,15,16,1,5,2,1,0,5,5,1,1,-1
210,201,206,206,14,17,15,16,1,2,1,1,9,-5,0,-3,2,-1
210,206,206,201,18,19,18,19,1,1,1,1,4,0,5,-1,1,-1
862,857,862,853,18,17,18,18,3,2,2,2,5,-5,9,1,-1,0
210,201,201,196,14,17,15,16,3,2,1,2,9,0,5,-3,2,-1
436,379,379,374,17,16,18,18,1,3,1,1,57,0,5,1,-2,0
689,684,679,1012,17,16,15,11,2,1,2,1,5,5,-333,1,1,4
956,956,951,951,20,19,20,18,2,1,1,1,0,5,0,1,-1,2
839,829,824,834,14,17,15,16,2,1,5,1,10,5,-10,-3,2,-1
286,281,286,281,21,19,20,21,4,2,2,2,5,-5,5,2,-1,-1
389,384,384,384,17,16,18,16,4,1,1,1,5,0,0,1,-2,2
998,998,993,993,13,14,15,13,2,1,3,2,0,5,0,-1,-1,2
220,215,215,215,14,17,15,16,2,3,1,1,5,0,0,-3,2,-1
914,909,904,904,18,17,18,16,1,2,3,2,5,5,0,1,-1,2
548,543,543,543,14,17,15,16,2,1,1,2,5,0,0,-3,2,-1
553,543,553,553,18,19,18,18,2,2,3,1,10,-10,0,-1,1,0
576,581,576,576,14,14,13,13,1,2,1,2,-5,5,0,0,1,0
764,759,764,759,20,19,20,21,2,1,2,2,5,-5,5,1,-1,-1
932,923,928,932,13,17,15,16,1,2,1,1,9,-5,-4,-4,2,-1
337,332,337,332,20,19,18,18,2,1,2,1,5,-5,5,1,1,0
581,571,576,571,14,14,13,13,1,4,2,2,10,-5,5,0,1,0
796,792,796,792,21,19,21,19,1,2,1,1,4,-4,4,2,-2,2
796,792,792,787,18,17,18,16,1,1,1,2,4,0,5,1,-1,2
374,370,365,365,17,16,18,18,3,1,4,1,4,5,0,1,-2,0
412,403,398,393,13,14,12,13,4,1,2,2,9,5,5,-1,2,-1
403,398,403,403,13,14,12,13,1,2,1,1,5,-5,0,-1,2,-1
304,295,300,295,18,17,18,19,1,2,3,2,9,-5,5,1,-1,-1
304,309,300,304,21,19,20,19,2,3,1,1,-5,9,-4,2,-1,1
843,843,843,839,14,14,15,13,3,1,2,2,0,0,4,0,-1,2
660,651,646,646,20,19,20,21,1,1,1,1,9,5,0,1,-1,-1
342,332,337,337,20,19,20,18,2,2,2,1,10,-5,0,1,-1,2
942,937,937,937,17,16,15,16,1,1,1,3,5,0,0,1,1,-1
595,590,590,590,18,19,18,19,1,3,1,1,5,0,0,-1,1,-1
1064,1059,1064,1064,17,16,15,16,1,6,2,1,5,-5,0,1,1,-1
895,890,890,890,18,19,20,19,1,1,1,1,5,0,0,-1,-1,1
524,515,515,510,18,19,18,19,1,3,2,1,9,0,5,-1,1,-1
937,932,932,932,13,16,15,16,3,1,1,1,5,0,0,-3,1,-1
196,374,370,342,14,14,15,13,1,1,3,3,-178,4,28,0,-1,2
1045,1031,1036,1036,13,14,12,13,2,2,3,3,14,-5,0,-1,2,-1
459,454,454,454,13,14,12,13,1,1,3,1,5,0,0,-1,2,-1
848,839,834,829,21,19,20,21,3,1,2,1,9,5,5,2,-1,-1
881,876,876,801,14,14,15,11,2,2,3,1,5,0,75,0,-1,4
956,951,951,946,20,19,20,18,3,3,1,2,5,0,5,1,-1,2
989,979,979,984,13,14,12,13,2,2,3,1,10,0,-5,-1,2,-1
731,726,736,726,13,14,12,13,2,1,2,2,5,-10,10,-1,2,-1
206,206,201,201,18,17,18,16,3,3,2,1,0,5,0,1,-1,2
754,750,750,745,17,16,15,16,2,1,1,1,4,0,5,1,1,-1
206,206,206,206,14,14,15,13,2,2,3,1,0,0,0,0,-1,2
337,342,337,337,13,14,15,16,3,3,1,1,-5,5,0,-1,-1,-1
482,487,487,482,14,14,13,13,2,2,3,2,-5,0,5,0,1,0
543,539,543,543,14,14,13,13,3,2,2,2,4,-4,0,0,1,0
839,834,829,829,21,19,20,21,1,4,1,1,5,5,0,2,-1,-1
496,487,487,482,14,14,13,13,3,3,2,2,9,0,5,0,1,0
604,600,600,600,14,14,15,13,1,2,1,2,4,0,0,0,-1,2
881,876,876,886,14,17,15,16,1,2,1,1,5,0,-10,-3,2,-1
740,731,736,731,13,14,12,13,2,3,2,1,9,-5,5,-1,2,-1
1040,1036,1036,1031,13,16,15,16,2,3,2,2,4,0,5,-3,1,-1
379,374,379,374,17,16,18,16,3,2,2,1,5,-5,5,1,-2,2
792,787,782,787,14,14,15,13,1,3,1,2,5,5,-5,0,-1,2
890,815,820,815,21,19,18,19,1,2,2,2,75,-5,5,2,1,-1
314,295,304,304,21,19,20,21,3,4,1,1,19,-9,0,2,-1,-1
801,796,796,796,18,17,18,19,2,1,3,1,5,0,0,1,-1,-1
248,239,234,229,14,14,15,13,3,1,3,1,9,5,5,0,-1,2
567,557,562,562,18,19,18,18,2,2,2,2,10,-5,0,-1,1,0
956,956,951,951,20,19,20,18,2,2,1,1,0,5,0,1,-1,2
431,426,431,426,17,16,15,16,1,2,2,1,5,-5,5,1,1,-1
506,501,501,501,14,17,15,16,2,2,1,2,5,0,0,-3,2,-1
224,210,201,201,14,14,13,13,3,1,1,3,14,9,0,0,1,0
210,206,201,196,18,19,18,19,1,2,1,2,4,5,5,-1,1,-1
984,970,970,970,13,14,15,13,4,2,1,4,14,0,0,-1,-1,2
384,384,384,384,17,16,18,16,1,1,1,1,0,0,0,1,-2,2
923,923,923,923,21,19,21,19,2,3,1,1,0,0,0,2,-2,2
571,571,567,567,18,19,18,18,2,1,1,2,0,4,0,-1,1,0
473,464,468,464,17,19,18,18,3,2,4,2,9,-4,4,-2,1,0
398,384,384,384,13,14,12,13,2,2,1,3,14,0,0,-1,2,-1
436,431,436,431,20,19,20,18,1,1,2,1,5,-5,5,1,-1,2
721,712,712,717,13,14,12,13,1,2,2,1,9,0,-5,-1,2,-1
337,332,323,318,13,14,13,13,3,1,2,2,5,9,5,-1,1,0
196,187,187,187,18,19,18,19,3,3,2,2,9,0,0,-1,1,-1
674,670,670,670,20,19,20,21,3,2,1,1,4,0,0,1,-1,-1
609,604,604,604,18,17,18,19,1,2,1,4,5,0,0,1,-1,-1
717,707,703,707,13,14,15,13,3,3,1,1,10,4,-4,-1,-1,2
586,586,581,581,14,17,15,16,2,1,1,3,0,5,0,-3,2,-1
220,220,220,220,14,14,15,13,2,3,2,3,0,0,0,0,-1,2
815,815,815,815,18,19,18,19,1,1,1,2,0,0,0,-1,1,-1
215,215,210,210,18,17,18,19,1,1,1,1,0,5,0,1,-1,-1
1021,1017,1017,1012,17,16,18,16,1,2,1,2,4,0,5,1,-2,2
942,937,932,932,13,14,15,13,2,3,1,1,5,5,0,-1,-1,2
604,595,595,595,18,19,18,19,2,2,3,1,9,0,0,-1,1,-1
604,600,600,600,14,14,15,16,1,3,3,1,4,0,0,0,-1,-1
257,253,248,248,14,17,15,16,2,2,1,1,4,5,0,-3,2,-1
201,201,196,196,14,14,13,13,2,3,1,3,0,5,0,0,1,0
642,642,642,637,17,19,18,18,2,1,2,2,0,0,5,-2,1,0
300,281,286,286,18,17,18,19,2,2,1,1,19,-5,0,1,-1,-1
295,286,286,286,21,19,20,21,1,1,3,2,9,0,0,2,-1,-1
267,262,257,257,14,14,13,13,3,3,3,2,5,5,0,0,1,0
993,984,974,974,17,16,15,16,3,2,1,1,9,10,0,1,1,-1
281,276,276,271,18,17,18,16,2,2,1,2,5,0,5,1,-1,2
590,586,586,581,18,19,18,19,2,1,1,1,4,0,5,-1,1,-1
543,539,543,543,21,19,20,21,1,2,3,1,4,-4,0,2,-1,-1
515,515,515,515,14,17,15,16,3,2,2,3,0,0,0,-3,2,-1
914,914,909,914,21,19,21,21,2,1,1,1,0,5,-5,2,-2,0
524,590,515,510,14,14,15,13,3,1,1,2,-66,75,5,0,-1,2
492,487,492,492,14,14,15,16,4,4,2,1,5,-5,0,0,-1,-1
754,745,745,736,13,14,15,13,2,1,2,2,9,0,9,-1,-1,2
829,824,820,815,21,19,20,21,3,2,1,2,5,4,5,2,-1,-1
810,806,801,801,14,14,15,13,3,1,3,1,4,5,0,0,-1,2
684,684,679,679,20,19,20,21,1,1,1,3,0,5,0,1,-1,-1
782,782,792,782,14,14,13,13,2,1,1,1,0,-10,10,0,1,0
843,834,834,829,18,17,18,16,1,4,2,2,9,0,5,1,-1,2
239,229,224,224,14,17,15,16,4,1,1,1,10,5,0,-3,2,-1
473,468,473,468,13,14,15,13,1,2,2,2,5,-5,5,-1,-1,2
309,295,290,286,14,17,15,16,1,2,2,1,14,5,4,-3,2,-1
595,595,595,595,18,17,18,19,2,3,1,2,0,0,0,1,-1,-1
754,750,745,750,17,16,15,16,1,2,3,1,4,5,-5,1,1,-1
1017,1012,1007,1003,17,16,18,16,2,2,3,2,5,5,4,1,-2,2
993,989,989,989,13,16,15,16,2,2,1,3,4,0,0,-3,1,-1
1012,1012,1007,1012,20,19,20,18,4,1,1,1,0,5,-5,1,-1,2
229,224,220,215,18,17,18,16,3,1,2,2,5,4,5,1,-1,2
586,581,581,581,21,19,20,21,2,1,2,1,5,0,0,2,-1,-1
276,276,276,271,14,14,13,13,1,1,2,1,0,0,5,0,1,0
768,768,768,764,20,19,20,18,2,4,2,1,0,0,4,1,-1,2
403,398,398,398,17,16,18,16,2,2,3,1,5,0,0,1,-2,2
548,548,548,548,14,14,15,16,1,1,2,2,0,0,0,0,-1,-1
693,689,689,689,20,19,18,18,3,1,1,1,4,0,0,1,1,0
1045,1040,1040,1040,17,19,18,18,3,2,1,1,5,0,0,-2,1,0
1003,1007,998,998,13,14,12,13,1,1,3,1,-4,9,0,-1,2,-1
309,309,309,304,14,17,15,16,1,1,1,2,0,0,5,-3,2,-1
609,604,604,604,18,17,18,19,3,2,1,2,5,0,0,1,-1,-1
482,473,473,473,18,16,18,18,1,2,3,1,9,0,0,2,-2,0
342,342,346,342,13,14,12,13,3,2,2,1,0,-4,4,-1,2,-1
571,482,487,482,18,17,18,19,1,1,2,2,89,-5,5,1,-1,-1
853,848,853,853,14,14,13,13,2,2,2,1,5,-5,0,0,1,0
206,206,201,201,14,14,15,13,1,2,2,2,0,5,0,0,-1,2
492,487,487,487,14,17,15,16,1,3,2,1,5,0,0,-3,2,-1
1068,1064,1059,1054,13,14,12,13,1,3,1,2,4,5,5,-1,2,-1
674,674,674,670,20,19,18,18,1,1,2,1,0,0,4,1,1,0
848,848,843,843,18,19,18,18,2,2,3,1,0,5,0,-1,1,0
421,412,407,407,20,19,18,18,4,3,1,2,9,5,0,1,1,0
309,300,295,304,14,14,15,13,2,1,1,1,9,5,-9,0,-1,2
1050,1050,1050,1040,17,19,18,18,1,1,2,2,0,0,10,-2,1,0
604,600,600,595,14,17,15,16,1,3,1,2,4,0,5,-3,2,-1
215,196,196,187,14,14,13,13,1,3,2,2,19,0,9,0,1,0
900,895,900,900,21,19,20,21,1,2,2,1,5,-5,0,2,-1,-1
970,965,965,974,13,14,12,13,2,3,2,1,5,0,-9,-1,2,-1
895,881,881,886,14,14,15,13,2,2,1,1,14,0,-5,0,-1,2
1073,989,989,989,20,19,20,18,1,2,1,1,84,0,0,1,-1,2
984,984,979,984,20,19,20,18,1,3,1,1,0,5,-5,1,-1,2
839,829,834,843,18,19,18,18,3,1,1,1,10,-5,-9,-1,1,0
1050,1045,1045,1045,20,19,18,18,1,1,1,2,5,0,0,1,1,0
974,965,965,965,13,16,15,16,2,2,1,1,9,0,0,-3,1,-1
473,468,473,473,13,14,15,16,1,2,1,1,5,-5,0,-1,-1,-1
520,506,520,515,21,19,20,19,1,2,1,1,14,-14,5,2,-1,1
196,196,196,196,21,19,21,21,2,3,1,1,0,0,0,2,-2,0
665,660,656,651,20,19,18,18,2,2,2,2,5,4,5,1,1,0
960,951,951,951,20,19,20,21,2,2,1,2,9,0,0,1,-1,-1
384,374,360,360,13,14,12,13,2,3,3,3,10,14,0,-1,2,-1
412,412,407,407,17,19,18,18,2,4,1,2,0,5,0,-2,1,0
370,374,370,370,17,16,18,18,1,5,2,1,-4,4,0,1,-2,0
750,745,750,750,13,16,15,16,1,1,2,1,5,-5,0,-3,1,-1
257,257,257,257,14,14,15,13,2,1,1,2,0,0,0,0,-1,2
487,473,478,468,21,19,20,21,1,2,1,3,14,-5,10,2,-1,-1
1036,1026,1021,1026,20,19,18,18,2,1,3,2,10,5,-5,1,1,0
337,337,342,337,17,19,18,18,3,2,2,2,0,-5,5,-2,1,0
534,510,515,520,18,17,15,16,3,2,2,1,24,-5,-5,1,2,-1
389,384,384,384,17,16,18,16,2,1,1,1,5,0,0,1,-2,2
239,229,229,229,14,17,15,16,1,1,3,2,10,0,0,-3,2,-1
721,717,712,717,20,19,18,18,2,2,3,1,4,5,-5,1,1,0
914,904,900,900,14,14,15,16,1,3,1,3,10,4,0,0,-1,-1
1068,1064,1068,1064,20,19,20,21,3,1,2,2,4,-4,4,1,-1,-1
1073,1068,1068,1068,17,16,15,16,2,2,3,1,5,0,0,1,1,-1
206,206,201,201,18,19,18,19,1,1,1,1,0,5,0,-1,1,-1
937,923,923,928,13,14,13,13,2,2,1,1,14,0,-5,-1,1,0
262,257,257,253,21,19,20,21,1,1,1,2,5,0,4,2,-1,-1
286,276,286,290,14,14,15,13,1,3,2,3,10,-10,-4,0,-1,2
637,637,628,698,17,16,15,16,1,1,1,1,0,9,-70,1,1,-1
271,267,267,267,14,14,13,13,1,2,3,3,4,0,0,0,1,0
881,876,881,881,21,19,20,19,2,5,2,1,5,-5,0,2,-1,1
670,665,665,660,20,19,20,18,1,2,1,1,5,0,5,1,-1,2
421,421,426,421,13,14,15,16,3,1,1,2,0,-5,5,-1,-1,-1
895,895,890,886,14,14,13,13,1,3,1,4,0,5,4,0,1,0
276,276,276,271,21,19,20,21,2,1,2,1,0,0,5,2,-1,-1
473,468,468,464,13,14,15,13,3,3,2,1,5,0,4,-1,-1,2
820,815,810,806,21,19,20,19,1,1,1,2,5,5,4,2,-1,1
323,314,314,314,18,19,18,19,3,1,2,1,9,0,0,-1,1,-1
595,590,586,586,18,19,18,19,3,1,1,1,5,4,0,-1,1,-1
224,215,220,220,18,19,18,19,1,2,1,1,9,-5,0,-1,1,-1
1021,1012,1012,243,13,14,15,11,2,2,2,1,9,0,769,-1,-1,4
187,187,1078,1073,14,14,15,13,1,1,1,2,0,-891,5,0,-1,2
384,379,379,384,17,16,15,16,3,2,1,3,5,0,-5,1,1,-1
782,768,778,773,14,16,15,16,1,1,2,2,14,-10,5,-2,1,-1
224,224,224,224,14,17,15,16,1,2,2,2,0,0,0,-3,2,-1
412,407,407,417,20,19,20,21,3,2,2,2,5,0,-10,1,-1,-1
318,304,304,300,14,17,15,16,1,4,2,2,14,0,4,-3,2,-1
243,239,239,234,14,14,15,13,1,3,2,1,4,0,5,0,-1,2
220,206,201,196,14,17,15,16,1,3,1,3,14,5,5,-3,2,-1
300,300,295,295,18,19,18,19,2,2,1,1,0,5,0,-1,1,-1
623,609,614,614,18,17,18,16,1,1,2,1,14,-5,0,1,-1,2
534,529,534,534,14,14,15,13,1,2,2,2,5,-5,0,0,-1,2
567,557,576,1045,18,19,18,13,1,2,2,1,10,-19,-469,-1,1,5
234,234,234,243,14,17,15,16,2,1,4,1,0,0,-9,-3,2,-1
1012,1012,1007,1007,13,14,15,13,3,2,1,1,0,5,0,-1,-1,2
698,689,689,689,17,16,18,18,1,1,1,1,9,0,0,1,-2,0
215,210,210,210,18,19,18,19,1,2,2,2,5,0,0,-1,1,-1
215,215,220,210,14,14,15,13,1,1,2,3,0,-5,10,0,-1,2
440,431,426,426,17,16,18,16,2,1,1,2,9,5,0,1,-2,2
243,229,224,215,14,14,13,13,4,3,3,1,14,5,9,0,1,0
286,281,281,281,18,17,18,16,1,2,1,1,5,0,0,1,-1,2
679,679,674,674,13,14,15,16,1,3,3,1,0,5,0,-1,-1,-1
951,946,951,946,17,16,15,16,1,3,2,2,5,-5,5,1,1,-1
337,332,328,323,17,16,18,16,1,2,2,2,5,4,5,1,-2,2
267,253,257,248,14,14,15,16,3,2,2,3,14,-4,9,0,-1,-1
557,548,553,543,14,14,13,13,1,2,2,2,9,-5,10,0,1,0
736,726,726,726,17,19,18,18,2,4,1,2,10,0,0,-2,1,0
820,815,815,810,14,14,15,13,3,1,2,3,5,0,5,0,-1,2
187,182,182,182,14,14,15,16,1,2,1,1,5,0,0,0,-1,-1
843,839,839,834,14,14,13,13,1,3,2,2,4,0,5,0,1,0
970,960,965,960,17,16,18,18,2,1,2,2,10,-5,5,1,-2,0
487,473,473,473,18,19,18,18,1,2,3,2,14,0,0,-1,1,0
389,384,384,384,13,16,15,16,3,2,1,3,5,0,0,-3,1,-1
201,196,196,192,18,17,18,19,3,2,3,2,5,0,4,1,-1,-1
332,332,337,332,20,19,20,18,1,1,2,1,0,-5,5,1,-1,2
1040,1026,1026,1031,13,14,15,13,4,2,3,1,14,0,-5,-1,-1,2
923,918,918,914,21,19,21,21,3,1,2,1,5,0,4,2,-2,0
586,576,571,571,21,19,20,21,1,2,1,1,10,5,0,2,-1,-1
618,609,609,609,18,17,18,19,2,3,3,1,9,0,0,1,-1,-1
239,229,234,229,14,14,13,13,3,1,2,2,10,-5,5,0,1,0
642,637,632,632,17,16,15,16,4,4,1,1,5,5,0,1,1,-1
998,998,998,993,20,19,20,21,2,1,4,1,0,0,5,1,-1,-1
562,548,539,534,18,19,18,18,2,1,3,2,14,9,5,-1,1,0
515,510,510,510,21,19,20,21,3,2,1,1,5,0,0,2,-1,-1
974,970,974,970,13,14,15,13,1,1,2,3,4,-4,4,-1,-1,2
876,871,867,867,14,14,13,13,2,2,1,1,5,4,0,0,1,0
206,201,196,192,18,17,18,19,3,1,2,1,5,5,4,1,-1,-1
571,567,567,567,14,14,13,13,2,2,2,1,4,0,0,0,1,0
750,731,731,731,13,14,12,13,1,2,2,3,19,0,0,-1,2,-1
1054,1050,1050,1045,13,14,15,13,5,2,3,2,4,0,5,-1,-1,2
918,909,909,914,14,17,15,16,2,4,1,1,9,0,-5,-3,2,-1
220,220,220,220,14,14,15,16,2,3,2,1,0,0,0,0,-1,-1
482,482,487,487,14,14,15,16,1,1,2,1,0,-5,0,0,-1,-1
374,365,370,370,13,14,15,16,4,1,1,1,9,-5,0,-1,-1,-1
806,792,792,796,14,17,15,16,2,1,1,1,14,0,-4,-3,2,-1
820,810,806,806,18,19,18,19,2,1,1,1,10,4,0,-1,1,-1
726,717,717,721,13,14,15,16,1,2,1,2,9,0,-4,-1,-1,-1
796,787,782,787,14,14,13,13,3,1,1,2,9,5,-5,0,1,0
796,792,796,792,14,14,15,13,3,1,2,2,4,-4,4,0,-1,2
576,571,571,571,14,17,15,16,4,3,2,1,5,0,0,-3,2,-1
1007,998,989,984,13,14,15,13,1,3,3,2,9,9,5,-1,-1,2
286,286,286,286,18,19,18,19,1,2,2,1,0,0,0,-1,1,-1
520,520,520,515,21,19,20,19,1,2,1,1,0,0,5,2,-1,1
707,703,703,698,13,14,12,13,1,3,2,1,4,0,5,-1,2,-1
496,492,492,487,18,19,18,19,3,1,4,1,4,0,5,-1,1,-1
346,342,346,337,17,16,18,16,2,2,2,2,4,-4,9,1,-2,2
745,736,731,731,20,19,20,21,1,1,1,1,9,5,0,1,-1,-1
356,346,342,342,17,16,15,16,2,2,1,1,10,4,0,1,1,-1
1073,1059,1059,1059,13,14,15,16,1,2,1,3,14,0,0,-1,-1,-1
506,510,506,600,14,17,15,13,4,3,2,1,-4,4,-94,-3,2,2
224,215,210,215,14,17,15,16,1,2,3,1,9,5,-5,-3,2,-1
501,501,501,501,14,14,15,13,2,4,1,2,0,0,0,0,-1,2
515,510,515,520,14,14,13,13,1,2,1,1,5,-5,-5,0,1,0
632,623,623,628,20,19,21,21,1,2,1,1,9,0,-5,1,-2,0
468,459,468,468,13,14,12,13,1,4,2,1,9,-9,0,-1,2,-1
220,215,215,210,18,17,18,19,1,1,3,3,5,0,5,1,-1,-1
1045,1045,1040,1040,17,19,18,18,2,1,1,2,0,5,0,-2,1,0
1031,1021,1021,1021,13,14,15,13,1,2,2,2,10,0,0,-1,-1,2
534,529,529,524,18,17,18,19,1,2,2,1,5,0,5,1,-1,-1
876,871,862,862,21,19,20,21,1,1,1,2,5,9,0,2,-1,-1
257,243,239,229,14,14,13,13,2,2,1,2,14,4,10,0,1,0
1007,998,1007,1003,17,16,18,18,1,2,2,1,9,-9,4,1,-2,0
464,454,454,454,20,19,20,18,2,2,4,1,10,0,0,1,-1,2
768,759,759,754,13,16,15,16,2,3,2,2,9,0,5,-3,1,-1
824,820,820,815,21,19,20,21,2,3,1,1,4,0,5,2,-1,-1
337,328,323,323,13,17,15,16,1,1,1,1,9,5,0,-4,2,-1
539,529,524,529,21,19,20,19,1,1,1,1,10,5,-5,2,-1,1
440,436,445,440,13,14,12,13,1,1,2,1,4,-9,5,-1,2,-1
323,309,309,309,14,17,15,16,1,2,1,2,14,0,0,-3,2,-1
403,403,398,398,20,19,20,21,1,3,1,1,0,5,0,1,-1,-1
736,731,731,731,20,19,20,18,1,1,1,1,5,0,0,1,-1,2
740,731,731,731,17,16,18,18,1,2,2,1,9,0,0,1,-2,0
557,557,553,557,14,14,13,13,2,3,1,1,0,4,-4,0,1,0
342,337,337,337,13,14,12,13,1,3,3,2,5,0,0,-1,2,-1
342,337,342,342,13,14,12,13,3,3,2,1,5,-5,0,-1,2,-1
501,501,501,501,14,17,15,16,1,3,3,1,0,0,0,-3,2,-1
529,520,515,520,14,14,15,13,1,2,1,1,9,5,-5,0,-1,2
304,300,304,309,21,19,20,21,2,1,2,3,4,-4,-5,2,-1,-1
206,201,201,201,18,19,18,19,2,2,1,1,5,0,0,-1,1,-1
1073,1073,1073,1073,17,19,18,18,3,2,3,1,0,0,0,-2,1,0
684,679,670,674,13,14,15,13,1,3,5,1,5,9,-4,-1,-1,2
1068,1068,1073,1073,13,14,15,16,1,2,2,1,0,-5,0,-1,-1,-1
309,304,304,304,18,19,18,19,1,1,1,1,5,0,0,-1,1,-1
342,332,342,332,13,14,15,13,3,1,2,2,10,-10,10,-1,-1,2
989,984,989,984,17,16,18,18,1,2,2,3,5,-5,5,1,-2,0
496,492,487,487,21,19,21,19,1,1,2,1,4,5,0,2,-2,2
346,337,342,337,17,16,18,18,3,2,2,2,9,-5,5,1,-2,0
417,417,412,407,13,14,15,16,2,2,3,2,0,5,5,-1,-1,-1
1045,1040,1064,1045,17,16,15,16,3,2,2,1,5,-24,19,1,1,-1
370,360,365,360,13,14,15,13,2,2,2,1,10,-5,5,-1,-1,2
834,829,829,829,14,14,15,13,1,2,1,3,5,0,0,0,-1,2
600,586,590,590,18,19,18,19,3,2,1,1,14,-4,0,-1,1,-1
454,450,459,459,17,16,18,18,1,2,1,1,4,-9,0,1,-2,0
562,557,562,562,21,19,20,18,2,2,2,1,5,-5,0,2,-1,2
389,384,389,384,13,14,12,13,3,4,2,1,5,-5,5,-1,2,-1
993,989,989,984,17,16,18,18,1,2,3,2,4,0,5,1,-2,0
895,886,890,886,18,19,18,19,1,2,1,2,9,-4,4,-1,1,-1
1068,1068,1064,1064,20,19,20,18,1,1,1,1,0,4,0,1,-1,2
337,332,328,328,17,16,15,16,2,2,1,1,5,4,0,1,1,-1
820,810,820,815,18,17,18,19,1,2,2,2,10,-10,5,1,-1,-1
534,529,529,524,14,14,13,13,3,3,1,3,5,0,5,0,1,0
618,609,604,604,18,19,18,19,1,1,1,1,9,5,0,-1,1,-1
970,965,965,960,13,14,15,13,1,2,1,1,5,0,5,-1,-1,2
553,553,553,553,18,17,18,18,2,1,2,1,0,0,0,1,-1,0
328,318,314,314,14,14,13,13,1,3,2,2,10,4,0,0,1,0
553,543,543,539,14,14,15,13,1,2,3,2,10,0,4,0,-1,2
515,510,510,506,14,14,13,13,3,3,2,1,5,0,4,0,1,0
782,778,778,782,21,19,20,19,1,1,2,1,4,0,-4,2,-1,1
965,956,956,956,13,16,15,16,1,2,1,1,9,0,0,-3,1,-1
253,253,257,253,18,19,18,18,4,1,1,2,0,-4,4,-1,1,0
529,524,520,524,18,19,18,19,4,1,3,1,5,4,-4,-1,1,-1
679,674,674,674,20,19,20,21,1,2,1,1,5,0,0,1,-1,-1
965,951,951,951,20,19,20,18,2,1,2,2,14,0,0,1,-1,2
342,337,337,337,17,16,18,18,2,3,2,1,5,0,0,1,-2,0
374,370,365,360,13,14,12,13,2,2,3,2,4,5,5,-1,2,-1
220,220,215,215,21,19,20,21,1,3,1,2,0,5,0,2,-1,-1
595,590,586,586,14,14,15,13,1,3,1,2,5,4,0,0,-1,2
267,262,267,257,14,14,13,13,2,1,2,2,5,-5,10,0,1,0
1068,1059,1054,1050,17,16,18,18,1,4,3,1,9,5,4,1,-2,0
604,595,595,595,14,14,13,13,3,4,1,1,9,0,0,0,1,0
909,904,900,904,14,17,15,16,1,2,1,1,5,4,-4,-3,2,-1
459,450,454,450,13,14,15,13,1,2,1,1,9,-4,4,-1,-1,2
974,974,970,970,20,19,20,21,3,1,1,1,0,4,0,1,-1,-1
192,1073,1073,1068,18,19,18,18,2,2,2,1,-881,0,5,-1,1,0
337,332,328,328,17,19,18,19,2,1,1,1,5,4,0,-2,1,-1
243,239,239,234,14,17,15,16,1,1,3,2,4,0,5,-3,2,-1
1007,1007,196,1003,13,14,15,13,3,3,1,1,0,811,-807,-1,-1,2
1003,998,993,993,17,16,18,18,2,1,1,2,5,5,0,1,-2,0
853,843,839,834,18,17,18,16,1,2,1,2,10,4,5,1,-1,2
571,567,642,567,21,19,18,18,1,2,1,1,4,-75,75,2,1,0
295,281,276,281,21,19,20,19,1,2,1,1,14,5,-5,2,-1,1
356,351,351,346,20,19,20,21,3,1,4,1,5,0,5,1,-1,-1
220,220,220,220,18,17,18,16,3,1,1,1,0,0,0,1,-1,2
586,581,581,576,14,14,15,13,3,3,1,1,5,0,5,0,-1,2
440,436,440,440,13,16,15,16,1,2,2,1,4,-4,0,-3,1,-1
567,567,562,562,14,14,13,13,2,3,1,2,0,5,0,0,1,0
684,684,684,679,20,19,20,21,1,1,1,2,0,0,5,1,-1,-1
909,904,900,900,18,19,18,19,2,1,2,1,5,4,0,-1,1,-1
487,478,478,478,14,16,15,16,1,1,1,1,9,0,0,-2,1,-1
468,459,454,454,13,14,12,13,1,4,1,1,9,5,0,-1,2,-1
656,651,651,646,20,19,20,21,1,1,1,3,5,0,5,1,-1,-1
562,553,557,553,14,14,13,13,3,2,2,3,9,-4,4,0,1,0
506,506,506,506,21,19,20,19,2,1,1,1,0,0,0,2,-1,1
468,473,473,468,20,19,20,21,3,3,1,2,-5,0,5,1,-1,-1
759,754,750,745,17,16,18,16,4,1,4,1,5,4,5,1,-2,2
529,520,524,524,18,19,18,19,1,2,1,3,9,-4,0,-1,1,-1
600,590,590,586,14,14,15,13,1,3,2,1,10,0,4,0,-1,2
956,951,956,951,13,14,15,16,1,2,2,1,5,-5,5,-1,-1,-1
342,342,342,337,20,19,20,18,2,3,2,1,0,0,5,1,-1,2
384,370,370,365,13,14,15,13,3,1,1,2,14,0,5,-1,-1,2
839,829,834,834,21,19,20,18,2,2,2,1,10,-5,0,2,-1,2
848,834,829,829,14,14,13,13,2,3,1,1,14,5,0,0,1,0
206,201,201,196,18,17,18,19,1,2,1,3,5,0,5,1,-1,-1
337,323,323,328,17,17,15,16,2,2,2,1,14,0,-5,0,2,-1
374,370,370,370,17,19,18,18,2,1,2,1,4,0,0,-2,1,0
900,886,886,886,14,17,15,16,3,4,2,1,14,0,0,-3,2,-1
834,824,820,820,18,19,18,19,2,2,3,1,10,4,0,-1,1,-1
543,520,515,515,14,14,13,13,2,2,1,1,23,5,0,0,1,0
595,590,590,590,14,14,15,13,1,3,1,2,5,0,0,0,-1,2
900,890,890,895,18,17,18,16,1,1,3,1,10,0,-5,1,-1,2
229,224,229,229,21,19,20,21,1,1,1,2,5,-5,0,2,-1,-1
300,290,290,290,14,14,15,16,3,2,3,3,10,0,0,0,-1,-1
370,370,370,370,20,19,20,21,1,1,1,2,0,0,0,1,-1,-1
937,932,937,932,13,14,12,13,3,1,2,1,5,-5,5,-1,2,-1
220,220,220,220,21,19,20,19,2,1,1,3,0,0,0,2,-1,1
571,539,548,543,14,17,15,16,1,1,2,6,32,-9,5,-3,2,-1
318,309,304,304,14,14,15,13,4,3,2,2,9,5,0,0,-1,2
304,300,300,300,14,14,13,13,1,2,1,2,4,0,0,0,1,0
323,318,318,314,14,14,13,13,3,2,2,1,5,0,4,0,1,0
417,412,412,407,17,16,15,16,3,2,4,1,5,0,5,1,1,-1
646,642,646,646,17,16,18,18,3,3,2,2,4,-4,0,1,-2,0
778,773,773,768,20,19,20,21,2,1,2,2,5,0,5,1,-1,-1
600,590,595,595,18,17,18,19,3,2,2,1,10,-5,0,1,-1,-1
965,965,960,960,17,16,18,16,2,1,3,1,0,5,0,1,-2,2
520,515,515,520,18,19,18,19,1,1,1,1,5,0,-5,-1,1,-1
389,379,374,374,13,14,15,13,2,3,2,1,10,5,0,-1,-1,2
253,243,234,234,14,17,15,16,1,1,2,1,10,9,0,-3,2,-1
703,698,707,707,20,19,18,18,2,2,1,2,5,-9,0,1,1,0
853,853,848,848,18,19,18,18,1,1,2,1,0,5,0,-1,1,0
820,810,810,810,14,17,15,16,1,1,2,1,10,0,0,-3,2,-1
290,290,295,290,21,19,20,21,2,1,2,1,0,-5,5,2,-1,-1
262,262,253,253,14,14,15,13,2,1,1,2,0,9,0,0,-1,2
389,384,384,384,17,16,15,16,3,1,1,3,5,0,0,1,1,-1
923,923,923,923,14,14,15,16,2,3,2,3,0,0,0,0,-1,-1
914,909,909,918,14,14,15,13,3,3,2,1,5,0,-9,0,-1,2
726,717,721,726,20,19,18,18,4,2,1,1,9,-4,-5,1,1,0
224,220,220,215,14,17,15,16,1,1,1,3,4,0,5,-3,2,-1
909,900,900,900,14,14,13,13,1,4,1,1,9,0,0,0,1,0
281,276,271,267,14,14,15,13,1,1,1,2,5,5,4,0,-1,2
267,262,262,262,18,17,18,16,1,1,1,1,5,0,0,1,-1,2
646,637,637,632,17,16,18,18,2,3,2,1,9,0,5,1,-2,0
271,271,267,271,21,19,20,21,2,1,1,1,0,4,-4,2,-1,-1
923,909,890,890,14,14,15,13,1,3,3,1,14,19,0,0,-1,2
412,407,403,403,20,19,20,18,1,2,1,1,5,4,0,1,-1,2
820,810,806,801,21,19,20,21,1,1,1,2,10,4,5,2,-1,-1
192,187,1078,1078,14,17,15,16,1,1,1,1,5,-891,0,-3,2,-1
229,220,224,224,21,19,20,21,2,2,1,1,9,-4,0,2,-1,-1
524,496,478,468,14,14,13,13,1,2,1,2,28,18,10,0,1,0
501,496,496,496,21,19,21,19,2,1,1,1,5,0,0,2,-2,2
1003,998,998,993,20,19,20,18,1,2,1,2,5,0,5,1,-1,2
707,698,693,693,13,14,15,13,2,2,2,1,9,5,0,-1,-1,2
792,628,623,618,14,19,21,19,1,1,1,2,164,5,5,-5,-2,2
824,820,820,815,14,17,15,16,1,1,2,2,4,0,5,-3,2,-1
1045,1040,1040,1040,17,16,18,18,1,3,1,1,5,0,0,1,-2,0
487,487,482,487,21,19,21,21,1,1,1,1,0,5,-5,2,-2,0
576,571,567,567,14,14,13,13,2,3,2,2,5,4,0,0,1,0
614,614,614,609,18,17,18,16,1,1,2,4,0,0,5,1,-1,2
754,754,750,754,20,19,20,18,1,1,1,3,0,4,-4,1,-1,2
974,1021,974,979,13,14,15,13,3,1,1,1,-47,47,-5,-1,-1,2
529,515,510,506,14,17,15,16,1,1,2,1,14,5,4,-3,2,-1
909,895,895,890,18,19,18,19,1,2,1,1,14,0,5,-1,1,-1
932,918,914,914,13,17,15,16,1,2,1,2,14,4,0,-4,2,-1
778,768,759,754,13,14,12,13,1,3,1,1,10,9,5,-1,2,-1
1064,1059,1054,1050,20,19,20,18,2,1,2,1,5,5,4,1,-1,2
867,867,993,862,21,19,18,18,3,1,1,2,0,-126,131,2,1,0
651,646,651,646,17,16,15,16,1,4,1,1,5,-5,5,1,1,-1
431,426,431,426,13,14,12,13,1,3,2,3,5,-5,5,-1,2,-1
314,309,304,304,18,17,18,16,1,3,2,1,5,5,0,1,-1,2
534,534,534,529,21,19,20,21,3,1,1,1,0,0,5,2,-1,-1
1036,1026,1026,1026,13,14,12,13,2,2,2,2,10,0,0,-1,2,-1
248,239,229,234,14,14,15,13,3,3,3,1,9,10,-5,0,-1,2
857,843,853,853,21,19,20,21,1,2,2,2,14,-10,0,2,-1,-1
618,618,618,618,21,19,21,21,1,1,1,1,0,0,0,2,-2,0
609,609,604,618,18,19,18,19,1,1,1,1,0,5,-14,-1,1,-1
182,182,1078,1078,21,19,20,18,2,1,1,1,0,-896,0,2,-1,2
206,201,206,206,18,17,18,19,1,2,2,1,5,-5,0,1,-1,-1
248,243,234,239,18,17,18,16,1,2,1,1,5,9,-5,1,-1,2
984,984,979,979,17,16,18,18,1,1,1,2,0,5,0,1,-2,0
248,239,243,248,18,19,18,18,1,1,1,1,9,-4,-5,-1,1,0
989,984,979,979,13,14,12,13,3,1,1,2,5,5,0,-1,2,-1
979,970,970,965,17,16,15,16,1,2,2,1,9,0,5,1,1,-1
370,365,365,360,13,14,12,13,1,1,2,2,5,0,5,-1,2,-1
623,614,618,618,14,14,13,13,3,4,3,1,9,-4,0,0,1,0
187,182,637,1078,21,19,20,18,1,1,1,1,5,-455,-441,2,-1,2
1007,1007,1003,1003,17,16,18,18,3,1,1,2,0,4,0,1,-2,0
520,520,515,510,14,17,15,16,4,2,1,3,0,5,5,-3,2,-1
829,829,824,824,21,19,20,21,1,4,1,2,0,5,0,2,-1,-1
796,782,787,782,14,14,15,13,1,2,1,1,14,-5,5,0,-1,2
323,318,328,314,14,17,15,16,1,2,2,4,5,-10,14,-3,2,-1
820,806,806,806,18,19,18,19,3,2,1,2,14,0,0,-1,1,-1
346,342,342,337,17,16,15,16,1,3,3,4,4,0,5,1,1,-1
1007,998,998,1003,13,14,15,13,1,2,2,2,9,0,-5,-1,-1,2
843,834,824,820,14,14,15,13,1,3,2,1,9,10,4,0,-1,2
721,717,721,721,17,19,18,18,1,3,2,1,4,-4,0,-2,1,0
609,600,600,600,21,19,20,21,1,1,1,2,9,0,0,2,-1,-1
787,782,778,773,14,14,15,13,3,1,1,2,5,4,5,0,-1,2
529,501,501,510,14,17,15,16,2,2,1,3,28,0,-9,-3,2,-1
182,1073,1078,1073,18,19,20,18,1,2,1,2,-891,-5,5,-1,-1,2
182,1078,1078,182,21,19,20,19,2,1,1,1,-896,0,896,2,-1,1
815,806,806,801,21,19,20,19,1,1,1,1,9,0,5,2,-1,1
1073,1068,1073,1068,20,19,18,18,1,2,2,1,5,-5,5,1,1,0
843,834,834,834,18,19,18,18,3,1,1,1,9,0,0,-1,1,0
1012,1012,1007,1007,17,19,18,18,4,2,1,1,0,5,0,-2,1,0
1045,1036,1036,1031,13,14,15,16,3,3,2,2,9,0,5,-1,-1,-1
796,787,787,787,18,17,18,19,3,2,2,1,9,0,0,1,-1,-1
234,224,215,220,14,17,15,16,1,1,1,1,10,9,-5,-3,2,-1
1036,1036,1031,1040,13,14,15,13,2,2,1,1,0,5,-9,-1,-1,2
370,360,360,365,17,16,15,16,1,2,1,1,10,0,-5,1,1,-1
389,379,374,374,13,14,12,13,1,2,4,2,10,5,0,-1,2,-1
445,431,426,421,13,14,12,13,1,1,1,3,14,5,5,-1,2,-1
421,417,403,398,13,14,12,13,3,2,2,2,4,14,5,-1,2,-1
740,731,721,712,17,16,18,18,1,1,2,1,9,10,9,1,-2,0
440,431,426,431,17,16,15,16,1,2,1,1,9,5,-5,1,1,-1
1007,1007,1003,998,13,14,15,13,1,3,3,1,0,4,5,-1,-1,2
656,642,642,637,13,14,12,13,2,4,2,2,14,0,5,-1,2,-1
314,304,300,300,21,19,20,21,2,1,1,1,10,4,0,2,-1,-1
1068,1064,1064,1064,13,14,15,13,2,3,2,3,4,0,0,-1,-1,2
468,459,454,454,13,14,12,13,1,2,3,2,9,5,0,-1,2,-1
764,754,754,754,17,16,18,18,2,2,3,1,10,0,0,1,-2,0
618,614,604,609,14,14,13,13,1,4,3,1,4,10,-5,0,1,0
736,731,726,726,17,19,18,18,2,1,2,2,5,5,0,-2,1,0
853,848,843,848,18,17,18,18,3,1,1,1,5,5,-5,1,-1,0
318,328,323,318,14,14,15,13,3,1,1,1,-10,5,5,0,-1,2
829,824,820,824,21,19,20,21,1,3,1,1,5,4,-4,2,-1,-1
740,740,736,736,17,16,18,16,2,2,6,1,0,4,0,1,-2,2
1059,1054,1050,1054,17,16,15,16,3,5,3,1,5,4,-4,1,1,-1
773,773,773,768,13,16,15,16,1,3,3,1,0,0,5,-3,1,-1
267,253,257,253,18,17,18,16,1,1,2,2,14,-4,4,1,-1,2
276,276,271,267,14,17,15,16,1,3,1,2,0,5,4,-3,2,-1
890,890,895,890,14,14,15,16,2,2,2,2,0,-5,5,0,-1,-1
342,332,337,332,20,19,20,21,2,2,2,1,10,-5,5,1,-1,-1
234,234,234,224,14,14,15,13,2,3,3,4,0,0,10,0,-1,2
524,520,520,520,14,14,13,13,3,2,3,2,4,0,0,0,1,0
571,571,571,567,14,14,15,13,1,2,5,2,0,0,4,0,-1,2
1031,946,942,937,17,16,15,16,1,1,2,2,85,4,5,1,1,-1
276,262,262,257,21,19,20,21,4,3,2,1,14,0,5,2,-1,-1
951,946,946,946,20,19,20,21,2,2,1,1,5,0,0,1,-1,-1
239,234,229,224,21,19,20,19,1,1,2,2,5,5,5,2,-1,1
810,782,778,782,14,14,15,13,1,1,1,2,28,4,-4,0,-1,2
210,196,206,206,14,14,13,13,1,2,2,1,14,-10,0,0,1,0
281,276,271,271,14,17,15,16,2,1,2,1,5,5,0,-3,2,-1
590,586,581,581,14,14,13,13,2,3,4,1,4,5,0,0,1,0
248,243,239,239,21,19,20,18,1,1,1,1,5,4,0,2,-1,2
295,290,290,286,18,19,18,19,1,3,1,1,5,0,4,-1,1,-1
482,482,318,487,21,19,21,21,2,1,1,1,0,164,-169,2,-2,0
196,182,187,187,14,17,15,16,1,1,2,2,14,-5,0,-3,2,-1
923,904,895,886,14,14,13,13,2,1,1,2,19,9,9,0,1,0
342,337,337,332,17,16,18,18,2,2,2,1,5,0,5,1,-2,0
886,876,881,881,21,19,20,19,1,1,1,1,10,-5,0,2,-1,1
464,459,450,445,17,16,15,16,2,3,2,2,5,9,5,1,1,-1
909,904,900,900,18,19,18,19,1,1,1,2,5,4,0,-1,1,-1
637,632,637,632,17,16,15,16,1,2,2,1,5,-5,5,1,1,-1
932,932,928,923,17,16,18,16,1,1,1,2,0,4,5,1,-2,2
834,829,829,829,21,19,20,21,1,3,1,1,5,0,0,2,-1,-1
300,300,300,300,18,17,18,16,2,3,2,1,0,0,0,1,-1,2
932,923,923,918,13,14,13,13,1,2,2,3,9,0,5,-1,1,0
895,886,890,890,14,14,13,13,3,2,2,2,9,-4,0,0,1,0
796,796,787,792,14,17,15,16,1,3,3,2,0,9,-5,-3,2,-1
773,778,764,764,20,19,20,18,1,1,1,1,-5,14,0,1,-1,2
810,787,792,787,14,14,15,13,1,2,3,2,23,-5,5,0,-1,2
600,595,590,595,14,14,13,13,2,2,1,1,5,5,-5,0,1,0
417,398,407,398,13,14,15,13,2,2,2,1,19,-9,9,-1,-1,2
576,567,571,567,18,19,18,18,1,1,6,2,9,-4,4,-1,1,0
548,539,539,543,14,14,13,13,1,1,1,4,9,0,-4,0,1,0
1021,1026,1021,1021,20,19,20,18,3,1,1,1,-5,5,0,1,-1,2
1003,998,998,998,20,19,20,21,1,1,1,1,5,0,0,1,-1,-1
515,510,510,506,14,17,15,16,3,4,2,3,5,0,4,-3,2,-1
482,473,482,492,18,16,18,19,1,3,1,1,9,-9,-10,2,-2,-1
454,450,445,445,20,19,18,18,1,1,1,2,4,5,0,1,1,0
595,590,590,590,18,19,18,19,2,1,1,3,5,0,0,-1,1,-1
787,782,782,782,18,17,18,19,1,1,1,1,5,0,0,1,-1,-1
300,201,192,187,14,14,13,13,3,2,1,2,99,9,5,0,1,0
581,581,581,581,18,17,18,19,2,1,1,1,0,0,0,1,-1,-1
867,867,862,857,14,14,15,13,2,2,2,2,0,5,5,0,-1,2
989,984,979,979,20,19,20,21,2,3,1,1,5,5,0,1,-1,-1
600,590,586,581,14,14,13,13,1,1,2,2,10,4,5,0,1,0
539,539,534,529,18,17,18,16,2,1,2,2,0,5,5,1,-1,2
478,473,473,468,13,14,15,13,2,3,4,2,5,0,5,-1,-1,2
1040,1036,1026,1026,13,16,15,16,1,1,4,2,4,10,0,-3,1,-1
450,445,450,454,17,16,15,16,3,2,2,1,5,-5,-4,1,1,-1
487,482,478,478,21,19,20,21,1,1,1,1,5,4,0,2,-1,-1
693,698,689,689,13,14,15,13,3,5,1,2,-5,9,0,-1,-1,2
857,839,834,834,14,14,15,16,2,2,1,1,18,5,0,0,-1,-1
192,187,187,187,14,14,15,16,3,3,1,3,5,0,0,0,-1,-1
581,567,567,567,14,17,15,16,1,2,3,1,14,0,0,-3,2,-1
984,974,974,970,17,16,15,16,1,2,1,2,10,0,4,1,1,-1
473,459,454,445,20,19,20,18,4,1,4,2,14,5,9,1,-1,2
281,276,276,271,14,14,15,13,1,1,2,2,5,0,5,0,-1,2
604,595,590,595,21,19,20,21,1,3,1,1,9,5,-5,2,-1,-1
534,520,520,529,14,14,13,13,2,2,1,1,14,0,-9,0,1,0
740,740,736,736,13,14,15,13,1,1,5,1,0,4,0,-1,-1,2
881,876,876,876,14,14,13,13,2,7,1,3,5,0,0,0,1,0
290,286,286,281,18,19,18,19,1,2,4,1,4,0,5,-1,1,-1
942,942,951,951,13,14,15,13,5,3,1,2,0,-9,0,-1,-1,2
417,417,417,407,13,14,12,13,3,3,2,2,0,0,10,-1,2,-1
1017,1012,1012,1007,13,14,12,13,3,1,1,2,5,0,5,-1,2,-1
1003,1003,998,998,20,19,20,21,1,1,1,1,0,5,0,1,-1,-1
721,721,717,712,20,19,20,18,1,2,1,3,0,4,5,1,-1,2
196,196,192,192,14,14,13,13,2,3,1,4,0,4,0,0,1,0
914,909,904,904,14,17,15,16,1,1,1,2,5,5,0,-3,2,-1
276,267,267,267,14,14,15,13,3,1,1,1,9,0,0,0,-1,2
407,403,412,407,13,14,12,13,3,2,2,1,4,-9,5,-1,2,-1
618,618,618,618,18,19,21,19,3,2,1,2,0,0,0,-1,-2,2
946,946,942,951,17,19,18,18,1,2,1,1,0,4,-9,-2,1,0
440,431,431,431,13,14,12,13,2,2,3,1,9,0,0,-1,2,-1
693,698,689,693,13,14,15,13,2,1,1,1,-5,9,-4,-1,-1,2
937,937,937,937,17,16,15,16,3,1,2,2,0,0,0,1,1,-1
229,220,220,215,14,17,15,16,3,1,1,2,9,0,5,-3,2,-1
267,262,262,257,18,19,18,18,3,1,2,1,5,0,5,-1,1,0
778,768,768,764,13,14,12,13,2,3,2,1,10,0,4,-1,2,-1
604,595,590,590,18,19,18,19,3,3,1,2,9,5,0,-1,1,-1
496,492,576,496,21,19,23,19,1,1,1,1,4,-84,80,2,-4,4
623,618,623,623,14,14,15,13,3,2,3,3,5,-5,0,0,-1,2
764,754,759,759,17,19,18,18,3,2,2,1,10,-5,0,-2,1,0
698,689,689,684,17,16,15,16,2,2,1,2,9,0,5,1,1,-1
304,309,304,300,21,19,20,19,2,1,3,2,-5,5,4,2,-1,1
1007,1003,1003,1003,17,16,15,16,3,2,2,1,4,0,0,1,1,-1
1003,1007,1003,1003,13,14,15,16,4,2,3,2,-4,4,0,-1,-1,-1
1073,1064,1068,1068,20,19,18,18,2,2,2,2,9,-4,0,1,1,0
454,450,445,445,17,16,18,18,2,2,3,1,4,5,0,1,-2,0
206,201,206,201,21,19,20,21,1,1,2,6,5,-5,5,2,-1,-1
548,534,529,534,14,14,13,13,3,2,3,1,14,5,-5,0,1,0
679,674,674,670,13,14,15,13,3,1,2,2,5,0,4,-1,-1,2
239,239,234,234,18,19,18,18,1,1,1,1,0,5,0,-1,1,0
464,454,450,450,20,19,18,18,4,1,1,2,10,4,0,1,1,0
515,515,515,510,18,17,18,19,3,2,2,1,0,0,5,1,-1,-1
271,267,267,267,18,19,18,18,1,1,1,1,4,0,0,-1,1,0
614,614,609,609,14,14,15,13,2,2,1,3,0,5,0,0,-1,2
595,595,590,590,21,19,20,21,1,1,1,1,0,5,0,2,-1,-1
487,482,478,478,18,19,18,18,1,1,1,1,5,4,0,-1,1,0
848,839,839,839,21,19,20,18,3,2,1,1,9,0,0,2,-1,2
1026,1026,1026,1026,17,16,15,16,3,1,3,1,0,0,0,1,1,-1
557,548,553,562,21,19,20,18,3,1,1,2,9,-5,-9,2,-1,2
281,286,286,281,14,17,15,16,2,1,2,2,-5,0,5,-3,2,-1
689,684,684,679,17,16,15,16,1,4,2,3,5,0,5,1,1,-1
862,857,857,853,14,14,13,13,2,2,1,2,5,0,4,0,1,0
239,224,224,224,18,17,18,16,3,2,1,1,15,0,0,1,-1,2
501,496,492,492,18,17,18,16,1,2,1,1,5,4,0,1,-1,2
440,426,421,426,13,14,12,13,3,3,1,3,14,5,-5,-1,2,-1
295,286,286,281,21,19,20,21,1,2,2,2,9,0,5,2,-1,-1
810,806,810,806,21,19,20,19,1,2,1,2,4,-4,4,2,-1,1
520,515,515,510,14,17,15,16,2,4,2,2,5,0,5,-3,2,-1
862,853,862,857,14,17,15,16,3,2,2,3,9,-9,5,-3,2,-1
482,468,464,459,14,14,12,13,1,3,2,3,14,4,5,0,2,-1
693,698,693,693,13,16,15,16,3,3,1,1,-5,5,0,-3,1,-1
1045,1040,1040,1040,13,14,12,13,1,4,2,1,5,0,0,-1,2,-1
609,604,609,604,21,19,21,21,1,1,1,2,5,-5,5,2,-2,0
501,501,501,501,14,14,13,13,3,3,2,1,0,0,0,0,1,0
281,271,271,276,18,19,18,18,1,2,1,1,10,0,-5,-1,1,0
581,576,571,576,14,14,15,13,1,3,1,1,5,5,-5,0,-1,2
267,257,257,253,18,17,18,16,1,2,2,2,10,0,4,1,-1,2
220,215,210,215,14,14,15,16,3,3,1,3,5,5,-5,0,-1,-1
717,717,717,717,20,19,20,18,1,1,2,1,0,0,0,1,-1,2
370,356,365,370,17,16,15,16,3,2,2,2,14,-9,-5,1,1,-1
1073,1068,1068,1073,13,14,12,13,3,2,1,1,5,0,-5,-1,2,-1
426,426,426,421,20,19,20,21,1,1,1,2,0,0,5,1,-1,-1
881,871,876,876,14,14,15,13,4,2,1,1,10,-5,0,0,-1,2
239,234,234,229,18,19,20,19,1,1,3,2,5,0,5,-1,-1,1
0,0,0,0,0,0,0,0,0,0,0,0,0,0,0,0,0,0
918,909,914,909,14,17,15,16,1,2,1,1,9,-5,5,-3,2,-1
445,440,440,436,20,19,20,21,2,3,1,2,5,0,4,1,-1,-1
271,262,262,257,14,17,15,16,3,1,3,2,9,0,5,-3,2,-1
914,909,909,909,21,19,21,19,3,1,2,1,5,0,0,2,-2,2
871,871,871,871,18,17,18,18,2,1,1,3,0,0,0,1,-1,0
768,768,764,764,13,14,12,13,1,3,1,2,0,4,0,-1,2,-1
736,731,726,726,13,14,12,13,1,1,1,2,5,5,0,-1,2,-1
1054,1054,1054,1054,20,19,18,18,1,1,2,1,0,0,0,1,1,0
820,815,815,810,14,14,13,13,6,1,1,2,5,0,5,0,1,0
750,745,745,745,13,14,12,13,2,1,2,2,5,0,0,-1,2,-1
576,562,562,562,14,14,13,13,1,4,1,1,14,0,0,0,1,0
403,398,398,393,17,16,15,16,2,1,2,1,5,0,5,1,1,-1
295,286,286,286,14,14,13,13,1,2,1,1,9,0,0,0,1,0
731,731,745,754,20,19,20,21,1,1,2,3,0,-14,-9,1,-1,-1
824,815,815,810,14,14,13,13,2,1,3,3,9,0,5,0,1,0
712,707,712,717,20,19,20,18,1,2,1,1,5,-5,-5,1,-1,2
501,496,496,492,14,17,15,16,1,2,2,2,5,0,4,-3,2,-1
323,314,314,314,18,17,18,16,1,2,2,1,9,0,0,1,-1,2
276,267,267,267,21,19,20,21,1,2,1,1,9,0,0,2,-1,-1
295,286,290,281,14,14,13,13,1,2,2,2,9,-4,9,0,1,0
464,464,464,464,13,16,15,16,3,3,1,2,0,0,0,-3,1,-1
586,576,586,590,14,17,15,16,1,2,2,1,10,-10,-4,-3,2,-1
586,571,571,571,14,14,15,13,1,2,1,1,15,0,0,0,-1,2
712,717,707,707,13,14,15,13,1,2,3,1,-5,10,0,-1,-1,2
440,426,421,421,13,14,15,13,5,2,1,2,14,5,0,-1,-1,2
914,914,914,909,21,19,21,21,1,2,1,1,0,0,5,2,-2,0
974,974,970,965,13,14,15,13,1,2,1,1,0,4,5,-1,-1,2
970,970,965,965,13,14,15,13,1,3,3,2,0,5,0,-1,-1,2
637,637,642,637,20,19,20,18,3,1,3,2,0,-5,5,1,-1,2
698,698,693,693,17,16,18,18,3,1,1,1,0,5,0,1,-2,0
712,703,693,693,17,19,18,18,3,1,2,3,9,10,0,-2,1,0
384,379,379,379,20,19,20,18,1,1,3,3,5,0,0,1,-1,2
881,876,871,867,21,19,20,18,1,3,1,1,5,5,4,2,-1,2
351,342,342,337,13,14,12,13,2,3,2,2,9,0,5,-1,2,-1
243,243,239,239,14,14,13,13,2,1,2,3,0,4,0,0,1,0
745,731,731,731,20,19,20,18,2,3,1,2,14,0,0,1,-1,2
482,473,473,468,14,14,15,13,1,3,1,1,9,0,5,0,-1,2
829,820,820,815,18,17,18,19,1,2,1,2,9,0,5,1,-1,-1
937,937,937,937,13,14,12,13,3,2,1,1,0,0,0,-1,2,-1
309,304,304,300,14,17,15,16,2,1,2,2,5,0,4,-3,2,-1
815,806,801,796,14,14,15,13,2,3,2,1,9,5,5,0,-1,2
374,370,374,370,13,14,12,13,1,2,3,2,4,-4,4,-1,2,-1
1045,1031,1017,1017,17,16,15,16,2,3,1,1,14,14,0,1,1,-1
646,646,646,637,17,19,18,18,1,1,3,2,0,0,9,-2,1,0
1031,1012,1007,998,13,14,12,13,1,4,1,2,19,5,9,-1,2,-1
496,501,501,496,18,19,18,19,3,1,4,1,-5,0,5,-1,1,-1
360,360,360,356,17,16,18,18,3,3,2,2,0,0,4,1,-2,0
468,464,468,468,20,19,18,18,2,2,2,1,4,-4,0,1,1,0
1064,1059,1054,1050,13,14,15,13,3,3,1,2,5,5,4,-1,-1,2
262,257,262,253,14,14,13,13,3,3,4,1,5,-5,9,0,1,0
562,562,562,557,18,19,18,18,2,1,1,2,0,0,5,-1,1,0
651,646,642,656,20,19,18,18,2,1,1,5,5,4,-14,1,1,0
210,206,210,206,18,19,18,19,1,2,2,1,4,-4,4,-1,1,-1
487,487,487,482,21,19,21,21,2,3,2,2,0,0,5,2,-2,0
567,562,562,562,21,19,20,21,1,1,1,1,5,0,0,2,-1,-1
820,824,815,820,14,17,15,16,1,5,3,1,-4,9,-5,-3,2,-1
501,492,492,492,14,17,15,16,1,3,1,2,9,0,0,-3,2,-1
923,909,904,904,14,17,15,16,1,1,1,3,14,5,0,-3,2,-1
276,276,271,267,18,19,18,18,2,1,1,2,0,5,4,-1,1,0
356,356,351,351,20,19,20,18,1,1,1,2,0,5,0,1,-1,2
928,923,923,923,14,14,15,13,1,3,1,3,5,0,0,0,-1,2
342,337,337,332,17,16,18,18,3,1,1,2,5,0,5,1,-2,0
295,290,290,286,18,19,18,19,3,3,1,1,5,0,4,-1,1,-1
712,707,707,707,17,16,18,18,2,2,1,1,5,0,0,1,-2,0
501,496,496,492,14,14,13,13,2,3,1,2,5,0,4,0,1,0
473,468,468,468,17,19,18,18,2,3,2,1,5,0,0,-2,1,0
440,431,431,426,13,16,15,16,3,2,2,1,9,0,5,-3,1,-1
1003,1003,993,993,13,14,15,16,4,1,1,2,0,10,0,-1,-1,-1
853,848,853,853,14,17,15,16,1,2,1,3,5,-5,0,-3,2,-1
801,801,801,801,14,14,13,13,2,2,2,1,0,0,0,0,1,0
426,426,426,421,13,14,12,13,3,3,2,1,0,0,5,-1,2,-1
342,337,332,332,13,14,15,13,1,1,1,2,5,5,0,-1,-1,2
871,862,862,857,21,19,20,18,2,2,1,1,9,0,5,2,-1,2
262,253,262,267,14,14,15,16,2,1,2,1,9,-9,-5,0,-1,-1
243,224,229,229,14,17,15,16,2,2,1,2,19,-5,0,-3,2,-1
942,937,923,918,13,14,13,13,2,1,1,2,5,14,5,-1,1,0
998,993,998,993,13,14,15,13,1,2,2,3,5,-5,5,-1,-1,2
1059,1054,1059,1050,17,19,18,18,1,1,2,2,5,-5,9,-2,1,0
201,196,192,192,18,19,18,19,1,1,2,1,5,4,0,-1,1,-1
609,604,604,604,18,17,18,19,2,2,1,1,5,0,0,1,-1,-1
670,665,665,660,13,14,15,16,1,2,2,1,5,0,5,-1,-1,-1
539,524,524,520,18,17,18,19,1,2,1,2,15,0,4,1,-1,-1
539,529,539,534,18,17,18,16,1,2,1,3,10,-10,5,1,-1,2
557,553,557,557,21,19,20,18,1,2,1,2,4,-4,0,2,-1,2
768,759,768,764,17,16,15,16,2,2,2,1,9,-9,4,1,1,-1
510,510,510,506,18,17,18,16,2,1,1,1,0,0,4,1,-1,2
820,810,815,815,18,19,20,19,1,2,1,1,10,-5,0,-1,-1,1
674,534,548,543,13,17,15,16,1,2,2,1,140,-14,5,-4,2,-1
637,628,628,632,17,17,18,18,2,1,1,1,9,0,-4,0,-1,0
276,257,257,248,14,17,15,16,2,1,1,2,19,0,9,-3,2,-1
651,632,637,637,20,19,20,21,2,1,1,2,19,-5,0,1,-1,-1
234,234,229,224,14,14,13,13,2,1,2,2,0,5,5,0,1,0
290,286,281,276,14,14,15,13,1,2,2,2,4,5,5,0,-1,2
984,974,974,970,13,14,15,16,2,3,2,1,10,0,4,-1,-1,-1
604,604,604,600,18,19,18,19,1,2,3,2,0,0,4,-1,1,-1
492,487,487,487,21,19,21,21,2,1,1,1,5,0,0,2,-2,0
257,257,248,253,14,14,15,13,1,2,3,1,0,9,-5,0,-1,2
1068,1064,1059,1059,20,19,20,18,2,1,1,1,4,5,0,1,-1,2
750,750,745,745,17,16,18,16,1,1,1,1,0,5,0,1,-2,2
318,318,318,314,14,14,13,13,2,4,2,1,0,0,4,0,1,0
768,764,764,764,20,19,20,18,5,1,2,3,4,0,0,1,-1,2
524,524,524,529,18,19,18,19,1,1,2,1,0,0,-5,-1,1,-1
257,248,239,243,21,19,20,18,1,1,1,1,9,9,-4,2,-1,2
370,365,365,365,17,19,18,18,2,2,1,1,5,0,0,-2,1,0
965,1064,960,960,20,14,20,18,1,1,1,1,-99,104,0,6,-6,2
778,773,773,806,13,14,15,13,1,2,1,3,5,0,-33,-1,-1,2
318,318,318,323,14,14,13,13,3,3,4,2,0,0,-5,0,1,0
360,351,342,342,13,14,12,13,2,4,1,2,9,9,0,-1,2,-1
946,946,946,951,17,16,18,18,1,3,1,3,0,0,-5,1,-2,0
1017,1007,993,993,13,14,12,13,2,3,1,2,10,14,0,-1,2,-1
946,937,937,932,17,19,18,18,1,2,1,2,9,0,5,-2,1,0
773,768,768,764,17,16,18,18,2,2,1,1,5,0,4,1,-2,0
928,909,909,909,14,17,15,16,1,2,2,1,19,0,0,-3,2,-1
829,824,824,820,18,17,18,19,2,3,2,1,5,0,4,1,-1,-1
1007,979,979,974,17,16,18,18,1,4,4,1,28,0,5,1,-2,0
436,431,426,426,17,16,15,16,2,1,2,3,5,5,0,1,1,-1
1045,1040,1036,1031,17,16,18,16,1,1,1,2,5,4,5,1,-2,2
182,1078,1073,1068,14,14,12,13,2,1,2,1,-896,5,5,0,2,-1
909,909,932,909,21,19,20,21,2,3,1,1,0,-23,23,2,-1,-1
346,346,346,342,13,14,12,13,1,1,2,1,0,0,4,-1,2,-1
581,567,571,576,18,19,18,18,3,4,1,1,14,-4,-5,-1,1,0
548,539,539,534,21,19,20,21,1,2,1,2,9,0,5,2,-1,-1
445,440,440,440,13,14,12,13,3,2,3,2,5,0,0,-1,2,-1
810,801,792,796,18,17,18,19,3,2,1,1,9,9,-4,1,-1,-1
989,974,965,965,13,14,12,13,5,1,1,2,15,9,0,-1,2,-1
1045,1036,1036,1036,17,16,18,18,1,2,1,1,9,0,0,1,-2,0
1064,1059,1059,1059,13,16,15,16,2,1,1,3,5,0,0,-3,1,-1
524,515,515,510,14,14,15,13,3,3,1,1,9,0,5,0,-1,2
224,215,210,210,14,17,15,16,3,2,3,2,9,5,0,-3,2,-1
871,862,862,857,21,19,20,18,1,2,2,2,9,0,5,2,-1,2
300,286,290,290,21,19,20,19,1,4,1,3,14,-4,0,2,-1,1
342,342,342,337,13,16,15,16,2,4,2,2,0,0,5,-3,1,-1
576,571,571,571,14,14,13,13,3,1,2,1,5,0,0,0,1,0
557,553,553,548,21,19,20,21,3,1,2,2,4,0,5,2,-1,-1
346,342,346,346,17,16,18,18,1,2,2,1,4,-4,0,1,-2,0
342,342,346,342,20,19,20,18,3,3,2,1,0,-4,4,1,-1,2
787,782,853,782,18,19,18,19,2,2,1,1,5,-71,71,-1,1,-1
553,548,548,543,14,14,13,13,1,1,1,1,5,0,5,0,1,0
656,651,656,651,13,16,15,16,1,2,2,1,5,-5,5,-3,1,-1
642,637,637,637,20,19,20,18,2,2,1,1,5,0,0,1,-1,2
506,501,501,496,18,19,18,19,3,1,3,3,5,0,5,-1,1,-1
876,871,876,871,21,19,20,18,2,1,1,1,5,-5,5,2,-1,2
220,220,215,224,18,19,18,19,2,3,1,1,0,5,-9,-1,1,-1
890,890,890,890,18,19,18,19,2,2,1,1,0,0,0,-1,1,-1
492,487,487,492,14,14,15,13,2,2,2,3,5,0,-5,0,-1,2
637,632,637,637,13,14,12,13,2,1,2,1,5,-5,0,-1,2,-1
717,707,707,707,13,14,15,13,2,2,2,1,10,0,0,-1,-1,2
623,623,618,614,18,17,18,19,3,3,1,1,0,5,4,1,-1,-1
637,623,628,628,17,17,15,16,2,2,2,1,14,-5,0,0,2,-1
660,651,646,646,20,19,20,18,2,2,1,1,9,5,0,1,-1,2
900,904,895,895,21,19,20,21,1,1,2,1,-4,9,0,2,-1,-1
323,323,309,318,14,17,15,16,2,1,2,1,0,14,-9,-3,2,-1
698,693,693,689,13,14,15,13,2,3,1,1,5,0,4,-1,-1,2
229,224,229,229,21,19,20,19,2,3,1,1,5,-5,0,2,-1,1
974,974,970,970,13,16,15,16,1,1,2,1,0,4,0,-3,1,-1
384,379,379,374,13,14,12,13,2,4,2,3,5,0,5,-1,2,-1
853,853,857,853,14,17,15,16,1,2,1,2,0,-4,4,-3,2,-1
876,867,867,862,14,14,15,13,3,1,2,2,9,0,5,0,-1,2
956,946,956,956,20,19,20,21,3,3,1,2,10,-10,0,1,-1,-1
787,787,787,782,18,19,18,19,2,1,1,1,0,0,5,-1,1,-1
1026,1026,1026,1026,17,16,18,16,3,3,2,1,0,0,0,1,-2,2
271,257,257,253,14,17,15,16,2,2,2,2,14,0,4,-3,2,-1
243,234,229,224,14,14,15,13,3,1,4,2,9,5,5,0,-1,2
196,196,187,187,14,14,15,16,3,1,1,1,0,9,0,0,-1,-1
942,974,946,942,17,16,15,16,1,2,4,1,-32,28,4,1,1,-1
618,600,595,595,14,14,13,13,1,1,4,1,18,5,0,0,1,0
1036,1031,1031,1031,13,14,15,16,2,2,1,1,5,0,0,-1,-1,-1
281,271,267,267,18,19,18,18,1,1,3,1,10,4,0,-1,1,0
323,318,323,318,18,17,18,16,2,1,2,1,5,-5,5,1,-1,2
1073,1064,1068,1068,17,16,15,16,3,2,2,1,9,-4,0,1,1,-1
604,595,595,595,21,19,20,21,3,2,1,1,9,0,0,2,-1,-1
998,998,1007,1012,20,19,18,18,2,3,2,1,0,-9,-5,1,1,0
215,215,215,215,21,19,20,21,4,3,1,1,0,0,0,2,-1,-1
590,581,576,581,18,17,18,16,1,1,3,1,9,5,-5,1,-1,2
229,229,229,229,14,14,15,13,2,1,2,1,0,0,0,0,-1,2
421,412,407,407,17,16,18,18,1,2,1,1,9,5,0,1,-2,0
956,956,960,956,20,19,20,21,3,2,2,1,0,-4,4,1,-1,-1
234,234,229,224,18,17,18,19,3,1,1,2,0,5,5,1,-1,-1
717,707,698,689,13,14,15,13,3,3,3,2,10,9,9,-1,-1,2
1064,1059,1059,1059,20,19,20,18,2,1,1,1,5,0,0,1,-1,2
581,576,581,576,21,19,20,18,3,2,1,1,5,-5,5,2,-1,2
862,853,857,848,14,17,15,16,1,1,3,2,9,-4,9,-3,2,-1
623,614,609,609,14,14,15,13,2,2,1,3,9,5,0,0,-1,2
431,426,426,426,13,14,12,13,1,2,3,2,5,0,0,-1,2,-1
721,717,717,717,13,14,15,13,1,2,1,1,4,0,0,-1,-1,2
665,660,656,656,13,14,12,13,3,3,1,1,5,4,0,-1,2,-1
614,600,600,604,18,19,20,19,1,1,1,1,14,0,-4,-1,-1,1
914,918,918,914,18,19,21,19,2,1,2,1,-4,0,4,-1,-2,2
848,834,839,829,14,14,13,13,1,2,2,4,14,-5,10,0,1,0
253,248,248,248,21,19,20,18,1,1,2,1,5,0,0,2,-1,2
501,492,492,492,14,17,15,16,1,1,1,3,9,0,0,-3,2,-1
698,693,689,689,20,19,20,18,3,1,1,1,5,4,0,1,-1,2
295,286,281,281,14,14,13,13,1,2,3,1,9,5,0,0,1,0
717,712,712,712,13,14,12,13,2,2,1,2,5,0,0,-1,2,-1
323,323,323,323,18,19,18,19,2,1,1,2,0,0,0,-1,1,-1
867,857,857,857,21,19,20,21,1,2,1,1,10,0,0,2,-1,-1
914,909,909,909,14,17,15,16,2,3,2,1,5,0,0,-3,2,-1
900,904,904,904,14,17,15,16,2,1,2,1,-4,0,0,-3,2,-1
726,721,717,717,13,14,15,13,1,3,2,2,5,4,0,-1,-1,2
581,576,581,581,18,17,18,19,1,1,2,1,5,-5,0,1,-1,-1
862,862,857,857,14,17,15,16,1,1,1,2,0,5,0,-3,2,-1
576,567,571,571,14,14,15,13,3,2,3,1,9,-4,0,0,-1,2
506,501,506,496,14,14,13,13,2,2,2,1,5,-5,10,0,1,0
431,426,421,417,17,16,18,18,3,2,2,3,5,5,4,1,-2,0
407,403,398,398,13,14,15,13,3,1,2,2,4,5,0,-1,-1,2
431,431,431,431,13,14,15,13,1,3,1,3,0,0,0,-1,-1,2
792,782,782,778,18,19,18,18,3,2,1,1,10,0,4,-1,1,0
773,764,768,764,17,16,18,18,1,1,4,1,9,-4,4,1,-2,0
374,351,351,346,13,14,15,16,3,2,1,2,23,0,5,-1,-1,-1
534,524,524,529,14,14,13,13,5,3,1,1,10,0,-5,0,1,0
300,286,286,290,21,19,20,21,2,1,1,4,14,0,-4,2,-1,-1
543,534,534,534,18,17,18,16,1,2,2,2,9,0,0,1,-1,2
773,768,768,768,20,19,20,18,2,3,1,1,5,0,0,1,-1,2
468,464,459,459,13,14,12,13,1,3,3,3,4,5,0,-1,2,-1
923,923,928,923,18,17,18,19,2,2,2,1,0,-5,5,1,-1,-1
632,628,628,623,13,17,15,16,1,1,1,1,4,0,5,-4,2,-1
379,370,374,370,13,16,15,16,1,2,3,2,9,-4,4,-3,1,-1
979,974,970,970,20,19,20,18,2,1,1,1,5,4,0,1,-1,2
482,482,478,478,14,17,15,16,1,1,1,1,0,4,0,-3,2,-1
698,693,693,693,13,14,12,13,1,2,2,1,5,0,0,-1,2,-1
1026,1026,1017,1017,13,14,12,13,2,5,3,1,0,9,0,-1,2,-1
239,229,234,229,18,19,18,19,1,1,2,2,10,-5,5,-1,1,-1
496,482,487,482,18,19,18,19,3,2,2,1,14,-5,5,-1,1,-1
553,543,539,576,14,14,13,13,1,2,1,1,10,4,-37,0,1,0
843,843,839,839,21,19,20,18,2,1,1,1,0,4,0,2,-1,2
224,210,210,224,14,17,15,16,1,1,1,1,14,0,-14,-3,2,-1
951,937,946,956,13,14,15,13,2,1,1,1,14,-9,-10,-1,-1,2
1050,1050,1050,1045,13,14,12,13,3,1,1,3,0,0,5,-1,2,-1
867,857,853,853,18,19,18,18,1,1,1,3,10,4,0,-1,1,0
600,600,600,600,21,19,20,21,2,1,1,1,0,0,0,2,-1,-1
487,487,487,487,14,14,15,13,1,1,2,1,0,0,0,0,-1,2
614,609,609,609,21,19,21,21,1,2,1,1,5,0,0,2,-2,0
834,829,834,829,14,17,15,16,2,2,2,2,5,-5,5,-3,2,-1
473,468,468,468,17,16,15,16,1,4,1,2,5,0,0,1,1,-1
1064,1054,1064,1068,17,16,15,16,1,2,1,1,10,-10,-4,1,1,-1
248,239,239,239,18,17,18,18,1,2,1,1,9,0,0,1,-1,0
886,876,867,862,14,14,13,13,1,2,1,2,10,9,5,0,1,0
295,281,286,281,18,19,18,19,3,1,2,2,14,-5,5,-1,1,-1
721,843,843,843,20,19,20,18,2,2,1,1,-122,0,0,1,-1,2
956,951,951,946,20,19,20,21,1,1,1,3,5,0,5,1,-1,-1
182,182,182,182,21,19,21,19,2,1,1,1,0,0,0,2,-2,2
379,374,365,365,13,16,15,16,3,3,2,2,5,9,0,-3,1,-1
440,426,431,426,13,14,15,16,2,2,3,2,14,-5,5,-1,-1,-1
951,951,951,951,17,19,18,18,1,1,1,2,0,0,0,-2,1,0
482,482,492,482,18,17,18,19,1,1,2,1,0,-10,10,1,-1,-1
914,914,909,909,14,17,15,16,1,3,1,3,0,5,0,-3,2,-1
356,346,337,337,17,16,18,16,2,2,1,3,10,9,0,1,-2,2
960,956,956,956,20,19,20,21,3,2,1,2,4,0,0,1,-1,-1
843,834,839,834,14,14,15,13,1,2,2,3,9,-5,5,0,-1,2
1045,1040,1040,1040,20,19,18,18,2,3,1,2,5,0,0,1,1,0
1003,998,998,998,17,16,18,18,2,4,1,3,5,0,0,1,-2,0
365,365,360,360,13,14,15,16,1,3,3,1,0,5,0,-1,-1,-1
853,843,839,839,18,17,18,18,1,1,1,1,10,4,0,1,-1,0
881,881,881,876,18,19,18,18,3,1,2,1,0,0,5,-1,1,0
1073,1078,1068,1068,13,14,15,13,1,1,2,1,-5,10,0,-1,-1,2
436,459,426,426,13,14,15,16,1,1,1,1,-23,33,0,-1,-1,-1
886,886,886,886,14,14,13,13,1,2,2,1,0,0,0,0,1,0
937,937,932,932,13,14,15,13,3,3,1,1,0,5,0,-1,-1,2
862,857,857,853,18,17,18,18,1,2,1,2,5,0,4,1,-1,0
515,510,520,520,14,17,15,16,4,2,2,1,5,-10,0,-3,2,-1
867,862,862,857,21,19,20,18,2,3,2,1,5,0,5,2,-1,2
492,482,478,487,14,14,15,16,1,1,1,1,10,4,-9,0,-1,-1
548,534,524,529,14,14,13,13,1,3,1,2,14,10,-5,0,1,0
918,909,909,904,14,14,15,13,1,2,1,2,9,0,5,0,-1,2
1031,1026,1021,1021,20,19,20,21,5,1,1,3,5,5,0,1,-1,-1
867,862,867,867,14,14,13,13,1,1,2,1,5,-5,0,0,1,0
637,637,632,632,20,19,20,21,2,1,1,1,0,5,0,1,-1,-1
806,801,801,801,21,19,21,21,1,1,4,1,5,0,0,2,-2,0
1036,1031,1031,1026,17,16,15,16,2,1,2,1,5,0,5,1,1,-1
717,712,707,707,13,14,15,13,2,3,1,1,5,5,0,-1,-1,2
492,492,487,482,21,19,21,19,2,1,1,2,0,5,5,2,-2,2
834,824,824,829,14,17,15,16,3,2,1,1,10,0,-5,-3,2,-1
946,937,937,979,17,19,18,18,2,2,1,1,9,0,-42,-2,1,0
210,210,210,206,21,19,20,21,1,1,2,1,0,0,4,2,-1,-1
951,942,942,942,17,16,18,18,3,2,2,1,9,0,0,1,-2,0
895,886,881,876,14,17,15,16,1,1,2,2,9,5,5,-3,2,-1
459,459,524,454,20,19,23,18,1,1,1,1,0,-65,70,1,-4,5
529,529,543,534,18,19,18,18,2,2,2,1,0,-14,9,-1,1,0
637,637,628,628,20,19,18,19,1,1,1,1,0,9,0,1,1,-1
576,581,571,576,14,17,15,16,1,5,3,1,-5,10,-5,-3,2,-1
201,196,196,196,18,17,18,16,3,2,3,2,5,0,0,1,-1,2
234,224,220,229,14,14,15,13,1,1,1,1,10,4,-9,0,-1,2
895,890,890,886,21,19,20,19,1,1,2,1,5,0,4,2,-1,1
984,979,979,979,17,16,15,16,1,2,1,3,5,0,0,1,1,-1
473,464,464,454,17,16,15,16,1,1,2,2,9,0,10,1,1,-1
304,300,300,295,14,17,15,16,1,3,1,4,4,0,5,-3,2,-1
389,384,379,374,13,14,12,13,3,2,1,3,5,5,5,-1,2,-1
843,839,839,839,21,19,20,21,1,1,2,1,4,0,0,2,-1,-1
276,271,271,267,18,19,18,18,1,1,1,2,5,0,4,-1,1,0
192,192,187,182,14,17,15,16,2,2,1,2,0,5,5,-3,2,-1
290,286,286,276,14,14,13,13,1,1,2,2,4,0,10,0,1,0
829,824,824,824,18,19,18,19,1,1,1,1,5,0,0,-1,1,-1
642,632,632,637,13,14,13,13,2,2,1,1,10,0,-5,-1,1,0
1026,1031,1026,1021,17,16,18,18,3,1,2,2,-5,5,5,1,-2,0
421,417,421,417,17,16,18,16,1,1,2,1,4,-4,4,1,-2,2
960,951,951,946,17,16,18,16,4,2,3,2,9,0,5,1,-2,2
1021,1017,1017,1017,13,14,15,16,1,1,1,1,4,0,0,-1,-1,-1
689,693,698,689,13,14,15,13,1,3,4,2,-4,-5,9,-1,-1,2
736,721,717,717,13,16,15,16,3,1,1,1,15,4,0,-3,1,-1
1007,1003,993,998,17,16,18,16,3,3,1,1,4,10,-5,1,-2,2
243,229,224,210,14,14,13,13,3,3,2,4,14,5,14,0,1,0
1021,1012,998,998,13,14,12,13,1,3,1,3,9,14,0,-1,2,-1
417,412,407,412,13,14,12,13,3,1,1,1,5,5,-5,-1,2,-1
492,492,487,487,18,19,18,19,2,3,2,1,0,5,0,-1,1,-1
276,267,271,271,14,17,15,16,1,2,2,2,9,-4,0,-3,2,-1
693,684,684,689,13,14,15,13,1,2,2,1,9,0,-5,-1,-1,2
956,951,946,946,20,19,20,21,1,2,1,1,5,5,0,1,-1,-1
586,581,576,576,14,17,15,16,3,1,1,3,5,5,0,-3,2,-1
679,674,665,665,13,16,15,16,4,3,3,1,5,9,0,-3,1,-1
520,515,520,520,14,14,15,13,1,2,1,2,5,-5,0,0,-1,2
323,323,318,323,18,19,18,19,2,1,1,3,0,5,-5,-1,1,-1
309,304,309,304,14,17,15,16,3,2,1,2,5,-5,5,-3,2,-1
717,707,707,703,13,14,15,13,1,2,1,2,10,0,4,-1,-1,2
403,398,398,398,13,14,12,13,1,2,2,1,5,0,0,-1,2,-1
904,900,900,895,14,17,15,16,2,1,4,1,4,0,5,-3,2,-1
323,309,318,314,14,17,15,16,1,2,2,1,14,-9,4,-3,2,-1
543,548,539,543,18,17,18,16,2,1,3,3,-5,9,-4,1,-1,2
759,759,759,754,13,14,15,16,1,3,2,2,0,0,5,-1,-1,-1
876,876,881,881,14,17,15,16,2,2,1,2,0,-5,0,-3,2,-1
215,210,206,210,21,19,20,21,1,1,3,1,5,4,-4,2,-1,-1
886,881,881,881,14,14,15,13,3,1,1,2,5,0,0,0,-1,2
417,417,412,407,20,19,18,18,1,1,1,1,0,5,5,1,1,0
914,904,904,900,14,17,15,16,1,1,1,2,10,0,4,-3,2,-1
464,464,464,459,13,14,15,16,2,1,3,2,0,0,5,-1,-1,-1
717,707,712,712,13,14,15,13,2,3,2,1,10,-5,0,-1,-1,2
323,318,323,323,14,14,13,13,2,2,3,2,5,-5,0,0,1,0
787,773,778,773,14,14,15,13,1,2,1,3,14,-5,5,0,-1,2
323,314,309,309,18,19,18,19,3,2,1,1,9,5,0,-1,1,-1
539,534,524,524,14,14,15,13,3,2,1,1,5,10,0,0,-1,2
989,984,984,984,13,14,12,13,3,2,1,1,5,0,0,-1,2,-1
586,576,581,581,14,14,15,13,2,2,3,2,10,-5,0,0,-1,2
1045,1045,1045,1036,13,14,15,13,1,3,3,2,0,0,9,-1,-1,2
618,618,623,632,18,19,18,18,2,2,1,1,0,-5,-9,-1,1,0
562,548,548,548,18,17,18,18,1,2,3,2,14,0,0,1,-1,0
356,346,342,351,20,19,20,21,2,3,1,1,10,4,-9,1,-1,-1
196,192,187,187,14,14,13,13,1,1,1,2,4,5,0,0,1,0
1040,1040,1036,1026,13,14,12,13,3,3,2,4,0,4,10,-1,2,-1
918,914,918,918,21,19,21,19,1,3,2,1,4,-4,0,2,-2,2
431,426,426,426,20,19,20,21,3,2,1,1,5,0,0,1,-1,-1
726,721,726,726,20,19,20,21,1,3,3,1,5,-5,0,1,-1,-1
332,328,318,323,20,19,21,21,1,1,1,1,4,10,-5,1,-2,0
684,679,679,674,13,14,15,16,1,3,2,2,5,0,5,-1,-1,-1
295,281,276,271,14,17,15,16,1,1,1,1,14,5,5,-3,2,-1
646,642,646,637,13,14,12,13,2,2,2,3,4,-4,9,-1,2,-1
196,187,187,187,18,19,21,19,3,2,1,1,9,0,0,-1,-2,2
515,510,510,515,14,14,15,13,2,1,2,3,5,0,-5,0,-1,2
862,843,843,843,14,17,15,16,1,3,1,1,19,0,0,-3,2,-1
220,210,210,210,18,19,18,19,4,2,3,1,10,0,0,-1,1,-1
890,890,890,886,18,17,18,16,1,2,2,2,0,0,4,1,-1,2
923,918,923,923,14,14,15,13,2,2,3,2,5,-5,0,0,-1,2
562,553,548,562,14,14,13,13,2,2,1,1,9,5,-14,0,1,0
778,768,773,773,13,14,12,13,2,2,2,3,10,-5,0,-1,2,-1
824,815,815,815,14,17,15,16,1,2,1,3,9,0,0,-3,2,-1
534,529,529,529,18,19,18,19,2,2,2,1,5,0,0,-1,1,-1
1073,1068,1068,1068,13,14,12,13,1,2,3,1,5,0,0,-1,2,-1
745,736,740,740,20,19,18,18,3,1,2,1,9,-4,0,1,1,0
829,824,834,820,14,14,13,13,2,3,2,2,5,-10,14,0,1,0
487,426,431,426,18,16,15,16,2,2,1,3,61,-5,5,2,1,-1
262,262,257,257,18,17,18,16,1,4,2,2,0,5,0,1,-1,2
351,342,342,342,13,14,12,13,1,1,2,3,9,0,0,-1,2,-1
656,646,651,646,20,19,18,18,2,2,1,1,10,-5,5,1,1,0
974,970,965,965,20,19,20,21,2,1,1,1,4,5,0,1,-1,-1
731,721,717,712,13,14,12,13,1,2,1,2,10,4,5,-1,2,-1
665,665,665,665,13,14,12,13,1,2,3,1,0,0,0,-1,2,-1
937,932,932,932,20,19,18,18,1,1,1,1,5,0,0,1,1,0
1012,1007,1017,1007,20,19,20,21,1,1,2,1,5,-10,10,1,-1,-1
750,745,745,740,20,19,20,21,3,3,1,2,5,0,5,1,-1,-1
951,951,956,951,17,16,15,16,1,3,2,1,0,-5,5,1,1,-1
679,674,674,679,20,19,20,21,1,3,4,3,5,0,-5,1,-1,-1
721,721,721,717,13,14,15,13,4,3,2,1,0,0,4,-1,-1,2
646,637,637,637,20,19,18,18,1,1,3,2,9,0,0,1,1,0
206,196,196,201,14,14,13,13,2,3,2,1,10,0,-5,0,1,0
726,717,726,717,13,14,12,13,2,2,1,3,9,-9,9,-1,2,-1
956,951,946,946,17,16,18,18,2,1,3,2,5,5,0,1,-2,0
318,314,328,318,14,17,15,16,1,2,1,1,4,-14,10,-3,2,-1
379,379,379,356,13,14,15,13,3,2,1,1,0,0,23,-1,-1,2
923,918,923,918,14,17,15,16,2,3,2,3,5,-5,5,-3,2,-1
918,914,909,909,21,19,21,21,3,3,1,1,4,5,0,2,-2,0
295,281,286,281,18,17,18,19,1,2,1,2,14,-5,5,1,-1,-1
426,421,417,412,13,14,15,16,2,2,3,1,5,4,5,-1,-1,-1
750,745,740,740,17,16,18,18,2,2,5,2,5,5,0,1,-2,0
576,576,571,571,18,17,18,16,1,3,1,3,0,5,0,1,-1,2
393,389,389,384,13,14,12,13,3,2,1,1,4,0,5,-1,2,-1
623,623,618,614,14,14,13,13,2,1,1,4,0,5,4,0,1,0
651,646,646,642,20,19,20,18,1,1,1,1,5,0,4,1,-1,2
300,290,286,286,14,14,13,13,3,2,3,1,10,4,0,0,1,0
496,496,487,487,14,14,13,13,2,2,1,1,0,9,0,0,1,0
1054,1050,1054,1050,20,19,20,18,1,1,2,1,4,-4,4,1,-1,2
984,974,974,974,13,14,12,13,2,3,1,2,10,0,0,-1,2,-1
857,857,853,848,21,19,20,21,1,3,1,2,0,4,5,2,-1,-1
937,942,937,942,13,14,12,13,1,1,3,3,-5,5,-5,-1,2,-1
276,267,257,253,18,17,18,18,3,1,2,1,9,10,4,1,-1,0
520,515,520,515,21,19,20,21,2,1,1,1,5,-5,5,2,-1,-1
506,496,496,496,14,14,13,13,5,2,1,1,10,0,0,0,1,0
393,389,384,384,13,16,15,16,2,1,3,3,4,5,0,-3,1,-1
384,379,379,379,20,19,20,21,2,2,1,1,5,0,0,1,-1,-1
286,281,286,276,14,14,13,13,1,2,2,1,5,-5,10,0,1,0
454,450,454,454,20,19,20,18,3,2,1,2,4,-4,0,1,-1,2
923,918,914,914,14,14,15,16,2,3,3,3,5,4,0,0,-1,-1
529,529,524,524,14,14,13,13,3,3,2,1,0,5,0,0,1,0
581,576,576,576,18,19,18,18,2,1,3,1,5,0,0,-1,1,0
754,745,745,740,17,16,18,18,4,1,2,1,9,0,5,1,-2,0
576,567,567,562,21,19,20,21,3,1,2,1,9,0,5,2,-1,-1
262,257,262,257,21,19,20,18,1,3,3,1,5,-5,5,2,-1,2
886,876,876,989,14,14,15,13,3,3,2,1,10,0,-113,0,-1,2
276,271,271,271,21,19,20,21,1,2,1,2,5,0,0,2,-1,-1
567,567,571,567,14,14,13,13,2,2,3,1,0,-4,4,0,1,0
951,951,946,946,17,16,18,16,1,1,1,2,0,5,0,1,-2,2
567,571,562,567,14,14,13,13,3,1,1,1,-4,9,-5,0,1,0
346,346,342,337,13,14,12,13,1,1,2,2,0,4,5,-1,2,-1
318,300,290,290,14,14,13,13,3,2,3,1,18,10,0,0,1,0
300,290,290,290,14,14,15,13,3,2,2,2,10,0,0,0,-1,2
764,754,750,745,13,14,15,13,3,1,1,2,10,4,5,-1,-1,2
586,571,571,571,18,19,18,18,1,1,1,3,15,0,0,-1,1,0
515,506,510,501,14,14,15,16,1,2,1,2,9,-4,9,0,-1,-1
459,454,454,454,13,14,15,16,2,2,3,1,5,0,0,-1,-1,-1
454,454,454,454,13,14,12,13,1,2,3,1,0,0,0,-1,2,-1
946,937,942,932,20,19,20,18,2,2,1,2,9,-5,10,1,-1,2
876,871,871,904,14,14,15,13,1,1,1,1,5,0,-33,0,-1,2
262,257,262,257,21,19,20,18,1,1,2,1,5,-5,5,2,-1,2
524,524,524,520,14,17,15,16,2,1,1,2,0,0,4,-3,2,-1
1003,998,993,993,13,14,12,13,2,1,3,1,5,5,0,-1,2,-1
754,745,745,745,13,16,15,16,2,2,3,1,9,0,0,-3,1,-1
604,600,600,600,21,19,20,19,1,2,1,1,4,0,0,2,-1,1
689,684,679,684,20,19,20,21,1,2,1,1,5,5,-5,1,-1,-1
965,965,970,960,13,14,15,16,2,3,2,2,0,-5,10,-1,-1,-1
824,806,806,806,14,17,15,16,3,2,2,1,18,0,0,-3,2,-1
815,801,801,796,14,14,13,13,3,2,1,2,14,0,5,0,1,0
281,276,271,271,14,14,15,13,1,3,3,3,5,5,0,0,-1,2
501,496,496,496,21,19,21,21,2,2,1,2,5,0,0,2,-2,0
815,810,806,810,21,19,20,21,1,2,1,3,5,4,-4,2,-1,-1
478,473,473,473,13,14,15,16,1,3,1,1,5,0,0,-1,-1,-1
674,660,665,665,13,14,15,13,2,2,1,1,14,-5,0,-1,-1,2
515,510,506,506,18,19,18,19,4,2,1,1,5,4,0,-1,1,-1
665,660,660,674,17,16,18,18,1,2,1,1,5,0,-14,1,-2,0
970,960,951,951,17,16,15,16,1,3,3,3,10,9,0,1,1,-1
281,276,271,271,14,17,15,16,1,3,1,1,5,5,0,-3,2,-1
928,923,923,923,18,17,18,19,1,2,3,1,5,0,0,1,-1,-1
862,857,853,857,14,14,13,13,2,1,3,1,5,4,-4,0,1,0
304,300,300,304,14,17,15,16,2,2,1,3,4,0,-4,-3,2,-1
370,370,360,360,20,19,18,18,1,1,3,3,0,10,0,1,1,0
614,609,618,614,21,19,21,21,1,2,2,1,5,-9,4,2,-2,0
768,764,764,768,13,14,12,13,1,2,1,2,4,0,-4,-1,2,-1
689,689,684,679,17,16,18,18,1,3,1,1,0,5,5,1,-2,0
923,918,918,918,14,14,13,13,2,3,3,1,5,0,0,0,1,0
740,736,736,736,20,19,20,18,2,2,2,1,4,0,0,1,-1,2
628,614,609,604,18,17,18,19,1,1,2,2,14,5,5,1,-1,-1
876,867,871,867,18,19,20,18,2,1,3,2,9,-4,4,-1,-1,2
412,407,412,412,20,19,18,18,1,1,4,2,5,-5,0,1,1,0
295,290,295,295,18,19,18,19,3,2,1,1,5,-5,0,-1,1,-1
792,787,787,787,18,19,18,19,3,2,3,1,5,0,0,-1,1,-1
637,632,628,628,13,14,13,13,1,2,2,1,5,4,0,-1,1,0
468,464,468,468,17,16,18,16,1,4,1,1,4,-4,0,1,-2,2
660,656,651,651,17,19,18,18,1,1,1,2,4,5,0,-2,1,0
895,890,1064,886,21,19,20,19,1,3,1,2,5,-174,178,2,-1,1
295,290,286,281,21,19,20,19,2,1,1,1,5,4,5,2,-1,1
923,918,914,914,21,19,21,19,1,3,1,1,5,4,0,2,-2,2
295,281,286,286,18,17,18,19,1,2,2,1,14,-5,0,1,-1,-1
1054,1050,1050,1045,20,19,18,18,2,1,2,2,4,0,5,1,1,0
820,820,820,815,18,17,18,19,2,3,1,1,0,0,5,1,-1,-1
740,736,731,731,13,14,15,16,2,3,3,1,4,5,0,-1,-1,-1
309,332,309,314,14,16,15,16,2,1,1,3,-23,23,-5,-2,1,-1
398,393,393,389,13,14,12,13,1,2,1,1,5,0,4,-1,2,-1
192,187,187,187,14,17,15,16,3,2,1,1,5,0,0,-3,2,-1
337,337,337,332,13,14,12,13,1,1,2,2,0,0,5,-1,2,-1
450,445,450,450,17,16,15,16,2,2,2,2,5,-5,0,1,1,-1
445,431,436,436,13,14,15,16,1,3,1,1,14,-5,0,-1,-1,-1
759,754,754,754,20,19,20,21,1,1,1,1,5,0,0,1,-1,-1
295,290,290,290,21,19,20,21,4,1,1,1,5,0,0,2,-1,-1
309,300,300,300,14,14,15,13,1,2,1,1,9,0,0,0,-1,2
581,576,576,571,18,17,18,18,2,3,2,1,5,0,5,1,-1,0
900,890,886,886,14,14,13,13,1,3,1,2,10,4,0,0,1,0
351,342,342,342,13,14,12,13,1,2,2,1,9,0,0,-1,2,-1
876,871,871,867,14,14,15,13,1,2,2,2,5,0,4,0,-1,2
843,843,839,839,14,14,15,13,2,1,1,4,0,4,0,0,-1,2
346,342,342,337,17,16,18,16,2,2,1,2,4,0,5,1,-2,2
670,660,660,660,17,16,15,16,2,1,3,1,10,0,0,1,1,-1
1078,1073,1068,1068,13,14,12,13,1,3,2,3,5,5,0,-1,2,-1
412,403,403,403,13,14,15,13,2,2,3,2,9,0,0,-1,-1,2
782,768,768,764,18,19,20,18,1,4,1,1,14,0,4,-1,-1,2
239,234,234,239,14,17,15,16,1,1,1,1,5,0,-5,-3,2,-1
482,482,482,482,21,19,21,21,2,2,1,1,0,0,0,2,-2,0
210,206,201,201,14,17,15,16,1,2,1,1,4,5,0,-3,2,-1
459,454,459,454,20,19,20,21,1,2,2,1,5,-5,5,1,-1,-1
337,323,328,323,17,19,18,19,2,2,2,2,14,-5,5,-2,1,-1
810,810,810,810,21,19,20,21,2,2,1,1,0,0,0,2,-1,-1
1078,1073,1064,1064,13,14,12,13,1,3,4,2,5,9,0,-1,2,-1
342,342,337,337,20,19,20,18,1,1,1,1,0,5,0,1,-1,2
262,267,243,257,18,17,18,16,1,1,3,2,-5,24,-14,1,-1,2
182,1068,1068,1068,18,16,18,16,1,2,1,1,-886,0,0,2,-2,2
778,778,773,773,20,19,20,18,1,1,1,1,0,5,0,1,-1,2
553,543,548,548,21,19,20,18,2,2,1,1,10,-5,0,2,-1,2
239,220,224,224,18,19,18,19,3,2,1,1,19,-4,0,-1,1,-1
524,510,510,506,14,14,13,13,1,2,1,3,14,0,4,0,1,0
993,989,989,984,17,16,18,18,1,2,1,1,4,0,5,1,-2,0
445,440,436,431,13,14,12,13,2,1,1,1,5,4,5,-1,2,-1
1040,1040,1036,1031,17,16,18,18,1,1,1,2,0,4,5,1,-2,0
993,989,984,984,20,19,18,18,2,3,1,1,4,5,0,1,1,0
960,946,956,951,13,14,15,13,3,2,1,2,14,-10,5,-1,-1,2
220,210,210,210,21,19,20,21,1,2,1,3,10,0,0,2,-1,-1
271,262,267,262,21,19,20,18,3,2,1,3,9,-5,5,2,-1,2
412,403,262,412,20,19,20,18,1,3,1,1,9,141,-150,1,-1,2
295,281,271,271,18,17,18,18,1,2,1,1,14,10,0,1,-1,0
384,379,374,374,13,14,15,13,2,3,1,1,5,5,0,-1,-1,2
220,215,215,210,21,19,20,19,1,1,2,1,5,0,5,2,-1,1
914,923,909,909,14,14,15,13,1,2,3,3,-9,14,0,0,-1,2
792,782,782,787,14,17,15,16,1,1,1,1,10,0,-5,-3,2,-1
1040,1036,1036,1036,13,14,15,16,2,2,3,3,4,0,0,-1,-1,-1
384,374,379,374,17,19,18,18,1,3,1,1,10,-5,5,-2,1,0
956,951,956,946,17,19,18,18,2,1,2,1,5,-5,10,-2,1,0
201,196,196,192,21,19,21,19,1,1,2,1,5,0,4,2,-2,2
937,923,918,923,13,14,13,13,2,3,3,1,14,5,-5,-1,1,0
276,262,267,267,14,17,15,16,3,2,3,1,14,-5,0,-3,2,-1
1017,1021,1012,1012,17,16,18,16,1,1,3,1,-4,9,0,1,-2,2
914,909,909,909,21,19,21,21,1,1,1,1,5,0,0,2,-2,0
632,642,632,632,17,16,15,16,1,1,1,1,-10,10,0,1,1,-1
365,356,356,356,17,16,18,18,1,1,1,1,9,0,0,1,-2,0
834,820,824,815,14,14,15,13,2,2,2,2,14,-4,9,0,-1,2
496,464,464,464,14,14,12,13,3,2,3,3,32,0,0,0,2,-1
201,192,192,187,21,19,21,19,1,2,2,1,9,0,5,2,-2,2
642,637,637,637,13,14,15,16,2,2,3,2,5,0,0,-1,-1,-1
689,684,679,679,20,19,20,18,1,1,1,1,5,5,0,1,-1,2
820,815,810,810,14,14,15,13,1,3,1,3,5,5,0,0,-1,2
431,426,426,426,20,19,20,18,1,2,2,1,5,0,0,1,-1,2
220,215,220,220,21,19,20,21,1,3,2,3,5,-5,0,2,-1,-1
520,520,515,515,18,19,18,19,1,1,1,1,0,5,0,-1,1,-1
234,224,220,210,14,14,15,16,3,3,2,4,10,4,10,0,-1,-1
370,365,370,370,13,14,12,13,1,2,2,3,5,-5,0,-1,2,-1
346,337,337,337,20,19,20,18,3,2,2,1,9,0,0,1,-1,2
707,707,707,703,20,19,20,21,1,1,2,2,0,0,4,1,-1,-1
271,262,257,257,14,14,13,13,3,2,1,2,9,5,0,0,1,0
407,403,393,398,13,14,15,13,3,3,1,3,4,10,-5,-1,-1,2
970,960,956,951,13,14,12,13,1,3,3,2,10,4,5,-1,2,-1
276,271,271,271,14,17,15,16,2,2,1,1,5,0,0,-3,2,-1
881,876,881,876,21,19,20,21,3,1,3,4,5,-5,5,2,-1,-1
267,257,257,257,14,17,15,16,2,2,3,2,10,0,0,-3,2,-1
300,295,295,290,18,17,18,19,2,2,1,1,5,0,5,1,-1,-1
628,628,623,623,21,19,21,19,1,1,1,1,0,5,0,2,-2,2
515,510,506,506,21,19,20,19,1,2,1,2,5,4,0,2,-1,1
914,900,895,890,14,14,15,13,2,3,4,2,14,5,5,0,-1,2
974,965,960,956,13,14,15,13,1,1,2,3,9,5,4,-1,-1,2
426,421,426,426,20,19,18,18,2,2,2,2,5,-5,0,1,1,0
745,745,740,736,13,14,15,13,1,1,1,3,0,5,4,-1,-1,2
431,426,426,426,17,16,18,18,2,1,1,1,5,0,0,1,-2,0
1068,1064,1073,1068,13,14,15,13,3,2,2,1,4,-9,5,-1,-1,2
1031,1026,1021,1017,17,16,18,18,1,1,2,1,5,5,4,1,-2,0
824,810,815,815,14,17,15,16,1,2,3,2,14,-5,0,-3,2,-1
806,801,796,796,21,19,21,21,1,2,3,1,5,5,0,2,-2,0
581,581,576,576,21,19,20,21,1,1,2,2,0,5,0,2,-1,-1
951,946,942,942,13,14,15,16,1,3,4,3,5,4,0,-1,-1,-1
848,834,829,829,14,14,15,13,1,1,1,1,14,5,0,0,-1,2
623,600,600,604,14,14,13,13,2,2,1,2,23,0,-4,0,1,0
417,417,417,417,20,19,20,21,1,1,3,1,0,0,0,1,-1,-1
510,510,506,510,14,17,15,16,2,1,1,1,0,4,-4,-3,2,-1
445,440,436,440,13,14,12,13,2,1,1,3,5,4,-4,-1,2,-1
984,979,979,984,20,19,20,18,1,1,1,1,5,0,-5,1,-1,2
426,421,417,421,13,14,12,13,2,2,2,1,5,4,-4,-1,2,-1
815,806,806,806,21,19,20,19,1,2,1,1,9,0,0,2,-1,1
253,243,243,243,18,19,18,18,1,1,1,2,10,0,0,-1,1,0
998,979,984,984,13,14,15,13,2,2,1,1,19,-5,0,-1,-1,2
660,646,651,651,20,19,20,18,1,2,1,1,14,-5,0,1,-1,2
1003,998,998,993,17,16,15,16,2,2,1,2,5,0,5,1,1,-1
815,801,796,796,14,14,13,13,1,3,3,1,14,5,0,0,1,0
1054,1050,1050,1050,17,16,15,16,3,1,2,1,4,0,0,1,1,-1
998,998,993,993,20,19,18,18,4,3,1,1,0,5,0,1,1,0
914,900,900,890,14,14,15,13,2,2,2,2,14,0,10,0,-1,2
436,431,431,740,17,16,15,13,1,2,1,1,5,0,-309,1,1,2
829,820,815,810,14,17,15,16,2,1,1,2,9,5,5,-3,2,-1
524,520,529,529,21,19,20,19,2,2,1,1,4,-9,0,2,-1,1
1068,1064,1059,1059,17,16,18,16,1,1,1,1,4,5,0,1,-2,2
1073,1064,1050,1054,13,14,15,13,1,1,3,3,9,14,-4,-1,-1,2
778,773,768,764,17,16,18,18,2,2,3,1,5,5,4,1,-2,0
787,787,787,782,14,14,15,13,2,3,2,1,0,0,5,0,-1,2
698,698,698,693,17,16,18,18,2,2,1,1,0,0,5,1,-2,0
370,365,370,370,17,16,15,16,1,1,2,3,5,-5,0,1,1,-1
689,703,679,684,17,16,18,16,1,2,1,1,-14,24,-5,1,-2,2
646,642,637,637,20,19,20,18,3,1,1,2,4,5,0,1,-1,2
1003,998,998,998,17,16,15,16,3,2,1,1,5,0,0,1,1,-1
792,778,773,787,14,14,15,13,3,1,2,1,14,5,-14,0,-1,2
670,670,670,665,13,14,15,13,1,3,2,1,0,0,5,-1,-1,2
1007,1007,1003,1003,20,19,20,18,1,1,1,1,0,4,0,1,-1,2
754,750,750,750,20,19,20,21,3,2,1,2,4,0,0,1,-1,-1
192,182,182,182,14,14,13,13,1,2,1,2,10,0,0,0,1,0
740,736,731,736,20,19,20,21,2,1,1,1,4,5,-5,1,-1,-1
745,736,740,736,20,19,18,18,2,3,2,1,9,-4,4,1,1,0
867,862,862,862,21,19,20,18,1,1,1,1,5,0,0,2,-1,2
1026,1021,1026,1017,13,14,15,13,2,4,1,2,5,-5,9,-1,-1,2
206,196,201,196,14,14,15,13,1,2,1,2,10,-5,5,0,-1,2
351,346,342,342,17,16,18,16,3,1,1,2,5,4,0,1,-2,2
229,220,220,220,14,17,15,16,1,1,3,3,9,0,0,-3,2,-1
192,182,1073,1073,14,14,12,13,1,1,1,3,10,-891,0,0,2,-1
403,393,393,393,13,14,15,13,3,2,3,3,10,0,0,-1,-1,2
1045,1040,1045,1040,20,19,20,21,1,2,2,1,5,-5,5,1,-1,-1
726,721,717,717,20,19,18,18,1,1,1,1,5,4,0,1,1,0
426,421,421,421,13,14,15,16,2,3,3,1,5,0,0,-1,-1,-1
229,224,224,224,21,19,20,21,2,2,1,1,5,0,0,2,-1,-1
473,473,478,473,17,16,15,16,1,2,1,2,0,-5,5,1,1,-1
1021,1026,1017,1017,17,16,18,16,2,2,1,1,-5,9,0,1,-2,2
900,895,890,890,14,14,13,13,2,1,1,2,5,5,0,0,1,0
337,337,332,337,13,14,13,13,1,3,1,1,0,5,-5,-1,1,0
271,267,267,267,21,19,20,21,3,1,3,1,4,0,0,2,-1,-1
548,548,548,548,14,14,15,13,2,2,1,1,0,0,0,0,-1,2
609,600,600,600,18,19,20,19,1,2,1,1,9,0,0,-1,-1,1
398,403,398,398,13,14,12,13,1,2,2,1,-5,5,0,-1,2,-1
1036,1031,1031,1026,13,14,12,13,3,3,1,1,5,0,5,-1,2,-1
796,787,792,792,18,17,18,19,2,2,3,1,9,-5,0,1,-1,-1
759,750,750,750,17,19,18,18,2,2,1,1,9,0,0,-2,1,0
239,234,234,234,21,19,20,18,2,1,2,1,5,0,0,2,-1,2
229,220,215,210,14,14,13,13,3,2,1,2,9,5,5,0,1,0
239,234,234,445,14,14,15,9,3,2,1,1,5,0,-211,0,-1,6
1040,1036,1036,1036,17,16,15,16,1,2,2,1,4,0,0,1,1,-1
796,1073,801,801,14,14,15,16,2,1,1,1,-277,272,0,0,-1,-1
210,206,201,206,18,19,18,19,3,2,3,1,4,5,-5,-1,1,-1
314,309,309,309,14,17,15,16,1,1,2,3,5,0,0,-3,2,-1
342,342,332,332,20,19,20,18,3,1,1,1,0,10,0,1,-1,2
468,468,468,464,20,19,20,18,2,2,1,1,0,0,4,1,-1,2
595,586,581,576,14,17,15,16,3,2,2,2,9,5,5,-3,2,-1
576,571,571,571,18,17,18,18,3,2,2,1,5,0,0,1,-1,0
271,262,257,253,18,19,18,18,4,2,1,3,9,5,4,-1,1,0
839,829,834,834,21,19,20,18,1,1,1,1,10,-5,0,2,-1,2
731,726,731,731,13,14,15,13,1,2,1,3,5,-5,0,-1,-1,2
1045,1045,1045,1045,17,16,18,18,1,1,1,2,0,0,0,1,-2,0
923,918,918,918,21,19,21,21,1,2,1,1,5,0,0,2,-2,0
1064,1064,1078,1064,17,19,18,18,1,3,2,1,0,-14,14,-2,1,0
365,360,365,360,13,14,12,16,1,2,1,1,5,-5,5,-1,2,-4
970,965,965,965,17,19,18,18,2,1,1,1,5,0,0,-2,1,0
600,604,595,590,21,19,20,21,3,3,1,1,-4,9,5,2,-1,-1
829,829,829,820,21,19,20,19,1,1,2,2,0,0,9,2,-1,1
876,876,876,871,14,14,15,16,3,2,1,2,0,0,5,0,-1,-1
820,824,824,824,14,14,13,13,1,1,1,2,-4,0,0,0,1,0
374,360,356,356,13,14,15,13,3,2,1,2,14,4,0,-1,-1,2
974,970,965,965,17,16,15,16,2,3,1,3,4,5,0,1,1,-1
393,393,389,384,17,16,18,16,1,3,2,3,0,4,5,1,-2,2
703,698,693,693,20,19,20,18,2,1,1,1,5,5,0,1,-1,2
773,773,768,768,17,16,15,16,2,1,1,1,0,5,0,1,1,-1
215,215,210,210,14,14,15,13,2,3,1,2,0,5,0,0,-1,2
1073,1068,1064,1064,13,14,15,13,3,1,3,1,5,4,0,-1,-1,2
464,454,454,450,20,19,20,21,1,3,2,2,10,0,4,1,-1,-1
773,768,773,768,20,19,18,18,2,1,2,1,5,-5,5,1,1,0
914,904,904,909,18,17,18,16,1,2,3,1,10,0,-5,1,-1,2
206,1036,1040,1040,14,16,15,16,1,5,1,2,-830,-4,0,-2,1,-1
501,496,496,496,14,14,13,13,2,1,1,2,5,0,0,0,1,0
276,271,271,271,18,17,18,16,2,2,1,1,5,0,0,1,-1,2
417,407,736,393,13,14,18,13,3,1,1,1,10,-329,343,-1,-4,5
1078,1078,1078,1068,13,16,15,16,1,1,1,2,0,0,10,-3,1,-1
323,314,304,304,14,14,13,13,2,2,1,2,9,10,0,0,1,0
717,712,707,703,17,19,18,18,1,2,2,2,5,5,4,-2,1,0
370,356,604,356,13,14,13,13,2,4,1,2,14,-248,248,-1,1,0
323,314,314,314,18,17,18,16,1,1,2,1,9,0,0,1,-1,2
984,979,974,970,13,14,15,13,2,3,2,1,5,5,4,-1,-1,2
956,951,956,951,17,19,18,18,3,2,1,1,5,-5,5,-2,1,0
478,468,468,464,13,14,12,13,1,2,2,3,10,0,4,-1,2,-1
773,768,768,768,17,16,18,16,4,2,1,2,5,0,0,1,-2,2
478,473,473,473,13,14,15,16,1,2,3,1,5,0,0,-1,-1,-1
473,473,468,468,13,14,12,13,3,2,3,3,0,5,0,-1,2,-1
454,445,445,445,17,16,18,18,2,2,2,1,9,0,0,1,-2,0
829,824,824,820,21,19,20,21,2,3,1,3,5,0,4,2,-1,-1
656,651,651,646,20,19,18,18,1,1,1,1,5,0,5,1,1,0
646,637,637,637,20,19,20,18,1,1,1,3,9,0,0,1,-1,2
890,871,871,867,14,14,15,16,1,2,2,1,19,0,4,0,-1,-1
750,745,745,745,20,19,18,18,1,2,1,4,5,0,0,1,1,0
614,604,604,600,14,14,15,13,1,1,1,1,10,0,4,0,-1,2
309,295,304,314,14,14,13,13,1,2,2,1,14,-9,-10,0,1,0
478,468,515,473,17,16,18,16,2,4,1,3,10,-47,42,1,-2,2
881,881,876,871,14,14,15,13,2,3,2,2,0,5,5,0,-1,2
1068,1064,1064,1064,20,19,20,21,2,1,1,1,4,0,0,1,-1,-1
187,182,187,182,14,14,13,13,4,2,2,1,5,-5,5,0,1,0
642,637,637,632,13,14,12,13,1,1,3,1,5,0,5,-1,2,-1
1064,1059,1054,1054,13,14,15,13,1,1,1,2,5,5,0,-1,-1,2
515,506,506,473,14,14,13,13,2,1,1,2,9,0,33,0,1,0
998,989,993,989,13,14,12,13,2,2,2,1,9,-4,4,-1,2,-1
445,445,431,426,13,14,15,13,1,3,2,1,0,14,5,-1,-1,2
482,487,482,482,14,17,15,16,1,1,1,2,-5,5,0,-3,2,-1
389,384,389,384,20,19,20,21,1,2,1,1,5,-5,5,1,-1,-1
1003,1003,998,1003,13,14,15,13,1,3,1,1,0,5,-5,-1,-1,2
918,914,914,914,18,19,18,19,4,2,3,1,4,0,0,-1,1,-1
951,956,951,956,13,14,12,13,3,2,2,2,-5,5,-5,-1,2,-1
300,224,229,229,14,17,15,16,3,2,2,3,76,-5,0,-3,2,-1
403,398,403,398,13,14,15,16,3,1,2,2,5,-5,5,-1,-1,-1
337,323,328,328,17,17,15,16,2,2,1,1,14,-5,0,0,2,-1
1003,998,1003,1003,20,19,18,18,1,2,1,2,5,-5,0,1,1,0
792,787,782,796,14,14,13,13,3,1,1,3,5,5,-14,0,1,0
623,618,623,618,18,17,18,19,1,1,4,2,5,-5,5,1,-1,-1
360,360,356,356,13,14,15,13,1,3,2,1,0,4,0,-1,-1,2
979,979,979,974,20,19,20,18,2,3,2,2,0,0,5,1,-1,2
787,768,764,759,14,14,15,13,3,3,1,2,19,4,5,0,-1,2
557,553,553,553,18,19,18,18,1,2,3,2,4,0,0,-1,1,0
970,965,965,965,13,14,12,13,1,3,2,4,5,0,0,-1,2,-1
436,431,431,431,17,16,18,18,3,2,1,1,5,0,0,1,-2,0
210,201,201,196,18,17,18,19,1,1,2,1,9,0,5,1,-1,-1
679,674,674,674,20,19,18,18,1,1,3,2,5,0,0,1,1,0
534,524,529,524,18,17,18,16,3,2,2,4,10,-5,5,1,-1,2
656,656,646,651,20,19,20,21,1,1,1,1,0,10,-5,1,-1,-1
979,974,970,974,13,16,15,16,1,1,3,1,5,4,-4,-3,1,-1
965,956,951,951,13,14,15,13,3,3,2,3,9,5,0,-1,-1,2
403,398,398,403,13,14,15,13,4,2,1,2,5,0,-5,-1,-1,2
853,843,843,843,18,19,18,18,2,3,2,1,10,0,0,-1,1,0
731,726,726,726,17,16,18,16,1,2,3,2,5,0,0,1,-2,2
286,286,286,281,18,19,18,19,1,1,2,1,0,0,5,-1,1,-1
206,192,192,187,18,17,15,16,1,2,2,2,14,0,5,1,2,-1
810,810,801,801,14,14,13,13,1,3,1,1,0,9,0,0,1,0
562,557,557,553,14,14,15,16,2,3,2,2,5,0,4,0,-1,-1
843,834,834,834,14,14,15,16,3,3,1,1,9,0,0,0,-1,-1
754,745,740,745,20,19,20,18,2,3,1,2,9,5,-5,1,-1,2
1036,1021,1021,1017,13,14,12,13,2,2,1,2,15,0,4,-1,2,-1
459,454,454,454,20,19,18,18,1,1,1,2,5,0,0,1,1,0
890,871,867,862,14,14,15,13,2,1,1,2,19,4,5,0,-1,2
1050,974,979,974,17,16,15,16,2,2,2,2,76,-5,5,1,1,-1
876,867,862,862,14,14,13,13,1,4,1,1,9,5,0,0,1,0
450,445,450,445,17,16,15,16,3,1,1,5,5,-5,5,1,1,-1
314,304,304,300,14,14,15,13,2,1,1,2,10,0,4,0,-1,2
473,468,468,468,20,19,18,18,1,3,1,1,5,0,0,1,1,0
1031,1021,1021,1021,20,19,20,21,1,1,2,2,10,0,0,1,-1,-1
651,642,642,642,13,14,12,13,2,2,2,5,9,0,0,-1,2,-1
257,248,243,234,21,19,20,18,3,2,1,2,9,5,9,2,-1,2
543,534,529,529,14,14,15,13,3,2,1,2,9,5,0,0,-1,2
857,843,843,843,14,14,15,16,1,3,1,3,14,0,0,0,-1,-1
196,192,187,187,14,14,13,13,1,3,1,1,4,5,0,0,1,0
571,562,562,557,14,14,15,13,2,4,2,1,9,0,5,0,-1,2
196,192,192,187,18,19,18,19,1,1,2,2,4,0,5,-1,1,-1
1040,1036,1036,1036,20,19,20,21,3,3,1,1,4,0,0,1,-1,-1
393,389,389,389,20,19,18,18,2,1,1,1,4,0,0,1,1,0
276,271,271,271,14,14,13,13,3,1,1,2,5,0,0,0,1,0
600,590,595,595,18,17,18,19,1,3,2,1,10,-5,0,1,-1,-1
867,867,867,862,14,14,13,13,1,1,2,1,0,0,5,0,1,0
1064,1064,1064,1064,17,16,15,16,1,3,3,1,0,0,0,1,1,-1
623,618,618,618,14,17,15,16,1,2,1,1,5,0,0,-3,2,-1
857,853,853,843,18,19,18,18,6,2,1,2,4,0,10,-1,1,0
974,220,965,960,13,14,15,13,2,1,2,2,754,-745,5,-1,-1,2
192,182,187,182,14,14,15,13,2,2,1,2,10,-5,5,0,-1,2
318,309,309,314,14,17,15,16,2,1,2,1,9,0,-5,-3,2,-1
187,187,1078,1073,18,19,18,18,2,1,2,2,0,-891,5,-1,1,0
393,384,389,393,17,16,18,16,3,3,1,3,9,-5,-4,1,-2,2
937,932,937,932,20,19,20,18,1,2,2,1,5,-5,5,1,-1,2
843,848,862,848,14,14,13,13,2,2,2,1,-5,-14,14,0,1,0
389,384,384,384,20,19,20,18,5,1,3,2,5,0,0,1,-1,2
993,984,979,979,13,14,15,13,2,3,1,1,9,5,0,-1,-1,2
229,224,234,220,14,14,13,13,2,2,2,3,5,-10,14,0,1,0
1036,1026,1021,1017,13,14,12,13,1,1,1,2,10,5,4,-1,2,-1
829,824,829,824,14,14,13,13,2,2,1,3,5,-5,5,0,1,0
923,923,923,923,21,19,21,21,2,3,1,1,0,0,0,2,-2,0
323,314,314,314,18,19,18,19,1,2,1,1,9,0,0,-1,1,-1
768,754,750,759,13,14,12,13,1,3,3,1,14,4,-9,-1,2,-1
726,721,721,717,17,16,15,16,2,1,2,2,5,0,4,1,1,-1
918,914,914,914,18,19,18,19,3,2,3,1,4,0,0,-1,1,-1
1017,1012,1012,1007,17,16,18,18,2,3,1,1,5,0,5,1,-2,0
534,524,524,520,18,17,18,19,1,2,3,1,10,0,4,1,-1,-1
829,815,820,815,14,14,13,13,3,3,3,2,14,-5,5,0,1,0
314,309,309,309,18,17,18,16,3,1,1,1,5,0,0,1,-1,2
454,450,450,450,13,14,15,16,1,1,3,1,4,0,0,-1,-1,-1
689,679,684,679,17,16,18,16,2,2,2,1,10,-5,5,1,-2,2
609,600,595,590,18,19,18,19,2,1,2,2,9,5,5,-1,1,-1
248,243,257,267,14,17,15,16,3,1,2,1,5,-14,-10,-3,2,-1
712,703,703,698,13,14,12,13,1,1,1,2,9,0,5,-1,2,-1
440,436,440,440,13,16,15,16,3,2,2,1,4,-4,0,-3,1,-1
553,543,548,548,18,17,18,18,2,3,2,1,10,-5,0,1,-1,0
914,914,904,900,14,14,15,13,1,5,2,1,0,10,4,0,-1,2
267,262,262,257,21,19,20,21,2,3,1,2,5,0,5,2,-1,-1
623,618,618,618,14,14,15,16,1,2,1,1,5,0,0,0,-1,-1
314,314,309,304,14,14,13,13,2,3,3,2,0,5,5,0,1,0
464,464,468,459,13,16,15,16,1,1,2,1,0,-4,9,-3,1,-1
365,351,351,356,17,19,18,18,2,2,1,1,14,0,-5,-2,1,0
206,206,206,201,18,19,18,19,1,1,1,2,0,0,5,-1,1,-1
712,707,707,782,13,16,15,16,2,3,1,1,5,0,-75,-3,1,-1
571,562,562,557,14,14,15,16,2,2,2,1,9,0,5,0,-1,-1
300,295,295,295,21,19,20,21,1,1,1,1,5,0,0,2,-1,-1
759,764,768,764,17,19,18,18,1,1,3,1,-5,-4,4,-2,1,0
267,262,262,257,14,14,15,13,1,2,2,2,5,0,5,0,-1,2
960,960,960,960,20,19,20,21,1,1,1,1,0,0,0,1,-1,-1
459,450,454,450,17,16,18,16,2,2,2,2,9,-4,4,1,-2,2
651,646,646,637,17,16,18,18,2,3,2,2,5,0,9,1,-2,0
360,356,360,365,13,16,15,16,3,3,2,1,4,-4,-5,-3,1,-1
234,220,210,210,14,14,15,13,2,3,1,1,14,10,0,0,-1,2
426,417,421,412,13,16,15,16,4,2,1,2,9,-4,9,-3,1,-1
557,529,529,520,14,14,13,13,1,3,2,1,28,0,9,0,1,0
1045,1040,1036,1031,17,16,15,16,2,3,2,1,5,4,5,1,1,-1
646,646,642,642,20,19,18,18,1,1,1,2,0,4,0,1,1,0
248,239,239,243,14,14,15,13,2,1,1,2,9,0,-4,0,-1,2
257,253,253,253,21,19,20,21,2,2,3,1,4,0,0,2,-1,-1
796,792,792,787,18,19,18,19,1,1,2,1,4,0,5,-1,1,-1
342,332,337,332,13,14,15,16,3,2,2,1,10,-5,5,-1,-1,-1
946,942,942,937,20,19,20,18,1,2,1,2,4,0,5,1,-1,2
1003,993,998,998,17,16,18,18,2,2,2,1,10,-5,0,1,-2,0
581,581,581,581,21,19,20,21,1,2,1,1,0,0,0,2,-1,-1
1026,1026,1026,1021,20,19,18,18,1,1,2,6,0,0,5,1,1,0
201,201,196,196,21,19,21,19,2,3,1,1,0,5,0,2,-2,2
759,759,754,754,17,19,18,18,2,1,1,1,0,5,0,-2,1,0
571,567,567,571,14,14,13,13,2,2,1,2,4,0,-4,0,1,0
646,632,637,642,17,16,18,16,2,1,1,1,14,-5,-5,1,-2,2
679,670,670,670,17,16,18,18,2,2,1,2,9,0,0,1,-2,0
759,745,745,745,13,14,15,13,1,1,1,1,14,0,0,-1,-1,2
871,867,871,862,14,17,15,16,2,1,4,2,4,-4,9,-3,2,-1
1054,1050,1050,1045,17,16,18,18,2,1,2,1,4,0,5,1,-2,0
482,473,468,468,21,19,20,21,1,1,1,3,9,5,0,2,-1,-1
1007,1007,1003,1003,17,16,18,18,2,1,2,1,0,4,0,1,-2,0
571,571,571,571,21,19,20,21,3,1,1,3,0,0,0,2,-1,-1
853,853,853,843,21,19,20,21,1,1,1,1,0,0,10,2,-1,-1
224,210,210,210,14,14,13,13,3,2,1,1,14,0,0,0,1,0
759,750,754,754,13,14,12,13,2,3,2,3,9,-4,0,-1,2,-1
417,407,407,407,17,16,15,16,2,1,2,1,10,0,0,1,1,-1
590,581,581,581,21,19,20,19,1,2,1,3,9,0,0,2,-1,1
468,459,464,459,17,16,18,18,3,1,3,1,9,-5,5,1,-2,0
890,876,881,876,14,14,13,13,5,3,1,1,14,-5,5,0,1,0
857,843,848,853,21,19,20,18,1,2,1,3,14,-5,-5,2,-1,2
717,712,703,703,13,14,15,13,3,3,1,3,5,9,0,-1,-1,2
1036,886,1031,1036,17,14,18,18,2,1,2,3,150,-145,-5,3,-4,0
323,328,328,323,18,19,21,19,3,1,1,1,-5,0,5,-1,-2,2
689,684,689,684,17,16,15,16,2,3,2,1,5,-5,5,1,1,-1
764,759,759,759,20,19,20,18,2,1,2,1,5,0,0,1,-1,2
309,295,290,290,14,17,15,16,2,2,3,3,14,5,0,-3,2,-1
984,979,979,974,13,14,12,13,1,2,1,2,5,0,5,-1,2,-1
670,660,656,651,20,19,20,21,2,2,1,2,10,4,5,1,-1,-1
670,660,665,660,20,19,20,18,2,2,1,1,10,-5,5,1,-1,2
196,187,182,182,14,14,13,13,1,3,1,2,9,5,0,0,1,0
276,267,262,262,14,14,13,13,2,2,3,1,9,5,0,0,1,0
815,806,810,806,14,14,13,13,3,2,2,1,9,-4,4,0,1,0
1012,848,853,843,13,14,15,13,1,3,1,1,164,-5,10,-1,-1,2
379,379,389,276,13,14,15,9,1,2,3,1,0,-10,113,-1,-1,6
745,740,740,736,20,19,18,18,2,2,2,1,5,0,4,1,1,0
370,370,374,370,20,19,18,18,1,3,2,1,0,-4,4,1,1,0
468,464,468,468,20,19,20,21,1,2,1,1,4,-4,0,1,-1,-1
529,515,520,520,14,14,15,13,1,2,1,1,14,-5,0,0,-1,2
918,909,909,904,14,17,15,16,1,3,2,1,9,0,5,-3,2,-1
581,576,576,576,14,14,15,16,1,3,2,1,5,0,0,0,-1,-1
450,450,450,450,13,14,15,13,3,2,3,3,0,0,0,-1,-1,2
909,895,881,881,18,17,18,19,1,3,2,1,14,14,0,1,-1,-1
196,192,192,187,14,14,15,13,2,3,1,2,4,0,5,0,-1,2
314,304,304,304,18,17,18,19,1,2,1,2,10,0,0,1,-1,-1
628,609,604,609,14,14,13,13,1,1,1,1,19,5,-5,0,1,0
600,590,600,595,21,19,20,21,1,4,2,1,10,-10,5,2,-1,-1
548,482,482,482,21,19,18,19,3,1,1,1,66,0,0,2,1,-1
1045,1040,1045,1040,13,14,15,16,1,2,2,2,5,-5,5,-1,-1,-1
206,201,201,196,18,19,18,19,3,2,1,2,5,0,5,-1,1,-1
1003,1003,1003,998,13,14,15,13,3,3,2,2,0,0,5,-1,-1,2
210,201,201,196,14,14,15,13,1,3,2,2,9,0,5,0,-1,2
445,436,440,431,13,14,15,16,2,2,2,2,9,-4,9,-1,-1,-1
984,984,979,974,17,19,18,18,1,1,2,1,0,5,5,-2,1,0
853,853,853,853,18,19,18,18,1,2,2,1,0,0,0,-1,1,0
309,309,309,309,14,14,13,13,1,2,1,1,0,0,0,0,1,0
974,970,970,965,17,16,18,16,2,3,2,1,4,0,5,1,-2,2
323,323,323,318,18,19,18,19,3,1,2,3,0,0,5,-1,1,-1
1026,1021,1031,1026,13,16,15,16,3,2,2,1,5,-10,5,-3,1,-1
351,351,360,356,13,14,15,13,1,4,2,1,0,-9,4,-1,-1,2
956,951,951,951,20,19,18,18,1,2,1,1,5,0,0,1,1,0
239,234,229,229,14,14,15,13,4,1,1,1,5,5,0,0,-1,2
445,436,431,431,13,14,15,16,3,2,1,2,9,5,0,-1,-1,-1
707,703,707,703,20,19,20,21,2,1,2,1,4,-4,4,1,-1,-1
904,895,900,895,14,14,13,13,4,2,2,2,9,-5,5,0,1,0
843,834,834,829,14,17,15,16,3,1,3,2,9,0,5,-3,2,-1
815,810,806,801,14,14,13,13,1,2,1,1,5,4,5,0,1,0
187,1073,1073,1068,18,16,18,18,2,2,1,2,-886,0,5,2,-2,0
1054,1045,1045,1045,13,14,15,13,1,3,3,1,9,0,0,-1,-1,2
281,276,271,271,18,17,18,16,2,5,1,2,5,5,0,1,-1,2
834,829,829,829,14,17,15,16,1,2,2,3,5,0,0,-3,2,-1
351,351,351,351,13,14,12,13,2,2,1,2,0,0,0,-1,2,-1
374,370,370,370,17,16,18,16,2,2,1,2,4,0,0,1,-2,2
801,801,801,801,21,19,21,19,1,3,1,1,0,0,0,2,-2,2
1050,1040,1040,1040,20,19,20,21,2,2,1,1,10,0,0,1,-1,-1
656,646,651,646,13,14,12,13,2,2,1,2,10,-5,5,-1,2,-1
942,942,942,946,20,19,20,18,4,3,1,1,0,0,-4,1,-1,2
332,323,323,323,17,17,18,19,1,2,1,1,9,0,0,0,-1,-1
824,820,815,815,14,17,15,16,2,2,3,1,4,5,0,-3,2,-1
632,623,623,623,13,14,15,16,1,2,1,2,9,0,0,-1,-1,-1
618,614,614,609,18,17,18,16,4,2,1,1,4,0,5,1,-1,2
403,393,389,398,13,14,15,13,3,2,1,1,10,4,-9,-1,-1,2
750,745,750,750,20,19,20,21,1,2,1,1,5,-5,0,1,-1,-1
754,750,750,750,17,19,18,18,3,2,1,1,4,0,0,-2,1,0
951,946,951,946,13,16,15,16,1,2,3,2,5,-5,5,-3,1,-1
623,623,623,623,14,17,15,16,1,2,1,2,0,0,0,-3,2,-1
1017,1012,1017,1017,20,19,18,18,1,1,3,1,5,-5,0,1,1,0
1012,1007,1007,1003,13,14,12,13,2,3,1,1,5,0,4,-1,2,-1
1040,1040,1036,1040,20,19,18,18,1,1,1,1,0,4,-4,1,1,0
965,965,960,956,13,14,12,13,3,3,2,2,0,5,4,-1,2,-1
295,286,286,281,14,14,13,13,1,3,2,2,9,0,5,0,1,0
267,262,267,267,18,19,18,18,4,2,2,2,5,-5,0,-1,1,0
806,801,796,801,14,14,15,13,1,3,1,1,5,5,-5,0,-1,2
745,740,740,736,13,16,15,16,2,1,1,1,5,0,4,-3,1,-1
492,492,487,492,18,19,18,19,2,1,1,1,0,5,-5,-1,1,-1
754,745,750,750,13,14,12,13,3,2,2,1,9,-5,0,-1,2,-1
440,440,431,431,17,16,18,16,1,1,1,2,0,9,0,1,-2,2
801,792,787,787,14,17,15,16,4,3,3,1,9,5,0,-3,2,-1
778,600,595,595,13,14,15,13,1,4,2,1,178,5,0,-1,-1,2
487,487,482,487,14,17,15,16,2,1,1,2,0,5,-5,-3,2,-1
323,328,323,323,14,14,13,13,2,1,3,2,-5,5,0,0,1,0
1040,1026,1036,1031,13,14,15,13,1,6,2,2,14,-10,5,-1,-1,2
886,881,881,876,14,14,13,13,1,2,1,3,5,0,5,0,1,0
904,900,895,895,14,14,15,16,2,2,1,1,4,5,0,0,-1,-1
271,267,267,267,14,14,13,13,1,1,2,3,4,0,0,0,1,0
571,567,567,567,18,19,18,18,3,2,1,4,4,0,0,-1,1,0
890,881,881,890,14,14,15,13,1,2,1,3,9,0,-9,0,-1,2
707,693,693,693,17,16,18,18,1,2,3,1,14,0,0,1,-2,0
806,796,796,792,14,17,15,16,1,1,2,2,10,0,4,-3,2,-1
506,496,496,492,14,14,13,13,1,1,3,2,10,0,4,0,1,0
914,890,886,881,14,14,13,13,1,2,2,2,24,4,5,0,1,0
389,379,379,374,17,16,15,16,3,2,1,1,10,0,5,1,1,-1
965,951,946,946,17,16,18,18,2,1,1,2,14,5,0,1,-2,0
1031,1026,1026,1021,13,14,15,16,3,3,2,1,5,0,5,-1,-1,-1
1026,1026,1021,1021,17,16,18,18,3,1,1,1,0,5,0,1,-2,0
300,295,290,295,14,14,13,13,1,2,1,1,5,5,-5,0,1,0
337,328,328,323,17,17,18,19,2,1,2,1,9,0,5,0,-1,-1
407,398,398,403,20,19,18,18,2,2,1,1,9,0,-5,1,1,0
651,646,646,642,13,14,12,13,3,2,1,3,5,0,4,-1,2,-1
773,773,764,768,13,14,15,13,3,3,1,1,0,9,-4,-1,-1,2
337,323,328,323,20,19,18,19,2,2,2,1,14,-5,5,1,1,-1
824,824,839,848,18,19,18,18,3,3,1,2,0,-15,-9,-1,1,0
839,834,829,829,18,17,18,16,4,1,1,1,5,5,0,1,-1,2
970,956,951,951,13,14,12,13,1,2,1,2,14,5,0,-1,2,-1
300,295,290,290,21,19,20,21,1,1,1,1,5,5,0,2,-1,-1
567,567,562,562,14,17,15,16,2,1,2,2,0,5,0,-3,2,-1
951,937,946,942,17,16,15,16,3,1,1,4,14,-9,4,1,1,-1
332,323,328,328,20,19,18,19,1,2,1,1,9,-5,0,1,1,-1
979,974,965,960,13,14,15,13,3,3,1,2,5,9,5,-1,-1,2
576,562,562,567,14,14,13,13,2,2,3,2,14,0,-5,0,1,0
646,637,637,632,13,14,12,13,2,2,2,1,9,0,5,-1,2,-1
792,782,787,782,14,17,15,16,1,2,2,2,10,-5,5,-3,2,-1
393,379,379,379,13,14,12,13,2,2,1,2,14,0,0,-1,2,-1
342,342,337,337,17,16,18,18,1,1,2,1,0,5,0,1,-2,0
1021,1017,1017,1012,20,19,20,18,1,1,1,2,4,0,5,1,-1,2
576,571,567,567,18,19,18,18,3,1,1,2,5,4,0,-1,1,0
984,979,974,974,13,14,12,13,2,2,2,2,5,5,0,-1,2,-1
946,942,937,937,13,14,12,13,2,2,1,1,4,5,0,-1,2,-1
679,679,670,665,20,19,20,21,1,1,2,2,0,9,5,1,-1,-1
210,206,201,201,21,19,21,21,1,1,1,1,4,5,0,2,-2,0
309,304,304,300,18,19,18,19,3,3,2,2,5,0,4,-1,1,-1
998,993,998,989,17,16,18,18,1,1,2,2,5,-5,9,1,-2,0
262,257,253,257,18,17,18,18,4,3,1,3,5,4,-4,1,-1,0
787,782,778,782,21,19,20,21,1,2,1,1,5,4,-4,2,-1,-1
182,1073,1073,1073,14,14,12,13,1,2,3,3,-891,0,0,0,2,-1
1064,1059,1059,1059,20,19,20,18,2,1,1,1,5,0,0,1,-1,2
890,881,876,876,21,19,20,18,2,2,1,2,9,5,0,2,-1,2
360,351,374,351,20,19,20,18,2,2,1,2,9,-23,23,1,-1,2
750,750,750,750,17,16,18,18,1,1,1,1,0,0,0,1,-2,0
539,529,529,529,21,19,20,19,1,2,1,1,10,0,0,2,-1,1
787,773,768,773,14,14,15,13,1,2,2,1,14,5,-5,0,-1,2
567,548,548,548,18,17,18,18,1,2,1,1,19,0,0,1,-1,0
773,773,773,768,20,19,20,18,1,1,1,1,0,0,5,1,-1,2
1012,1007,1007,1007,13,14,15,13,2,3,1,3,5,0,0,-1,-1,2
543,534,529,529,14,17,15,16,3,3,1,1,9,5,0,-3,2,-1
712,707,717,707,13,14,15,13,1,2,2,3,5,-10,10,-1,-1,2
393,384,389,384,17,16,18,16,2,2,2,2,9,-5,5,1,-2,2
1073,1068,1068,1068,17,16,18,18,1,1,3,1,5,0,0,1,-2,0
693,684,684,684,17,16,15,16,2,2,1,1,9,0,0,1,1,-1
389,384,384,389,17,16,18,18,1,2,1,1,5,0,-5,1,-2,0
332,337,337,332,20,19,20,21,1,1,2,2,-5,0,5,1,-1,-1
1003,998,998,998,17,16,18,18,1,3,1,1,5,0,0,1,-2,0
323,318,318,318,18,17,18,16,1,1,1,2,5,0,0,1,-1,2
834,824,824,820,18,17,18,16,1,2,2,1,10,0,4,1,-1,2
534,520,529,534,21,19,20,18,1,1,2,1,14,-9,-5,2,-1,2
201,196,196,201,14,17,15,16,1,1,2,1,5,0,-5,-3,2,-1
543,534,529,534,14,14,13,13,3,3,1,1,9,5,-5,0,1,0
1036,1031,1036,1026,13,14,12,13,3,3,2,2,5,-5,10,-1,2,-1
600,590,595,595,14,14,13,13,1,2,2,2,10,-5,0,0,1,0
398,393,393,393,13,14,15,16,3,4,3,1,5,0,0,-1,-1,-1
323,318,323,318,14,17,15,16,2,3,2,1,5,-5,5,-3,2,-1
614,609,609,609,21,19,21,19,2,3,1,1,5,0,0,2,-2,2
1017,1007,1003,1007,13,14,15,13,2,3,1,1,10,4,-4,-1,-1,2
201,196,187,192,21,19,21,19,2,1,1,2,5,9,-5,2,-2,2
445,436,426,426,13,14,15,13,2,4,1,1,9,10,0,-1,-1,2
543,543,548,543,18,17,18,18,3,1,1,1,0,-5,5,1,-1,0
956,946,942,937,13,14,15,13,2,3,2,3,10,4,5,-1,-1,2
496,496,496,492,18,19,18,19,2,3,2,2,0,0,4,-1,1,-1
900,890,886,881,14,14,13,13,3,1,1,2,10,4,5,0,1,0
857,848,848,843,14,14,13,13,3,3,1,3,9,0,5,0,1,0
379,374,370,374,20,19,20,18,2,2,3,3,5,4,-4,1,-1,2
370,360,360,360,17,16,15,16,2,2,1,1,10,0,0,1,1,-1
407,403,403,393,13,14,12,13,1,2,1,2,4,0,10,-1,2,-1
970,965,960,960,17,16,18,18,2,1,1,2,5,5,0,1,-2,0
515,506,506,501,21,19,20,21,1,2,1,2,9,0,5,2,-1,-1
1059,1050,1054,1050,17,16,18,18,2,3,2,1,9,-4,4,1,-2,0
210,215,210,210,21,19,20,21,1,1,1,1,-5,5,0,2,-1,-1
745,740,740,736,13,14,12,13,2,2,2,2,5,0,4,-1,2,-1
721,712,717,717,13,16,15,16,2,3,1,1,9,-5,0,-3,1,-1
886,890,886,886,14,17,15,16,2,3,1,1,-4,4,0,-3,2,-1
478,473,478,478,20,19,20,18,1,2,2,1,5,-5,0,1,-1,2
220,220,215,215,18,17,18,16,2,3,1,2,0,5,0,1,-1,2
220,220,215,210,18,19,18,19,1,1,4,2,0,5,5,-1,1,-1
243,239,243,243,14,14,13,13,3,2,2,1,4,-4,0,0,1,0
923,923,923,918,14,14,13,13,2,3,3,2,0,0,5,0,1,0
534,534,529,524,14,14,15,13,3,2,1,3,0,5,5,0,-1,2
548,548,548,548,14,14,15,13,1,1,1,1,0,0,0,0,-1,2
210,206,206,206,21,19,20,21,2,1,1,1,4,0,0,2,-1,-1
824,824,820,820,21,19,20,21,1,1,1,2,0,4,0,2,-1,-1
374,365,360,356,13,14,12,13,1,2,2,2,9,5,4,-1,2,-1
1007,998,1003,1003,17,16,15,16,3,2,2,1,9,-5,0,1,1,-1
731,726,721,726,13,14,15,13,1,1,1,3,5,5,-5,-1,-1,2
1031,1031,1031,1026,13,16,15,16,2,1,2,1,0,0,5,-3,1,-1
960,956,956,956,17,16,15,16,2,3,1,3,4,0,0,1,1,-1
314,304,300,304,18,19,18,19,3,1,1,1,10,4,-4,-1,1,-1
881,867,881,876,18,19,18,18,3,2,1,1,14,-14,5,-1,1,0
300,300,300,300,18,19,18,19,2,1,1,1,0,0,0,-1,1,-1
998,989,989,984,17,16,18,18,2,1,3,3,9,0,5,1,-2,0
862,862,857,857,18,19,18,18,1,1,1,2,0,5,0,-1,1,0
365,360,356,360,13,14,15,16,1,3,2,3,5,4,-4,-1,-1,-1
506,492,496,492,14,14,13,13,3,2,2,3,14,-4,4,0,1,0
253,248,248,248,18,19,18,18,4,2,1,2,5,0,0,-1,1,0
1045,1040,1036,1036,17,16,15,16,2,1,3,3,5,4,0,1,1,-1
670,665,670,660,13,14,12,13,2,1,2,1,5,-5,10,-1,2,-1
778,773,773,773,20,19,18,18,2,2,1,1,5,0,0,1,1,0
590,642,581,581,14,14,15,16,3,1,2,1,-52,61,0,0,-1,-1
595,590,595,595,18,19,18,19,3,5,3,1,5,-5,0,-1,1,-1
370,360,360,356,17,16,15,16,2,4,1,2,10,0,4,1,1,-1
660,651,660,651,20,19,20,21,2,2,2,2,9,-9,9,1,-1,-1
407,403,398,393,17,16,18,16,2,2,1,1,4,5,5,1,-2,2
562,557,557,557,21,19,20,21,2,4,1,1,5,0,0,2,-1,-1
698,693,689,689,17,16,18,18,2,1,1,1,5,4,0,1,-2,0
609,618,614,609,14,14,13,13,2,1,1,2,-9,4,5,0,1,0
510,496,496,501,14,14,13,13,1,1,1,1,14,0,-5,0,1,0
754,754,759,750,13,14,15,13,1,3,5,2,0,-5,9,-1,-1,2
1059,1054,1050,1050,17,16,15,16,1,1,3,3,5,4,0,1,1,-1
824,974,820,820,18,14,18,19,3,1,2,1,-150,154,0,4,-4,-1
1026,1026,1021,1021,13,14,15,13,1,2,2,3,0,5,0,-1,-1,2
192,192,192,192,18,17,18,16,1,3,3,2,0,0,0,1,-1,2
309,304,304,300,14,17,15,16,1,2,2,2,5,0,4,-3,2,-1
431,436,440,450,20,19,20,18,1,1,1,1,-5,-4,-10,1,-1,2
651,642,651,646,17,16,15,16,4,1,2,2,9,-9,5,1,1,-1
365,356,360,356,20,19,18,18,2,2,1,1,9,-4,4,1,1,0
970,965,965,965,20,19,20,18,2,2,1,1,5,0,0,1,-1,2
839,824,824,824,14,17,15,16,3,3,1,1,15,0,0,-3,2,-1
529,529,529,529,21,19,20,19,1,3,1,1,0,0,0,2,-1,1
464,454,454,450,13,14,12,13,2,3,2,2,10,0,4,-1,2,-1
281,276,276,271,14,14,15,13,2,4,2,2,5,0,5,0,-1,2
1021,1021,1021,1017,13,14,15,13,1,1,2,2,0,0,4,-1,-1,2
759,759,759,754,17,16,18,18,2,1,2,1,0,0,5,1,-2,0
496,496,496,501,18,17,18,19,2,1,3,1,0,0,-5,1,-1,-1
970,960,965,965,17,19,18,18,1,2,5,1,10,-5,0,-2,1,0
351,351,351,346,20,19,20,18,1,3,1,1,0,0,5,1,-1,2
323,323,328,323,18,19,18,19,2,1,2,1,0,-5,5,-1,1,-1
646,646,642,646,20,19,20,18,1,3,1,1,0,4,-4,1,-1,2
989,984,979,979,20,19,20,18,1,1,1,2,5,5,0,1,-1,2
384,379,379,374,17,16,15,16,1,1,1,1,5,0,5,1,1,-1
806,801,801,796,21,19,21,21,1,2,1,5,5,0,5,2,-2,0
267,262,257,257,14,14,15,13,3,1,1,3,5,5,0,0,-1,2
862,853,853,895,21,19,20,19,1,2,2,1,9,0,-42,2,-1,1
253,243,239,243,18,19,18,18,1,2,3,1,10,4,-4,-1,1,0
914,904,904,904,21,19,20,19,3,1,1,1,10,0,0,2,-1,1
989,989,984,984,13,14,15,13,3,3,2,1,0,5,0,-1,-1,2
187,182,187,1073,18,17,18,18,1,1,3,2,5,-5,-886,1,-1,0
215,210,210,210,18,17,18,19,1,2,1,1,5,0,0,1,-1,-1
1036,1026,1026,1021,13,16,15,16,1,2,2,1,10,0,5,-3,1,-1
379,374,374,370,20,19,20,18,1,1,2,1,5,0,4,1,-1,2
750,726,721,721,17,16,18,16,3,1,1,1,24,5,0,1,-2,2
553,548,539,539,14,17,15,16,1,2,1,2,5,9,0,-3,2,-1
281,271,271,271,14,14,13,13,1,2,1,1,10,0,0,0,1,0
295,290,290,286,14,14,15,13,2,2,1,2,5,0,4,0,-1,2
304,295,290,281,14,14,15,13,1,5,2,2,9,5,9,0,-1,2
839,220,843,839,14,17,15,16,1,1,2,1,619,-623,4,-3,2,-1
651,646,646,646,20,19,20,21,3,1,1,2,5,0,0,1,-1,-1
553,553,543,567,14,17,15,16,2,3,1,1,0,10,-24,-3,2,-1
642,642,642,642,20,19,20,21,3,2,2,1,0,0,0,1,-1,-1
740,731,731,731,17,16,15,16,2,2,2,3,9,0,0,1,1,-1
904,904,904,904,14,17,15,16,3,3,1,3,0,0,0,-3,2,-1
829,829,824,824,14,14,15,16,1,1,2,1,0,5,0,0,-1,-1
496,482,487,492,14,14,13,13,2,1,2,1,14,-5,-5,0,1,0
529,524,524,524,14,14,15,16,1,2,1,1,5,0,0,0,-1,-1
328,318,318,318,14,14,15,13,1,2,3,2,10,0,0,0,-1,2
295,295,295,290,14,14,13,13,3,3,2,1,0,0,5,0,1,0
768,764,764,764,13,14,15,13,2,2,2,1,4,0,0,-1,-1,2
243,239,239,239,21,19,20,18,3,2,3,1,4,0,0,2,-1,2
342,342,337,337,13,14,12,13,3,3,2,1,0,5,0,-1,2,-1
946,942,942,937,20,19,20,21,2,3,1,1,4,0,5,1,-1,-1
764,764,759,759,20,19,20,21,1,1,3,1,0,5,0,1,-1,-1
857,853,857,853,18,17,18,18,2,2,2,1,4,-4,4,1,-1,0
674,670,665,665,20,19,20,21,1,1,1,2,4,5,0,1,-1,-1
210,206,201,206,18,17,18,19,2,1,1,1,4,5,-5,1,-1,-1
539,534,534,534,14,14,13,13,2,2,3,1,5,0,0,0,1,0
342,337,346,342,13,14,15,13,3,3,4,3,5,-9,4,-1,-1,2
778,773,773,768,13,14,12,13,1,3,2,3,5,0,5,-1,2,-1
346,342,346,337,17,16,18,18,1,1,3,2,4,-4,9,1,-2,0
220,210,210,206,18,17,18,19,1,3,2,1,10,0,4,1,-1,-1
726,726,721,726,13,14,12,13,1,1,1,1,0,5,-5,-1,2,-1
393,393,393,389,17,16,18,18,1,3,2,1,0,0,4,1,-2,0
768,759,759,759,20,19,18,18,3,2,1,1,9,0,0,1,1,0
637,628,628,623,17,19,18,19,2,1,1,2,9,0,5,-2,1,-1
1007,1003,1007,1003,20,19,20,18,1,2,1,1,4,-4,4,1,-1,2
501,482,473,473,18,17,18,16,1,1,1,2,19,9,0,1,-1,2
815,806,815,810,18,17,15,16,2,1,3,3,9,-9,5,1,2,-1
623,614,609,604,18,17,18,19,3,2,2,1,9,5,5,1,-1,-1
881,876,876,876,21,19,20,21,2,2,1,1,5,0,0,2,-1,-1
454,450,450,445,17,19,18,18,1,3,2,2,4,0,5,-2,1,0
393,389,384,384,17,16,15,16,3,1,2,1,4,5,0,1,1,-1
581,576,576,576,18,19,18,18,2,2,2,1,5,0,0,-1,1,0
182,1078,1078,1073,21,19,20,18,1,1,1,2,-896,0,5,2,-1,2
407,407,407,403,13,14,12,13,3,3,4,1,0,0,4,-1,2,-1
871,871,867,867,14,14,15,16,1,1,1,1,0,4,0,0,-1,-1
440,436,440,431,17,16,15,16,1,1,2,1,4,-4,9,1,1,-1
660,656,656,656,17,16,18,16,2,1,2,2,4,0,0,1,-2,2
660,656,660,656,17,16,18,16,1,2,2,1,4,-4,4,1,-2,2
937,937,928,923,13,14,15,13,2,2,2,3,0,9,5,-1,-1,2
482,473,478,473,18,16,18,18,2,2,2,2,9,-5,5,2,-2,0
923,914,909,909,14,14,15,13,2,3,1,1,9,5,0,0,-1,2
1064,1064,1059,1059,20,19,20,21,3,3,1,1,0,5,0,1,-1,-1
346,342,342,342,17,16,18,16,2,2,3,1,4,0,0,1,-2,2
431,426,426,421,17,16,15,16,2,1,2,2,5,0,5,1,1,-1
618,614,614,614,18,19,18,19,3,3,2,1,4,0,0,-1,1,-1
351,351,346,346,20,19,18,18,1,1,1,1,0,5,0,1,1,0
750,745,750,745,13,16,15,16,2,2,1,2,5,-5,5,-3,1,-1
304,300,300,300,18,19,18,19,1,1,1,3,4,0,0,-1,1,-1
412,412,407,407,13,16,15,16,1,1,1,1,0,5,0,-3,1,-1
951,946,946,951,20,19,18,18,3,1,1,2,5,0,-5,1,1,0
946,937,946,946,20,19,20,21,1,2,1,2,9,-9,0,1,-1,-1
253,239,243,243,14,17,15,16,3,1,2,3,14,-4,0,-3,2,-1
886,881,886,881,21,19,20,19,1,4,3,2,5,-5,5,2,-1,1
979,979,974,974,20,19,18,18,5,1,1,1,0,5,0,1,1,0
295,286,295,286,14,14,13,13,2,2,2,2,9,-9,9,0,1,0
389,389,389,384,17,19,18,18,3,1,2,2,0,0,5,-2,1,0
1073,1073,1068,1068,17,16,18,16,2,1,2,1,0,5,0,1,-2,2
332,323,323,323,17,17,18,16,1,2,3,1,9,0,0,0,-1,2
993,984,989,984,17,16,15,16,4,2,2,1,9,-5,5,1,1,-1
923,904,904,904,14,14,15,13,2,4,3,1,19,0,0,0,-1,2
323,314,309,309,21,19,21,19,1,3,1,2,9,5,0,2,-2,2
379,379,379,379,20,19,20,18,1,2,1,1,0,0,0,1,-1,2
567,553,553,553,14,14,13,13,1,2,2,2,14,0,0,0,1,0
726,721,721,717,17,16,18,18,1,1,1,1,5,0,4,1,-2,0
895,890,890,890,21,19,20,21,2,1,1,1,5,0,0,2,-1,-1
464,454,454,454,17,16,15,16,1,2,2,1,10,0,0,1,1,-1
403,403,393,393,17,16,18,16,3,3,1,2,0,10,0,1,-2,2
300,295,290,290,18,17,18,19,1,1,2,1,5,5,0,1,-1,-1
267,262,262,257,21,19,20,18,3,2,2,2,5,0,5,2,-1,2
1073,1059,1054,1050,17,16,18,16,1,4,1,2,14,5,4,1,-2,2
543,543,534,539,14,14,13,13,1,3,4,1,0,9,-5,0,1,0
679,674,679,674,13,16,15,16,1,2,2,2,5,-5,5,-3,1,-1
384,379,384,384,13,14,12,13,3,3,2,1,5,-5,0,-1,2,-1
417,407,407,407,17,16,18,18,1,2,3,1,10,0,0,1,-2,0
1026,1026,1031,1021,20,19,18,18,3,2,2,1,0,-5,10,1,1,0
886,876,881,881,18,17,18,19,2,2,3,1,10,-5,0,1,-1,-1
529,524,529,520,14,14,15,13,1,3,1,2,5,-5,9,0,-1,2
482,473,473,468,21,19,20,21,1,2,1,2,9,0,5,2,-1,-1
459,459,459,459,13,14,12,13,3,1,1,2,0,0,0,-1,2,-1
1050,1040,1040,1040,20,19,20,18,1,2,1,2,10,0,0,1,-1,2
660,656,679,684,13,14,12,13,1,3,2,1,4,-23,-5,-1,2,-1
543,534,539,539,14,14,13,13,3,3,1,1,9,-5,0,0,1,0
567,562,557,571,14,17,15,16,1,1,1,1,5,5,-14,-3,2,-1
262,262,267,262,18,19,18,18,2,1,1,1,0,-5,5,-1,1,0
257,239,239,239,14,17,15,16,1,2,3,2,18,0,0,-3,2,-1
881,871,881,881,21,19,20,19,2,2,2,3,10,-10,0,2,-1,1
1054,1050,1045,1045,20,19,18,18,2,2,1,1,4,5,0,1,1,0
201,196,196,196,18,19,21,19,1,1,1,1,5,0,0,-1,-2,2
337,332,337,332,17,16,18,18,2,1,1,1,5,-5,5,1,-2,0
206,201,196,196,14,14,15,13,1,3,2,3,5,5,0,0,-1,2
693,689,689,689,13,14,15,13,1,2,3,2,4,0,0,-1,-1,2
520,501,496,510,14,14,15,13,4,3,1,1,19,5,-14,0,-1,2
848,829,824,824,14,14,13,13,1,2,2,2,19,5,0,0,1,0
918,895,895,900,14,14,15,16,1,3,3,1,23,0,-5,0,-1,-1
792,787,787,792,18,19,18,19,1,1,1,3,5,0,-5,-1,1,-1
398,393,393,389,17,16,18,16,1,4,1,4,5,0,4,1,-2,2
656,651,646,646,17,19,18,18,1,1,1,1,5,5,0,-2,1,0
787,782,778,778,18,17,18,18,2,1,1,1,5,4,0,1,-1,0
1021,1012,1012,1007,13,14,15,13,2,3,2,3,9,0,5,-1,-1,2
206,201,201,201,14,14,15,16,2,2,3,2,5,0,0,0,-1,-1
1021,1017,1012,1012,17,16,18,16,1,1,1,1,4,5,0,1,-2,2
234,229,229,224,14,14,13,13,1,2,2,2,5,0,5,0,1,0
286,286,286,290,18,19,18,19,1,1,1,1,0,0,-4,-1,1,-1
1064,1054,1050,267,13,14,15,16,3,2,1,1,10,4,783,-1,-1,-1
1012,1007,1012,1007,13,14,12,13,3,3,4,3,5,-5,5,-1,2,-1
1031,1031,1026,1021,17,16,18,18,3,3,2,2,0,5,5,1,-2,0
473,473,473,468,13,14,12,13,1,2,3,2,0,0,5,-1,2,-1
862,862,867,862,14,14,13,13,1,2,2,2,0,-5,5,0,1,0
989,984,979,989,17,16,18,16,3,2,1,2,5,5,-10,1,-2,2
900,890,886,886,18,17,18,19,2,2,1,1,10,4,0,1,-1,-1
581,581,581,581,21,19,20,21,2,2,2,1,0,0,0,2,-1,-1
782,773,768,764,14,16,15,16,1,2,1,1,9,5,4,-2,1,-1
768,764,764,764,20,19,20,21,3,2,1,2,4,0,0,1,-1,-1
253,253,248,248,18,19,18,18,2,1,1,2,0,5,0,-1,1,0
862,853,857,853,18,19,18,18,1,1,2,1,9,-4,4,-1,1,0
581,576,576,571,18,17,18,16,1,1,2,2,5,0,5,1,-1,2
417,407,412,417,13,14,15,13,3,1,1,3,10,-5,-5,-1,-1,2
374,370,365,365,13,14,12,13,4,1,1,2,4,5,0,-1,2,-1
332,323,323,323,17,17,15,16,1,3,1,2,9,0,0,0,2,-1
356,356,356,351,20,19,20,18,1,1,1,2,0,0,5,1,-1,2
801,801,806,801,14,17,15,16,4,1,1,2,0,-5,5,-3,2,-1
698,684,693,689,13,16,15,16,2,2,2,3,14,-9,4,-3,1,-1
421,417,417,412,17,16,18,18,2,3,2,2,4,0,5,1,-2,0
548,548,548,548,21,19,20,18,2,3,2,1,0,0,0,2,-1,2
703,693,703,693,13,14,15,16,1,2,2,1,10,-10,10,-1,-1,-1
909,900,904,900,14,14,13,13,3,2,2,1,9,-4,4,0,1,0
984,979,979,979,20,19,20,21,2,1,1,3,5,0,0,1,-1,-1
459,440,440,445,13,14,15,13,2,3,2,3,19,0,-5,-1,-1,2
703,698,698,698,13,14,15,13,2,3,1,3,5,0,0,-1,-1,2
801,792,792,792,18,19,18,19,1,1,1,1,9,0,0,-1,1,-1
300,300,300,300,21,19,20,19,3,3,1,3,0,0,0,2,-1,1
745,740,740,740,13,14,12,13,2,4,3,1,5,0,0,-1,2,-1
281,271,267,267,14,14,13,13,2,4,1,3,10,4,0,0,1,0
937,928,923,923,20,19,18,19,2,1,3,2,9,5,0,1,1,-1
848,843,843,843,14,17,15,16,3,1,3,1,5,0,0,-3,2,-1
318,314,314,314,18,17,18,16,1,1,3,1,4,0,0,1,-1,2
782,782,787,787,18,17,18,16,2,1,2,1,0,-5,0,1,-1,2
286,286,290,286,18,19,18,19,2,3,1,1,0,-4,4,-1,1,-1
229,224,224,224,18,19,18,19,1,2,1,1,5,0,0,-1,1,-1
196,192,192,187,18,17,18,19,1,1,2,1,4,0,5,1,-1,-1
623,609,614,600,14,17,15,16,3,2,1,4,14,-5,14,-3,2,-1
637,623,623,623,20,19,18,19,2,2,1,1,14,0,0,1,1,-1
604,600,600,600,14,14,13,13,2,3,1,1,4,0,0,0,1,0
951,942,946,946,13,14,15,16,1,2,2,1,9,-4,0,-1,-1,-1
623,623,618,618,18,17,18,16,2,1,1,1,0,5,0,1,-1,2
351,337,337,332,13,14,15,13,1,2,2,1,14,0,5,-1,-1,2
989,984,984,979,17,19,18,18,2,1,2,1,5,0,5,-2,1,0
496,487,492,482,14,14,13,13,1,3,2,2,9,-5,10,0,1,0
431,431,524,426,13,14,13,13,3,1,1,2,0,-93,98,-1,1,0
670,651,646,646,13,14,12,13,2,3,4,3,19,5,0,-1,2,-1
529,520,515,515,18,17,18,16,2,2,2,1,9,5,0,1,-1,2
721,717,717,712,13,14,12,13,1,1,1,2,4,0,5,-1,2,-1
773,759,759,754,20,19,20,21,2,1,2,1,14,0,5,1,-1,-1
426,412,421,417,17,16,18,16,2,8,2,2,14,-9,4,1,-2,2
670,670,660,660,17,16,18,18,1,5,1,1,0,10,0,1,-2,0
942,932,932,932,17,16,18,18,1,1,1,1,10,0,0,1,-2,0
736,731,726,726,20,19,20,18,1,1,1,2,5,5,0,1,-1,2
876,942,871,871,14,16,15,16,2,1,2,1,-66,71,0,-2,1,-1
234,229,229,229,18,19,18,19,3,2,1,1,5,0,0,-1,1,-1
426,412,421,407,13,14,12,13,2,3,2,2,14,-9,14,-1,2,-1
778,768,773,773,17,16,15,16,1,2,3,1,10,-5,0,1,1,-1
501,492,496,492,18,17,18,16,1,2,2,2,9,-4,4,1,-1,2
796,796,796,796,18,17,18,19,2,1,1,1,0,0,0,1,-1,-1
604,600,595,595,18,19,18,19,1,1,3,1,4,5,0,-1,1,-1
759,754,759,750,13,14,15,16,3,1,2,2,5,-5,9,-1,-1,-1
703,693,698,693,13,14,12,13,2,2,1,1,10,-5,5,-1,2,-1
464,464,459,459,17,19,18,18,2,1,1,1,0,5,0,-2,1,0
618,600,590,586,18,17,15,16,1,2,1,2,18,10,4,1,2,-1
1026,1021,1021,1021,17,16,18,18,2,2,1,1,5,0,0,1,-2,0
487,478,482,487,18,19,18,19,2,1,1,1,9,-4,-5,-1,1,-1
337,323,328,328,20,19,21,19,2,2,2,1,14,-5,0,1,-2,2
581,576,576,576,21,19,20,18,2,2,1,2,5,0,0,2,-1,2
614,609,604,604,18,17,18,19,2,1,1,3,5,5,0,1,-1,-1
210,201,206,206,18,17,18,19,1,1,3,1,9,-5,0,1,-1,-1
1045,1036,1036,1031,17,16,18,16,2,3,2,2,9,0,5,1,-2,2
637,623,623,618,13,17,15,16,2,2,2,3,14,0,5,-4,2,-1
942,937,937,932,13,14,15,16,2,1,2,2,5,0,5,-1,-1,-1
1064,1059,1059,1054,13,14,12,13,1,3,1,2,5,0,5,-1,2,-1
764,754,754,764,13,14,15,16,4,3,3,1,10,0,-10,-1,-1,-1
492,492,492,492,18,19,18,19,2,2,1,3,0,0,0,-1,1,-1
810,796,796,801,14,14,13,13,3,2,1,3,14,0,-5,0,1,0
464,459,468,464,13,16,15,16,2,1,3,1,5,-9,4,-3,1,-1
1007,1003,1003,1003,17,16,15,16,2,3,1,1,4,0,0,1,1,-1
417,403,403,403,13,14,15,13,1,3,1,2,14,0,0,-1,-1,2
1021,1021,1021,1021,13,14,12,13,1,1,2,1,0,0,0,-1,2,-1
932,923,918,914,17,17,15,16,1,1,2,3,9,5,4,0,2,-1
295,300,295,286,18,17,18,19,2,3,1,4,-5,5,9,1,-1,-1
1021,1017,1017,1017,13,14,15,13,2,3,2,1,4,0,0,-1,-1,2
1021,1021,1021,1021,20,19,20,21,3,3,2,1,0,0,0,1,-1,-1
937,932,937,932,13,14,15,16,1,2,2,2,5,-5,5,-1,-1,-1
914,909,909,909,18,17,18,19,3,1,2,1,5,0,0,1,-1,-1
384,374,374,370,13,14,12,13,4,3,3,3,10,0,4,-1,2,-1
614,618,614,614,21,19,21,21,4,3,1,1,-4,4,0,2,-2,0
206,201,196,192,18,17,18,16,1,1,2,2,5,5,4,1,-1,2
543,543,548,543,14,17,15,16,2,3,2,2,0,-5,5,-3,2,-1
914,904,909,904,14,14,13,13,3,2,2,2,10,-5,5,0,1,0
543,543,543,543,18,17,18,18,3,3,3,1,0,0,0,1,-1,0
539,539,539,539,14,14,13,13,2,3,1,3,0,0,0,0,1,0
820,824,815,815,18,17,18,16,1,3,1,3,-4,9,0,1,-1,2
782,773,773,768,14,14,12,13,1,1,2,3,9,0,5,0,2,-1
609,604,609,609,21,19,21,19,2,3,1,1,5,-5,0,2,-2,2
482,473,473,473,18,16,18,16,1,1,3,1,9,0,0,2,-2,2
886,886,886,886,21,19,20,19,1,1,2,1,0,0,0,2,-1,1
956,960,960,956,13,16,15,16,1,2,2,1,-4,0,4,-3,1,-1
286,276,271,271,14,17,15,16,3,3,1,3,10,5,0,-3,2,-1
567,557,557,557,14,17,15,16,1,2,1,2,10,0,0,-3,2,-1
871,867,867,867,21,19,20,18,1,3,1,1,4,0,0,2,-1,2
224,215,215,215,18,17,18,19,3,3,1,1,9,0,0,1,-1,-1
586,571,567,571,21,19,20,21,2,3,1,2,15,4,-4,2,-1,-1
881,886,871,871,14,17,15,16,2,1,3,1,-5,15,0,-3,2,-1
909,904,904,904,14,17,15,16,3,2,3,1,5,0,0,-3,2,-1
754,745,750,750,20,19,18,18,2,2,1,1,9,-5,0,1,1,0
323,318,318,318,18,17,18,16,2,1,3,2,5,0,0,1,-1,2
239,239,234,239,18,19,18,18,2,1,1,1,0,5,-5,-1,1,0
450,412,417,412,17,16,15,16,1,1,1,1,38,-5,5,1,1,-1
450,445,436,436,13,14,15,13,1,3,1,1,5,9,0,-1,-1,2
384,374,374,370,20,19,20,18,2,2,1,2,10,0,4,1,-1,2
229,215,215,215,14,17,15,16,1,1,1,2,14,0,0,-3,2,-1
946,942,942,946,20,19,20,18,2,1,1,1,4,0,-4,1,-1,2
262,257,262,262,21,19,20,18,1,1,2,1,5,-5,0,2,-1,2
192,182,187,182,14,14,13,13,1,1,2,1,10,-5,5,0,1,0
937,923,904,904,13,14,15,13,1,2,5,1,14,19,0,-1,-1,2
436,436,440,440,20,19,20,21,1,1,2,3,0,-4,0,1,-1,-1
895,890,890,890,18,19,18,19,2,2,1,1,5,0,0,-1,1,-1
609,609,604,609,18,19,18,19,3,3,1,1,0,5,-5,-1,1,-1
965,956,965,960,13,14,15,13,3,2,2,2,9,-9,5,-1,-1,2
398,384,384,384,13,14,15,13,1,2,3,1,14,0,0,-1,-1,2
796,792,787,881,14,14,13,13,2,3,3,1,4,5,-94,0,1,0
923,918,914,909,18,17,18,19,1,1,3,1,5,4,5,1,-1,-1
871,862,862,862,14,14,15,13,3,1,1,3,9,0,0,0,-1,2
914,909,904,904,18,19,18,19,1,2,1,1,5,5,0,-1,1,-1
342,337,323,323,13,14,13,13,1,1,3,2,5,14,0,-1,1,0
1040,1036,1021,1026,17,16,15,16,3,3,1,1,4,15,-5,1,1,-1
843,834,834,843,14,17,15,16,1,2,2,1,9,0,-9,-3,2,-1
534,520,520,520,18,19,18,19,1,4,1,1,14,0,0,-1,1,-1
600,595,590,590,18,19,18,19,1,1,1,1,5,5,0,-1,1,-1
1068,1064,1064,1068,20,19,20,21,3,3,1,1,4,0,-4,1,-1,-1
295,286,286,286,21,19,20,21,1,2,1,3,9,0,0,2,-1,-1
745,740,740,740,17,19,18,18,2,2,3,1,5,0,0,-2,1,0
1045,1036,1040,1040,13,14,12,13,1,2,1,1,9,-4,0,-1,2,-1
792,773,764,754,14,14,12,13,1,3,2,2,19,9,10,0,2,-1
679,670,670,670,13,14,15,13,1,2,2,1,9,0,0,-1,-1,2
267,257,262,253,14,14,15,13,3,3,2,2,10,-5,9,0,-1,2
468,459,464,454,13,14,15,13,4,2,2,2,9,-5,10,-1,-1,2
768,764,759,764,20,19,20,21,1,3,1,1,4,5,-5,1,-1,-1
473,464,473,464,13,16,15,16,3,2,2,1,9,-9,9,-3,1,-1
834,820,820,810,14,14,15,13,1,1,2,2,14,0,10,0,-1,2
421,421,412,417,13,14,15,16,3,1,1,2,0,9,-5,-1,-1,-1
731,717,712,712,13,14,15,13,2,4,1,2,14,5,0,-1,-1,2
543,539,539,539,18,19,18,18,2,1,2,1,4,0,0,-1,1,0
1007,998,1003,998,13,14,12,13,3,2,1,2,9,-5,5,-1,2,-1
764,759,759,754,20,19,20,21,1,1,1,3,5,0,5,1,-1,-1
1012,1007,1007,1007,20,19,18,18,1,2,3,2,5,0,0,1,1,0
478,473,473,473,13,14,12,13,1,2,2,3,5,0,0,-1,2,-1
614,618,614,614,21,19,21,21,1,3,1,1,-4,4,0,2,-2,0
754,745,750,745,13,14,15,16,2,2,1,1,9,-5,5,-1,-1,-1
670,665,665,665,13,14,15,13,2,5,2,3,5,0,0,-1,-1,2
557,557,557,553,18,19,18,18,3,2,1,2,0,0,4,-1,1,0
286,267,271,271,14,14,13,13,1,2,1,1,19,-4,0,0,1,0
881,871,871,871,14,14,15,13,1,2,3,2,10,0,0,0,-1,2
220,215,210,210,14,17,15,16,1,6,2,1,5,5,0,-3,2,-1
539,543,543,543,21,19,20,21,2,1,1,3,-4,0,0,2,-1,-1
332,337,342,332,13,14,12,13,1,2,2,2,-5,-5,10,-1,2,-1
665,656,651,656,13,14,15,13,2,3,2,2,9,5,-5,-1,-1,2
253,248,248,248,14,14,15,13,2,2,2,3,5,0,0,0,-1,2
932,923,928,928,20,19,21,21,1,2,1,1,9,-5,0,1,-2,0
965,960,960,960,20,19,18,18,1,2,1,1,5,0,0,1,1,0
974,970,965,970,13,14,15,13,2,3,2,1,4,5,-5,-1,-1,2
182,1068,1064,1059,18,16,18,18,1,2,1,1,-886,4,5,2,-2,0
295,290,290,286,18,17,18,19,3,1,2,2,5,0,4,1,-1,-1
365,365,365,365,20,19,18,18,1,4,2,1,0,0,0,1,1,0
586,590,609,586,14,14,15,16,2,3,2,1,-4,-19,23,0,-1,-1
267,267,267,267,14,14,15,13,2,2,4,2,0,0,0,0,-1,2
642,642,637,637,13,14,15,16,3,3,1,1,0,5,0,-1,-1,-1
300,295,295,290,18,17,18,16,3,1,2,2,5,0,5,1,-1,2
379,374,374,374,13,16,15,16,1,2,1,1,5,0,0,-3,1,-1
674,665,660,660,20,19,20,18,3,1,1,1,9,5,0,1,-1,2
848,834,848,839,18,17,15,16,3,1,1,1,14,-14,9,1,2,-1
239,239,239,234,14,14,15,13,3,3,3,3,0,0,5,0,-1,2
923,918,918,914,14,14,15,16,3,3,2,2,5,0,4,0,-1,-1
829,824,820,820,14,14,15,13,2,1,1,1,5,4,0,0,-1,2
239,234,234,234,18,19,18,18,2,2,1,2,5,0,0,-1,1,0
567,567,567,562,14,17,15,16,1,3,2,1,0,0,5,-3,2,-1
496,492,496,492,21,19,21,21,1,1,1,1,4,-4,4,2,-2,0
642,637,628,623,13,14,13,13,2,4,1,2,5,9,5,-1,1,0
946,942,937,942,13,14,15,13,2,1,1,1,4,5,-5,-1,-1,2
787,773,768,768,18,16,18,16,2,2,3,1,14,5,0,2,-2,2
267,257,262,253,18,17,18,18,3,4,2,2,10,-5,9,1,-1,0
1073,1064,1054,1054,17,16,15,16,1,3,1,1,9,10,0,1,1,-1
196,192,187,187,21,19,21,19,1,3,3,2,4,5,0,2,-2,2
834,829,824,824,14,17,15,16,1,2,4,3,5,5,0,-3,2,-1
637,637,637,632,17,16,15,16,1,2,1,1,0,0,5,1,1,-1
295,290,290,290,14,14,15,13,3,2,1,2,5,0,0,0,-1,2
792,787,782,782,18,19,18,19,3,3,1,2,5,5,0,-1,1,-1
356,346,346,351,13,14,15,13,1,1,1,4,10,0,-5,-1,-1,2
989,984,979,979,13,14,15,16,3,2,2,2,5,5,0,-1,-1,-1
1007,1003,998,998,17,16,15,16,3,1,1,1,4,5,0,1,1,-1
806,801,796,796,21,19,21,21,3,4,3,2,5,5,0,2,-2,0
445,440,440,440,20,19,20,21,1,1,1,3,5,0,0,1,-1,-1
309,309,309,309,18,17,18,19,2,2,1,1,0,0,0,1,-1,-1
736,736,740,736,20,19,20,21,1,1,2,1,0,-4,4,1,-1,-1
595,590,586,586,14,14,15,13,3,1,1,1,5,4,0,0,-1,2
304,295,295,290,14,14,15,13,3,3,3,2,9,0,5,0,-1,2
243,239,234,234,18,19,18,18,1,1,2,1,4,5,0,-1,1,0
698,698,698,693,17,19,18,18,5,1,1,3,0,0,5,-2,1,0
595,581,571,567,14,14,13,13,1,3,3,1,14,10,4,0,1,0
548,543,548,543,18,17,18,18,2,3,4,1,5,-5,5,1,-1,0
318,314,309,304,18,19,18,19,1,3,3,2,4,5,5,-1,1,-1
356,346,346,342,13,14,15,16,3,1,2,1,10,0,4,-1,-1,-1
806,801,806,801,14,14,15,13,3,2,2,1,5,-5,5,0,-1,2
290,281,286,286,14,17,15,16,2,2,3,3,9,-5,0,-3,2,-1
984,970,960,965,13,14,12,13,2,1,3,1,14,10,-5,-1,2,-1
932,932,937,932,13,14,12,13,1,1,2,1,0,-5,5,-1,2,-1
600,590,595,590,18,17,18,19,2,2,2,3,10,-5,5,1,-1,-1
295,290,290,286,14,17,15,16,1,2,1,1,5,0,4,-3,2,-1
323,304,300,295,14,17,15,16,1,2,1,2,19,4,5,-3,2,-1
993,989,984,984,13,14,15,16,1,3,1,3,4,5,0,-1,-1,-1
1050,1054,1054,1054,13,14,12,13,1,1,1,2,-4,0,0,-1,2,-1
351,346,337,342,13,14,15,16,3,1,3,1,5,9,-5,-1,-1,-1
600,590,586,586,14,17,15,16,1,3,3,2,10,4,0,-3,2,-1
1036,1031,1036,1036,13,14,12,13,1,1,2,1,5,-5,0,-1,2,-1
857,848,839,843,14,17,15,16,2,3,2,2,9,9,-4,-3,2,-1
632,628,623,618,20,19,18,19,1,1,1,2,4,5,5,1,1,-1
192,187,182,182,18,17,18,19,1,2,1,1,5,5,0,1,-1,-1
529,524,524,520,14,14,15,16,1,2,1,1,5,0,4,0,-1,-1
1036,1026,1031,1031,17,16,18,16,3,1,1,3,10,-5,0,1,-2,2
492,487,487,487,18,19,18,19,1,1,2,1,5,0,0,-1,1,-1
801,787,792,792,14,14,13,13,1,2,3,1,14,-5,0,0,1,0
665,660,656,656,17,19,18,18,2,1,2,3,5,4,0,-2,1,0
801,801,801,792,14,14,15,13,3,3,2,2,0,0,9,0,-1,2
1068,1059,1064,1059,20,19,20,21,2,1,1,2,9,-5,5,1,-1,-1
192,182,1078,1073,21,19,20,21,1,1,2,1,10,-896,5,2,-1,-1
253,253,253,253,14,17,15,16,1,1,2,1,0,0,0,-3,2,-1
867,867,867,867,18,17,18,18,4,3,1,1,0,0,0,1,-1,0
426,426,421,421,13,14,12,13,1,1,3,1,0,5,0,-1,2,-1
1003,989,989,989,13,14,12,13,2,2,2,1,14,0,0,-1,2,-1
454,450,464,464,17,16,18,16,2,2,2,2,4,-14,0,1,-2,2
557,543,553,548,18,17,18,18,2,1,2,1,14,-10,5,1,-1,0
586,576,576,576,18,17,18,18,2,2,3,2,10,0,0,1,-1,0
229,229,220,220,14,17,15,16,1,3,1,1,0,9,0,-3,2,-1
623,623,623,623,18,19,18,19,1,1,2,3,0,0,0,-1,1,-1
637,642,632,834,13,16,15,16,1,5,1,1,-5,10,-202,-3,1,-1
487,473,478,482,14,16,15,16,2,2,1,1,14,-5,-4,-2,1,-1
239,234,229,229,14,17,15,16,1,1,3,1,5,5,0,-3,2,-1
571,567,571,567,18,17,18,16,1,3,2,3,4,-4,4,1,-1,2
782,778,778,782,21,19,20,21,2,1,1,1,4,0,-4,2,-1,-1
764,759,759,759,20,19,20,18,1,1,1,1,5,0,0,1,-1,2
820,810,820,815,18,17,18,19,1,2,4,3,10,-10,5,1,-1,-1
609,595,595,590,14,14,13,13,2,1,3,2,14,0,5,0,1,0
398,389,393,393,17,19,18,18,2,2,2,1,9,-4,0,-2,1,0
1036,1031,1040,1026,17,19,18,18,1,2,2,2,5,-9,14,-2,1,0
937,932,923,928,17,16,15,16,1,2,1,1,5,9,-5,1,1,-1
773,764,764,764,17,16,18,16,2,1,2,1,9,0,0,1,-2,2
365,360,356,365,13,14,15,13,1,2,1,1,5,4,-9,-1,-1,2
937,937,937,932,13,14,15,13,1,1,3,2,0,0,5,-1,-1,2
196,192,192,192,18,17,18,19,2,3,2,1,4,0,0,1,-1,-1
267,262,262,262,14,17,15,16,3,1,2,1,5,0,0,-3,2,-1
482,482,482,482,21,19,21,19,2,1,1,1,0,0,0,2,-2,2
1050,1045,1045,1040,13,14,12,13,2,3,2,2,5,0,5,-1,2,-1
600,600,600,595,18,19,18,19,3,1,3,1,0,0,5,-1,1,-1
689,684,684,679,13,14,12,13,1,2,3,2,5,0,5,-1,2,-1
286,286,281,281,21,19,20,19,2,1,3,2,0,5,0,2,-1,1
314,314,314,314,18,19,18,19,2,1,2,4,0,0,0,-1,1,-1
923,904,904,900,14,14,15,13,3,2,2,2,19,0,4,0,-1,2
942,937,937,937,17,16,15,16,1,1,2,4,5,0,0,1,1,-1
374,374,374,374,13,14,15,13,1,2,1,1,0,0,0,-1,-1,2
853,843,857,853,14,14,13,13,2,2,2,1,10,-14,4,0,1,0
248,239,239,239,14,14,15,13,1,2,1,1,9,0,0,0,-1,2
407,403,403,398,20,19,20,21,1,2,1,2,4,0,5,1,-1,-1
993,989,989,989,17,19,18,18,2,2,1,2,4,0,0,-2,1,0
750,745,740,740,13,14,15,16,1,1,1,3,5,5,0,-1,-1,-1
374,370,370,370,20,19,20,18,2,2,1,1,4,0,0,1,-1,2
356,356,351,351,17,16,18,18,3,2,1,2,0,5,0,1,-2,0
946,937,937,932,13,16,15,16,4,2,2,2,9,0,5,-3,1,-1
360,346,346,346,13,14,12,13,2,1,1,2,14,0,0,-1,2,-1
848,848,848,848,21,19,20,21,2,2,2,3,0,0,0,2,-1,-1
567,562,562,557,18,19,18,18,1,1,2,2,5,0,5,-1,1,0
220,215,215,215,18,19,18,19,1,1,1,1,5,0,0,-1,1,-1
1054,1054,1054,1050,20,19,20,18,3,1,1,4,0,0,4,1,-1,2
534,529,529,529,18,17,18,19,4,2,2,1,5,0,0,1,-1,-1
365,356,360,360,17,16,18,18,2,2,1,1,9,-4,0,1,-2,0
946,942,937,932,13,14,12,13,2,4,3,2,4,5,5,-1,2,-1
417,412,412,412,20,19,18,18,2,2,1,1,5,0,0,1,1,0
398,393,393,393,17,16,18,16,1,1,1,1,5,0,0,1,-2,2
646,642,637,637,13,14,15,13,3,1,1,3,4,5,0,-1,-1,2
1068,1064,1059,1059,13,14,15,13,1,1,3,1,4,5,0,-1,-1,2
792,792,792,787,18,17,18,16,1,1,2,1,0,0,5,1,-1,2
600,637,604,595,14,14,13,13,2,1,1,3,-37,33,9,0,1,0
436,426,426,426,17,16,18,16,1,1,1,1,10,0,0,1,-2,2
642,637,637,1040,13,14,15,13,2,2,1,1,5,0,-403,-1,-1,2
487,482,478,478,14,14,15,16,3,2,2,1,5,4,0,0,-1,-1
886,1040,876,876,21,19,20,21,1,1,1,1,-154,164,0,2,-1,-1
412,407,403,407,13,14,12,13,2,3,1,3,5,4,-4,-1,2,-1
539,529,529,529,14,14,13,13,2,2,2,1,10,0,0,0,1,0
548,543,543,543,21,19,20,21,3,1,1,1,5,0,0,2,-1,-1
674,670,665,665,17,16,18,18,1,2,3,1,4,5,0,1,-2,0
262,253,248,248,18,17,18,18,3,1,1,1,9,5,0,1,-1,0
1073,1064,1064,1059,17,16,18,18,2,3,1,2,9,0,5,1,-2,0
253,243,243,243,18,17,18,18,1,2,1,5,10,0,0,1,-1,0
520,515,515,515,21,19,20,21,2,2,1,1,5,0,0,2,-1,-1
323,318,314,314,14,17,15,16,2,5,2,1,5,4,0,-3,2,-1
946,937,932,923,20,19,18,19,2,1,1,2,9,5,9,1,1,-1
281,281,271,271,18,17,18,16,1,1,1,3,0,10,0,1,-1,2
703,698,698,698,13,14,15,13,1,1,1,3,5,0,0,-1,-1,2
698,693,689,689,20,19,20,18,2,3,1,2,5,4,0,1,-1,2
379,374,370,365,13,16,15,16,2,1,2,1,5,4,5,-3,1,-1
1068,1064,1064,1064,13,14,15,16,3,3,1,1,4,0,0,-1,-1,-1
782,768,778,778,21,19,20,21,2,2,1,1,14,-10,0,2,-1,-1
1068,984,979,970,13,14,12,13,1,2,1,2,84,5,9,-1,2,-1
614,614,614,614,14,14,15,13,3,3,2,1,0,0,0,0,-1,2
942,932,923,928,17,19,18,19,3,1,1,1,10,9,-5,-2,1,-1
1064,1054,1050,1054,13,14,15,16,3,2,1,1,10,4,-4,-1,-1,-1
206,201,201,196,18,17,18,16,1,1,1,2,5,0,5,1,-1,2
1021,1021,1017,1021,17,16,15,16,3,2,1,3,0,4,-4,1,1,-1
300,295,295,295,18,19,20,19,1,1,2,1,5,0,0,-1,-1,1
604,595,595,590,18,19,18,19,3,2,2,1,9,0,5,-1,1,-1
614,609,604,604,18,17,18,16,1,1,2,5,5,5,0,1,-1,2
506,492,496,496,21,19,21,21,2,2,1,1,14,-4,0,2,-2,0
1045,1045,1040,1040,20,19,20,18,1,1,1,2,0,5,0,1,-1,2
496,492,492,492,14,14,15,16,2,2,1,1,4,0,0,0,-1,-1
618,618,623,618,14,14,15,13,2,2,2,3,0,-5,5,0,-1,2
956,956,960,956,20,19,20,18,2,2,2,1,0,-4,4,1,-1,2
440,436,436,431,13,14,15,13,1,3,2,1,4,0,5,-1,-1,2
468,464,464,459,13,14,12,13,2,3,2,1,4,0,5,-1,2,-1
356,351,356,356,13,14,15,13,2,2,2,2,5,-5,0,-1,-1,2
1007,993,989,989,13,14,15,13,2,2,1,3,14,4,0,-1,-1,2
417,417,417,412,17,16,18,18,3,1,2,1,0,0,5,1,-2,0
182,1064,182,196,14,14,13,13,1,2,1,1,-882,882,-14,0,1,0
759,754,759,754,20,19,20,18,1,1,2,1,5,-5,5,1,-1,2
187,1073,1068,1068,14,14,12,13,1,3,1,1,-886,5,0,0,2,-1
337,332,337,337,17,19,18,18,1,2,1,1,5,-5,0,-2,1,0
206,206,201,201,18,17,18,19,2,1,1,2,0,5,0,1,-1,-1
248,248,248,248,14,14,15,13,2,3,1,2,0,0,0,0,-1,2
778,773,773,773,17,16,18,18,1,2,1,1,5,0,0,1,-2,0
1078,1073,1073,1068,17,16,15,16,2,2,2,2,5,0,5,1,1,-1
731,721,726,726,20,19,20,18,2,2,1,1,10,-5,0,1,-1,2
773,768,768,768,13,14,15,13,1,2,1,2,5,0,0,-1,-1,2
862,857,857,857,21,19,20,18,1,1,1,1,5,0,0,2,-1,2
1059,1054,1059,1054,13,14,15,16,1,4,1,2,5,-5,5,-1,-1,-1
928,918,923,923,14,17,15,16,1,2,1,3,10,-5,0,-3,2,-1
637,632,632,623,13,14,13,13,1,2,1,2,5,0,9,-1,1,0
614,614,609,609,14,14,15,13,4,3,1,2,0,5,0,0,-1,2
281,271,267,267,14,14,15,13,3,3,1,2,10,4,0,0,-1,2
707,703,703,693,13,14,12,13,1,1,2,3,4,0,10,-1,2,-1
876,876,871,871,18,17,18,16,1,1,1,2,0,5,0,1,-1,2
871,867,862,857,21,19,20,18,1,1,1,2,4,5,5,2,-1,2
604,600,595,590,21,19,20,21,3,1,2,2,4,5,5,2,-1,-1
492,482,478,478,14,14,13,13,1,2,2,1,10,4,0,0,1,0
609,604,604,600,18,17,18,16,1,1,1,1,5,0,4,1,-1,2
768,754,759,759,13,14,12,13,2,2,2,1,14,-5,0,-1,2,-1
417,412,412,412,13,14,15,13,1,1,1,1,5,0,0,-1,-1,2
1073,1068,1059,1064,13,14,15,13,1,2,3,1,5,9,-5,-1,-1,2
548,539,539,539,18,17,18,18,1,4,1,1,9,0,0,1,-1,0
412,403,393,389,20,19,18,18,1,1,1,1,9,10,4,1,1,0
323,318,314,314,14,17,15,16,2,3,1,1,5,4,0,-3,2,-1
398,393,393,393,17,16,18,18,1,1,3,1,5,0,0,1,-2,0
956,956,951,946,13,14,15,13,2,3,1,2,0,5,5,-1,-1,2
543,534,539,539,18,19,18,18,3,3,3,1,9,-5,0,-1,1,0
792,787,787,792,14,14,13,13,1,1,2,1,5,0,-5,0,1,0
501,496,496,496,14,14,13,13,2,2,1,3,5,0,0,0,1,0
384,384,379,379,13,14,12,13,3,3,1,2,0,5,0,-1,2,-1
792,773,759,759,14,14,12,13,3,1,1,2,19,14,0,0,2,-1
201,187,187,182,18,17,18,19,1,3,2,1,14,0,5,1,-1,-1
384,379,384,379,20,19,20,21,1,2,1,1,5,-5,5,1,-1,-1
623,618,618,618,21,19,21,19,2,2,1,1,5,0,0,2,-2,2
440,431,431,431,13,14,12,13,4,2,2,3,9,0,0,-1,2,-1
660,656,656,656,20,19,20,18,3,1,1,1,4,0,0,1,-1,2
515,515,515,510,14,14,13,13,2,1,2,2,0,0,5,0,1,0
459,459,459,454,13,14,15,13,1,1,3,1,0,0,5,-1,-1,2
956,946,951,946,17,16,18,18,2,4,1,3,10,-5,5,1,-2,0
998,998,989,989,17,16,15,16,1,3,3,3,0,9,0,1,1,-1
253,248,253,248,14,14,15,13,2,3,2,2,5,-5,5,0,-1,2
468,459,464,459,20,19,20,21,1,2,1,1,9,-5,5,1,-1,-1
234,224,229,229,14,14,15,13,2,2,2,1,10,-5,0,0,-1,2
286,267,271,286,14,14,13,13,3,2,1,1,19,-4,-15,0,1,0
257,243,229,224,14,17,15,16,1,3,2,1,14,14,5,-3,2,-1
257,248,253,248,14,14,13,13,1,2,1,3,9,-5,5,0,1,0
974,970,970,970,13,14,12,13,3,2,1,1,4,0,0,-1,2,-1
276,267,267,267,14,14,13,13,2,3,2,3,9,0,0,0,1,0
998,984,989,989,13,14,15,13,2,2,1,2,14,-5,0,-1,-1,2
464,459,450,450,20,19,18,18,1,3,1,1,5,9,0,1,1,0
815,810,806,801,14,17,15,16,3,1,1,2,5,4,5,-3,2,-1
1050,1040,1045,1045,17,16,18,16,2,2,1,1,10,-5,0,1,-2,2
543,529,520,515,14,14,13,13,2,2,1,2,14,9,5,0,1,0
764,759,764,759,13,14,12,13,1,4,2,2,5,-5,5,-1,2,-1
281,271,271,271,14,14,15,13,3,2,1,2,10,0,0,0,-1,2
539,539,539,539,21,19,20,21,2,1,1,1,0,0,0,2,-1,-1
267,262,267,262,18,19,18,18,2,1,2,1,5,-5,5,-1,1,0
951,942,946,946,17,16,18,18,2,3,2,1,9,-4,0,1,-2,0
300,295,290,290,21,19,20,19,2,3,3,1,5,5,0,2,-1,1
660,646,646,642,13,16,15,16,2,2,2,1,14,0,4,-3,1,-1
754,754,750,745,20,19,18,18,1,1,1,1,0,4,5,1,1,0
1036,1036,1031,1031,17,16,15,16,1,1,2,3,0,5,0,1,1,-1
623,628,623,623,18,17,18,16,1,1,2,1,-5,5,0,1,-1,2
220,210,201,206,14,17,15,16,2,1,2,1,10,9,-5,-3,2,-1
450,445,445,445,17,16,18,16,2,1,2,1,5,0,0,1,-2,2
1017,1007,1003,1003,13,14,15,13,2,2,1,2,10,4,0,-1,-1,2
618,614,623,618,18,19,18,19,3,2,2,1,4,-9,5,-1,1,-1
281,281,281,276,14,14,13,13,1,3,2,1,0,0,5,0,1,0
586,586,581,576,18,19,18,18,1,3,1,2,0,5,5,-1,1,0
1059,1059,1059,1054,20,19,20,18,1,3,1,2,0,0,5,1,-1,2
586,590,586,581,18,17,18,16,3,3,1,1,-4,4,5,1,-1,2
810,806,806,810,18,19,18,19,2,1,1,1,4,0,-4,-1,1,-1
267,262,262,257,14,17,15,16,2,2,2,1,5,0,5,-3,2,-1
707,703,707,703,13,14,15,13,1,4,1,3,4,-4,4,-1,-1,2
853,848,843,843,21,19,20,21,2,1,2,1,5,5,0,2,-1,-1
895,890,900,895,14,14,13,13,1,3,1,3,5,-10,5,0,1,0
581,576,576,576,21,19,20,21,3,2,3,1,5,0,0,2,-1,-1
529,520,520,524,18,19,18,19,2,2,3,1,9,0,-4,-1,1,-1
754,750,754,750,20,19,20,21,1,2,1,2,4,-4,4,1,-1,-1
459,459,323,459,13,14,21,13,2,1,1,1,0,136,-136,-1,-7,8
590,567,567,562,14,14,13,13,3,3,2,1,23,0,5,0,1,0
553,360,548,548,14,19,15,16,3,1,2,2,193,-188,0,-5,4,-1
328,323,323,323,14,14,13,13,1,3,2,3,5,0,0,0,1,0
824,820,820,815,18,19,18,19,1,1,2,1,4,0,5,-1,1,-1
314,309,304,309,14,14,15,16,1,2,1,1,5,5,-5,0,-1,-1
1026,1021,1017,1017,17,19,18,18,1,1,3,1,5,4,0,-2,1,0
946,942,942,942,20,19,20,21,1,3,1,1,4,0,0,1,-1,-1
970,970,965,965,20,19,20,21,2,4,2,2,0,5,0,1,-1,-1
450,440,440,436,13,16,15,16,5,3,2,1,10,0,4,-3,1,-1
431,417,412,412,13,14,12,13,1,2,1,1,14,5,0,-1,2,-1
848,848,848,848,18,19,18,18,2,2,3,1,0,0,0,-1,1,0
351,346,346,342,17,16,18,18,3,1,3,1,5,0,4,1,-2,0
304,300,304,300,14,17,15,16,2,2,3,1,4,-4,4,-3,2,-1
524,520,524,524,18,17,18,16,1,2,1,3,4,-4,0,1,-1,2
923,914,914,914,21,19,21,19,3,2,1,1,9,0,0,2,-2,2
965,960,960,956,20,19,20,18,2,1,1,2,5,0,4,1,-1,2
904,895,900,895,21,19,20,19,2,1,1,1,9,-5,5,2,-1,1
974,965,970,970,17,16,18,18,3,1,5,1,9,-5,0,1,-2,0
1021,1017,1012,1017,17,16,18,16,3,3,1,1,4,5,-5,1,-2,2
543,543,539,534,18,17,18,18,2,1,2,2,0,4,5,1,-1,0
210,206,192,192,14,14,13,13,2,2,1,2,4,14,0,0,1,0
660,656,651,646,13,14,12,13,2,1,1,2,4,5,5,-1,2,-1
510,496,501,501,18,17,18,19,3,2,2,1,14,-5,0,1,-1,-1
871,862,862,862,14,14,15,16,2,2,2,3,9,0,0,0,-1,-1
304,304,304,300,18,19,20,19,2,2,1,1,0,0,4,-1,-1,1
1064,1059,1059,1054,20,19,20,21,4,2,1,2,5,0,5,1,-1,-1
417,407,407,407,17,16,18,16,1,2,1,1,10,0,0,1,-2,2
520,506,496,496,14,14,15,13,2,3,2,1,14,10,0,0,-1,2
1007,998,989,989,13,14,15,13,1,3,3,3,9,9,0,-1,-1,2
960,951,956,956,13,14,15,13,2,2,5,1,9,-5,0,-1,-1,2
384,384,384,389,17,19,18,18,3,1,2,3,0,0,-5,-2,1,0
895,886,890,886,21,19,20,19,1,2,2,1,9,-4,4,2,-1,1
595,586,595,590,18,17,18,19,1,2,1,2,9,-9,5,1,-1,-1
304,295,295,290,14,14,15,13,3,2,1,2,9,0,5,0,-1,2
1003,998,989,989,17,16,18,16,1,4,1,2,5,9,0,1,-2,2
937,937,932,932,17,19,18,18,2,1,1,1,0,5,0,-2,1,0
300,295,295,295,21,19,20,21,2,1,1,3,5,0,0,2,-1,-1
895,890,890,895,18,19,18,19,2,1,2,1,5,0,-5,-1,1,-1
623,618,618,618,18,17,18,19,3,2,2,1,5,0,0,1,-1,-1
567,562,553,553,18,17,18,18,2,3,1,1,5,9,0,1,-1,0
229,224,220,220,14,14,15,13,1,3,1,1,5,4,0,0,-1,2
515,510,510,510,14,14,15,13,1,2,1,1,5,0,0,0,-1,2
698,684,679,674,13,14,15,13,2,1,1,3,14,5,5,-1,-1,2
712,717,717,717,13,14,15,13,1,3,1,1,-5,0,0,-1,-1,2
815,810,810,806,14,14,15,16,3,2,2,2,5,0,4,0,-1,-1
656,651,651,656,17,19,18,18,1,1,1,1,5,0,-5,-2,1,0
206,206,201,206,14,17,15,16,2,2,3,1,0,5,-5,-3,2,-1
571,557,562,562,14,17,15,16,3,2,2,1,14,-5,0,-3,2,-1
187,182,1073,1073,14,14,15,16,1,2,2,1,5,-891,0,0,-1,-1
1031,1026,1031,1021,17,16,15,16,1,1,1,1,5,-5,10,1,1,-1
984,979,979,979,20,19,20,21,1,2,1,2,5,0,0,1,-1,-1
623,628,623,623,18,17,18,16,2,1,3,1,-5,5,0,1,-1,2
900,890,890,886,18,17,18,19,1,3,2,1,10,0,4,1,-1,-1
360,356,351,356,13,14,15,13,3,2,1,3,4,5,-5,-1,-1,2
984,984,979,974,13,14,12,13,1,2,3,2,0,5,5,-1,2,-1
707,703,698,698,20,19,18,18,2,2,1,1,4,5,0,1,1,0
862,857,857,853,18,17,18,16,3,4,2,1,5,0,4,1,-1,2
946,942,937,937,20,19,20,21,1,3,1,1,4,5,0,1,-1,-1
300,290,281,290,18,19,18,19,1,1,1,1,10,9,-9,-1,1,-1
300,300,295,295,18,17,18,19,2,1,1,2,0,5,0,1,-1,-1
942,942,946,942,13,14,12,13,3,1,2,1,0,-4,4,-1,2,-1
553,492,496,520,14,14,15,13,1,3,2,1,61,-4,-24,0,-1,2
684,674,674,674,17,16,15,16,1,1,1,1,10,0,0,1,1,-1
407,403,398,398,13,16,15,16,2,1,1,1,4,5,0,-3,1,-1
918,909,909,900,18,19,18,19,2,2,2,2,9,0,9,-1,1,-1
496,492,492,492,14,14,13,13,1,4,1,1,4,0,0,0,1,0
848,843,848,848,21,19,20,18,2,2,2,2,5,-5,0,2,-1,2
787,773,778,782,18,19,18,19,1,2,1,1,14,-5,-4,-1,1,-1
1021,1017,1017,1012,13,14,12,13,3,2,3,2,4,0,5,-1,2,-1
839,829,824,824,14,17,15,16,1,1,1,1,10,5,0,-3,2,-1
796,796,792,792,21,19,21,21,1,3,1,2,0,4,0,2,-2,0
534,529,534,539,14,14,15,16,2,2,3,3,5,-5,-5,0,-1,-1
515,515,515,510,14,17,15,16,1,1,2,2,0,0,5,-3,2,-1
445,436,440,440,17,16,15,16,1,2,1,1,9,-4,0,1,1,-1
182,1078,1078,1078,21,19,20,21,1,1,1,1,-896,0,0,2,-1,-1
187,182,187,182,14,17,15,16,2,2,2,1,5,-5,5,-3,2,-1
506,496,492,492,14,14,13,13,1,2,4,2,10,4,0,0,1,0
609,604,614,618,18,17,18,16,1,2,1,3,5,-10,-4,1,-1,2
684,684,679,679,13,14,12,13,2,3,2,1,0,5,0,-1,2,-1
332,328,323,323,20,19,18,19,1,1,2,1,4,5,0,1,1,-1
918,909,909,909,14,14,15,16,1,2,2,2,9,0,0,0,-1,-1
300,290,271,290,18,17,18,16,3,1,1,1,10,19,-19,1,-1,2
839,843,839,839,18,17,18,18,2,1,1,1,-4,4,0,1,-1,0
721,717,721,712,13,14,12,13,1,2,3,3,4,-4,9,-1,2,-1
450,440,436,431,20,19,18,18,2,2,1,1,10,4,5,1,1,0
960,956,951,951,17,16,18,16,2,3,3,2,4,5,0,1,-2,2
562,557,557,557,18,17,18,18,1,1,3,1,5,0,0,1,-1,0
318,323,323,314,14,14,15,13,2,3,2,2,-5,0,9,0,-1,2
581,581,586,581,21,19,20,21,4,2,1,2,0,-5,5,2,-1,-1
407,407,403,398,17,16,15,16,3,3,2,1,0,4,5,1,1,-1
426,417,421,417,20,19,20,21,2,1,1,1,9,-4,4,1,-1,-1
843,839,839,839,14,14,13,13,1,2,1,3,4,0,0,0,1,0
1073,1064,1064,1059,17,16,18,16,2,3,2,2,9,0,5,1,-2,2
323,318,323,318,21,19,21,21,2,2,3,3,5,-5,5,2,-2,0
295,290,290,281,14,14,15,13,3,3,2,2,5,0,9,0,-1,2
337,328,323,323,13,14,13,13,3,1,1,2,9,5,0,-1,1,0
374,365,360,360,17,16,18,18,2,1,1,1,9,5,0,1,-2,0
586,581,586,581,18,19,18,19,2,2,2,1,5,-5,5,-1,1,-1
721,717,712,712,20,19,18,18,3,2,1,1,4,5,0,1,1,0
276,262,253,248,14,14,13,13,3,2,2,1,14,9,5,0,1,0
1026,1021,1017,1021,13,14,15,13,1,2,1,1,5,4,-4,-1,-1,2
187,1073,1073,1073,14,14,12,13,1,2,1,3,-886,0,0,0,2,-1
201,206,210,210,21,19,20,21,2,1,1,2,-5,-4,0,2,-1,-1
956,946,946,942,13,14,15,13,2,2,1,2,10,0,4,-1,-1,2
1054,979,984,984,20,16,18,18,1,3,2,1,75,-5,0,4,-2,0
726,726,726,721,13,14,15,13,2,3,2,2,0,0,5,-1,-1,2
206,192,196,196,14,14,15,13,2,2,2,2,14,-4,0,0,-1,2
600,632,637,632,18,19,18,18,2,2,2,1,-32,-5,5,-1,1,0
1064,1054,1054,1054,13,16,15,16,2,2,1,1,10,0,0,-3,1,-1
421,421,421,421,20,19,20,21,2,1,2,3,0,0,0,1,-1,-1
487,473,478,473,14,14,13,13,2,2,2,2,14,-5,5,0,1,0
1068,1064,1068,1054,13,14,12,13,1,3,4,1,4,-4,14,-1,2,-1
876,862,853,853,14,17,15,16,1,4,4,1,14,9,0,-3,2,-1
553,548,543,543,18,17,18,16,3,3,1,1,5,5,0,1,-1,2
857,853,853,853,18,17,18,18,3,3,2,1,4,0,0,1,-1,0
1031,1021,1021,1021,17,16,18,18,4,2,3,2,10,0,0,1,-2,0
487,482,482,482,21,19,21,21,2,2,1,1,5,0,0,2,-2,0
1012,356,1012,1007,13,16,12,13,1,1,2,1,656,-656,5,-3,4,-1
234,229,229,229,21,19,20,21,2,2,1,1,5,0,0,2,-1,-1
309,300,300,295,14,17,15,16,3,1,1,1,9,0,5,-3,2,-1
421,421,417,412,17,16,18,18,2,1,2,2,0,4,5,1,-2,0
1040,1036,1036,1036,17,16,18,16,3,2,2,1,4,0,0,1,-2,2
745,736,740,731,20,19,18,18,3,1,3,2,9,-4,9,1,1,0
843,843,843,839,18,19,18,18,1,2,1,2,0,0,4,-1,1,0
248,239,234,243,14,14,15,13,1,1,1,1,9,5,-9,0,-1,2
1078,1073,1064,1059,13,14,12,13,2,2,1,4,5,9,5,-1,2,-1
454,445,445,450,13,14,12,13,1,3,2,3,9,0,-5,-1,2,-1
890,881,881,881,14,17,15,16,1,2,1,1,9,0,0,-3,2,-1
956,946,951,951,13,14,15,13,2,2,3,1,10,-5,0,-1,-1,2
370,365,360,365,13,14,12,13,3,1,1,1,5,5,-5,-1,2,-1
951,946,946,946,20,19,20,21,1,3,1,2,5,0,0,1,-1,-1
1007,993,989,993,13,14,15,13,2,3,1,3,14,4,-4,-1,-1,2
665,665,660,660,20,19,20,18,1,1,1,2,0,5,0,1,-1,2
1045,1045,1040,1045,20,19,20,18,1,1,1,1,0,5,-5,1,-1,2
721,721,717,712,17,16,18,18,3,2,2,1,0,4,5,1,-2,0
482,473,478,482,14,14,15,13,1,2,1,1,9,-5,-4,0,-1,2
1012,1007,1003,1007,20,19,20,21,2,1,1,1,5,4,-4,1,-1,-1
960,951,942,946,17,19,18,18,2,1,1,1,9,9,-4,-2,1,0
567,562,567,562,21,19,20,18,3,2,2,1,5,-5,5,2,-1,2
360,356,356,360,20,19,18,18,3,2,2,1,4,0,-4,1,1,0
370,365,365,360,13,14,12,13,2,1,2,3,5,0,5,-1,2,-1
515,510,520,510,21,19,20,21,1,1,1,2,5,-10,10,2,-1,-1
782,773,778,778,21,19,20,21,1,2,1,1,9,-5,0,2,-1,-1
586,581,581,581,14,17,15,16,1,2,2,1,5,0,0,-3,2,-1
900,895,895,890,14,14,13,13,1,3,1,2,5,0,5,0,1,0
703,782,689,689,13,14,12,13,2,1,1,2,-79,93,0,-1,2,-1
248,243,243,243,21,19,20,21,1,1,3,1,5,0,0,2,-1,-1
609,604,604,604,18,19,18,19,3,2,2,1,5,0,0,-1,1,-1
656,646,646,642,20,19,20,18,1,1,1,2,10,0,4,1,-1,2
1068,1064,1064,1064,13,14,12,13,2,2,1,2,4,0,0,-1,2,-1
482,478,478,473,14,14,15,13,1,1,2,1,4,0,5,0,-1,2
1045,1045,1045,1040,17,16,15,16,3,3,2,1,0,0,5,1,1,-1
182,182,187,182,21,19,21,21,2,1,2,2,0,-5,5,2,-2,0
524,524,515,520,21,19,20,21,2,3,2,1,0,9,-5,2,-1,-1
768,768,768,768,13,14,12,13,1,2,1,2,0,0,0,-1,2,-1
731,726,726,726,13,14,15,13,3,3,2,1,5,0,0,-1,-1,2
539,529,534,534,18,17,18,16,3,2,1,1,10,-5,0,1,-1,2
998,989,989,989,20,19,20,21,4,3,1,2,9,0,0,1,-1,-1
360,360,360,360,17,16,18,18,1,3,4,1,0,0,0,1,-2,0
956,951,951,951,17,19,18,18,2,2,1,1,5,0,0,-2,1,0
750,736,740,736,13,14,12,13,1,2,3,2,14,-4,4,-1,2,-1
220,196,210,224,14,14,13,13,2,2,2,3,24,-14,-14,0,1,0
1050,1040,1040,1036,20,19,20,21,2,2,1,1,10,0,4,1,-1,-1
412,403,403,403,13,14,15,13,2,2,3,1,9,0,0,-1,-1,2
857,853,848,848,21,19,20,21,2,2,1,3,4,5,0,2,-1,-1
1078,1073,1078,1078,20,19,20,18,2,1,2,1,5,-5,0,1,-1,2
553,543,543,543,14,17,15,16,2,4,4,1,10,0,0,-3,2,-1
1064,1054,1050,1050,13,14,15,13,6,2,2,1,10,4,0,-1,-1,2
984,979,979,979,20,19,20,21,1,2,1,1,5,0,0,1,-1,-1
454,445,445,445,13,14,15,13,2,3,2,2,9,0,0,-1,-1,2
370,365,360,356,17,16,18,18,2,1,3,2,5,5,4,1,-2,0
379,379,384,379,17,16,18,16,3,1,2,1,0,-5,5,1,-2,2
412,403,398,403,13,14,12,13,2,3,3,1,9,5,-5,-1,2,-1
632,632,632,632,13,14,13,13,1,2,1,2,0,0,0,-1,1,0
740,721,712,717,13,14,12,13,2,2,3,3,19,9,-5,-1,2,-1
220,215,215,215,21,19,20,21,3,3,1,2,5,0,0,2,-1,-1
1040,1036,1036,1040,20,19,20,21,3,3,3,2,4,0,-4,1,-1,-1
679,670,679,674,13,14,12,13,2,2,3,3,9,-9,5,-1,2,-1
182,1073,1073,1068,14,14,12,13,1,1,2,1,-891,0,5,0,2,-1
965,956,951,946,13,16,15,16,1,2,2,1,9,5,5,-3,1,-1
824,820,820,820,14,14,15,16,2,2,1,2,4,0,0,0,-1,-1
792,792,792,792,14,17,15,16,2,3,1,1,0,0,0,-3,2,-1
281,267,262,257,21,19,20,18,2,2,1,2,14,5,5,2,-1,2
736,726,736,726,13,14,15,13,1,3,4,2,10,-10,10,-1,-1,2
450,445,445,445,20,19,20,18,2,3,1,3,5,0,0,1,-1,2
1007,1007,1003,1003,17,19,18,18,1,1,1,2,0,4,0,-2,1,0
764,759,773,773,20,19,20,21,1,2,2,1,5,-14,0,1,-1,-1
1073,1068,1064,1064,17,16,18,18,2,1,1,2,5,4,0,1,-2,0
674,665,665,670,13,16,15,16,3,1,1,2,9,0,-5,-3,1,-1
421,417,417,412,13,14,15,13,2,2,2,2,4,0,5,-1,-1,2
342,342,342,342,17,19,18,18,1,1,1,1,0,0,0,-2,1,0
337,337,328,332,17,16,15,16,1,1,2,1,0,9,-4,1,1,-1
787,782,787,782,18,17,18,16,1,2,2,1,5,-5,5,1,-1,2
609,590,586,581,14,14,15,13,3,2,6,2,19,4,5,0,-1,2
731,726,721,721,13,14,15,13,1,3,1,2,5,5,0,-1,-1,2
946,951,946,951,20,19,20,21,3,1,1,3,-5,5,-5,1,-1,-1
286,281,281,281,14,17,15,16,2,1,2,1,5,0,0,-3,2,-1
220,210,206,206,14,14,13,13,2,2,1,2,10,4,0,0,1,0
398,389,389,389,20,19,20,18,1,3,1,1,9,0,0,1,-1,2
642,660,642,637,17,16,15,16,1,1,3,2,-18,18,5,1,1,-1
951,937,937,937,13,14,12,13,2,2,1,4,14,0,0,-1,2,-1
914,909,909,904,18,19,18,19,1,1,2,2,5,0,5,-1,1,-1
436,431,431,431,17,16,18,16,1,2,2,1,5,0,0,1,-2,2
712,703,703,703,20,19,20,18,1,1,1,2,9,0,0,1,-1,2
440,431,431,426,20,19,20,21,1,2,1,3,9,0,5,1,-1,-1
478,473,468,464,17,16,15,16,2,2,3,2,5,5,4,1,1,-1
581,571,571,571,14,14,13,13,2,1,1,2,10,0,0,0,1,0
1007,1003,1003,993,13,16,15,16,3,3,4,2,4,0,10,-3,1,-1
979,974,970,960,13,14,12,13,3,3,2,2,5,4,10,-1,2,-1
740,736,745,726,20,19,18,18,1,1,2,3,4,-9,19,1,1,0
810,801,801,801,18,17,18,19,3,1,1,1,9,0,0,1,-1,-1
824,815,815,810,18,17,18,16,1,3,2,3,9,0,5,1,-1,2
796,792,792,787,14,14,13,13,2,1,2,3,4,0,5,0,1,0
1003,998,890,993,17,16,15,16,4,3,1,1,5,108,-103,1,1,-1
965,956,960,956,20,19,20,21,1,2,2,1,9,-4,4,1,-1,-1
454,445,450,450,13,14,15,16,3,2,2,1,9,-5,0,-1,-1,-1
192,192,187,182,14,14,15,13,1,3,2,2,0,5,5,0,-1,2
895,890,890,890,18,17,18,16,2,3,3,3,5,0,0,1,-1,2
229,224,229,224,21,19,20,19,3,2,2,1,5,-5,5,2,-1,1
960,956,960,951,17,19,18,18,3,1,1,1,4,-4,9,-2,1,0
337,323,323,323,20,19,18,19,2,2,1,2,14,0,0,1,1,-1
421,421,417,412,13,14,15,13,1,1,2,1,0,4,5,-1,-1,2
904,900,895,895,14,17,15,16,3,2,2,3,4,5,0,-3,2,-1
267,262,267,262,18,17,18,18,3,1,2,1,5,-5,5,1,-1,0
342,337,337,337,13,14,12,13,2,3,2,1,5,0,0,-1,2,-1
342,342,332,332,13,14,15,13,2,3,1,1,0,10,0,-1,-1,2
693,689,693,693,20,19,20,18,2,4,4,1,4,-4,0,1,-1,2
745,740,740,736,17,19,18,18,1,1,1,1,5,0,4,-2,1,0
1073,1073,1068,1068,17,16,18,18,1,2,1,2,0,5,0,1,-2,0
698,693,689,684,20,19,20,21,1,1,2,1,5,4,5,1,-1,-1
290,286,281,281,14,17,15,16,1,2,3,1,4,5,0,-3,2,-1
764,759,759,750,13,14,12,13,1,3,4,4,5,0,9,-1,2,-1
1007,998,1003,998,17,16,18,16,2,3,2,2,9,-5,5,1,-2,2
360,356,356,360,20,19,20,18,1,2,1,1,4,0,-4,1,-1,2
1021,1012,1012,1007,17,16,18,16,2,1,2,2,9,0,5,1,-2,2
215,206,210,210,21,19,20,19,1,2,1,1,9,-4,0,2,-1,1
314,323,314,318,14,14,15,13,2,2,3,1,-9,9,-4,0,-1,2
468,459,468,468,13,14,12,13,1,2,2,1,9,-9,0,-1,2,-1
679,670,674,674,20,19,18,18,1,2,1,1,9,-4,0,1,1,0
295,295,290,295,18,17,18,19,2,1,1,1,0,5,-5,1,-1,-1
360,360,356,356,17,19,18,18,3,4,1,1,0,4,0,-2,1,0
1040,1031,1026,1017,13,14,15,13,1,2,1,2,9,5,9,-1,-1,2
909,904,900,900,18,19,18,19,1,4,1,1,5,4,0,-1,1,-1
506,501,501,496,14,14,15,13,1,2,2,3,5,0,5,0,-1,2
1040,1036,1036,1040,20,19,18,18,3,2,1,2,4,0,-4,1,1,0
665,656,670,665,20,19,18,18,3,4,2,1,9,-14,5,1,1,0
586,576,571,571,14,14,15,16,2,1,1,1,10,5,0,0,-1,-1
304,300,300,300,21,19,20,19,1,1,2,1,4,0,0,2,-1,1
731,726,721,721,20,19,20,18,4,4,1,3,5,5,0,1,-1,2
548,548,548,548,14,14,13,13,3,4,1,2,0,0,0,0,1,0
979,974,970,970,13,14,15,13,1,2,1,1,5,4,0,-1,-1,2
426,412,421,417,17,16,15,16,1,2,2,1,14,-9,4,1,1,-1
529,529,529,524,21,19,20,21,2,1,2,2,0,0,5,2,-1,-1
792,782,773,1045,14,14,12,9,2,1,1,1,10,9,-272,0,2,3
843,843,839,834,18,17,18,16,3,3,2,1,0,4,5,1,-1,2
876,881,876,876,14,17,15,16,2,1,3,1,-5,5,0,-3,2,-1
618,618,618,614,14,14,15,13,2,3,1,2,0,0,4,0,-1,2
543,534,529,529,21,19,20,21,1,2,1,1,9,5,0,2,-1,-1
674,665,670,670,20,19,18,18,2,2,1,1,9,-5,0,1,1,0
482,473,473,478,18,19,18,18,1,2,1,1,9,0,-5,-1,1,0
646,642,642,637,20,19,20,18,1,1,1,2,4,0,5,1,-1,2
229,224,224,224,18,19,18,19,3,2,2,1,5,0,0,-1,1,-1
445,440,440,445,17,16,15,16,3,2,3,1,5,0,-5,1,1,-1
543,534,609,539,18,17,18,18,1,2,1,1,9,-75,70,1,-1,0
510,506,501,501,14,17,15,16,4,1,1,1,4,5,0,-3,2,-1
946,942,937,942,13,14,15,13,1,1,1,1,4,5,-5,-1,-1,2
764,759,754,754,13,14,15,13,2,3,1,2,5,5,0,-1,-1,2
290,286,276,276,14,14,15,13,3,3,2,2,4,10,0,0,-1,2
974,970,965,960,13,14,15,13,3,1,1,3,4,5,5,-1,-1,2
881,867,876,876,21,19,20,18,1,2,1,1,14,-9,0,2,-1,2
768,754,750,745,17,16,15,16,2,2,1,2,14,4,5,1,1,-1
646,642,773,642,13,14,15,16,2,2,2,1,4,-131,131,-1,-1,-1
487,482,478,473,18,19,20,18,3,2,1,2,5,4,5,-1,-1,2
464,454,454,454,13,14,12,13,2,3,1,2,10,0,0,-1,2,-1
501,501,501,501,21,19,21,21,2,2,2,2,0,0,0,2,-2,0
642,642,642,632,13,14,12,13,3,3,2,1,0,0,10,-1,2,-1
1026,1026,1021,1012,17,19,18,18,1,2,1,1,0,5,9,-2,1,0
857,857,857,853,14,14,15,13,2,2,1,4,0,0,4,0,-1,2
224,220,220,215,14,17,15,16,2,1,2,1,4,0,5,-3,2,-1
773,768,768,768,20,19,18,18,3,2,1,2,5,0,0,1,1,0
824,820,820,815,21,19,20,21,2,3,1,2,4,0,5,2,-1,-1
243,234,239,239,21,19,20,18,3,2,1,1,9,-5,0,2,-1,2
417,412,407,412,13,14,15,13,3,2,1,1,5,5,-5,-1,-1,2
370,365,365,365,20,19,20,21,2,1,3,1,5,0,0,1,-1,-1
984,984,984,984,17,19,18,18,3,1,2,1,0,0,0,-2,1,0
689,689,689,689,17,16,15,16,2,1,1,2,0,0,0,1,1,-1
412,407,412,407,20,19,18,18,2,2,2,1,5,-5,5,1,1,0
820,815,815,815,21,19,20,21,1,1,1,2,5,0,0,2,-1,-1
712,707,707,707,13,14,12,13,3,1,2,3,5,0,0,-1,2,-1
454,450,651,450,17,16,20,16,3,1,1,1,4,-201,201,1,-4,4
604,595,586,581,14,14,15,13,2,3,2,2,9,9,5,0,-1,2
806,787,792,792,21,19,21,19,1,2,1,2,19,-5,0,2,-2,2
782,782,778,778,18,19,18,18,1,1,1,1,0,4,0,-1,1,0
257,253,248,248,14,17,15,16,1,1,1,3,4,5,0,-3,2,-1
1045,1045,1040,1040,17,19,18,18,1,1,1,1,0,5,0,-2,1,0
731,731,726,726,17,16,15,16,3,1,1,1,0,5,0,1,1,-1
224,215,215,215,14,17,15,16,2,4,1,1,9,0,0,-3,2,-1
510,496,496,496,18,19,18,19,2,1,3,1,14,0,0,-1,1,-1
923,923,923,918,18,17,18,19,2,1,2,2,0,0,5,1,-1,-1
1012,1003,1007,1003,17,16,15,16,1,2,2,1,9,-4,4,1,1,-1
993,984,984,984,13,14,12,13,1,3,3,2,9,0,0,-1,2,-1
304,295,295,290,14,17,15,16,1,2,2,2,9,0,5,-3,2,-1
979,979,979,993,13,14,15,16,2,1,1,1,0,0,-14,-1,-1,-1
510,506,501,496,18,17,18,19,5,1,2,2,4,5,5,1,-1,-1
468,468,464,464,17,16,15,16,3,1,1,1,0,4,0,1,1,-1
656,646,646,646,20,19,20,21,2,2,2,1,10,0,0,1,-1,-1
314,318,318,314,18,19,18,19,2,3,2,2,-4,0,4,-1,1,-1
206,206,206,206,21,19,20,21,2,1,2,1,0,0,0,2,-1,-1
309,295,295,295,14,14,15,13,1,2,1,3,14,0,0,0,-1,2
792,782,778,778,14,17,15,16,2,2,1,1,10,4,0,-3,2,-1
984,974,974,974,13,14,12,13,1,2,1,1,10,0,0,-1,2,-1
450,445,454,459,20,19,20,21,3,1,1,2,5,-9,-5,1,-1,-1
1050,1045,1040,1036,13,14,15,13,3,3,3,2,5,5,4,-1,-1,2
576,567,567,567,21,17,15,16,3,2,3,1,9,0,0,4,2,-1
843,834,824,824,14,14,15,13,1,3,3,1,9,10,0,0,-1,2
464,459,459,459,17,16,15,16,1,1,4,1,5,0,0,1,1,-1
539,534,529,529,18,19,18,19,2,2,1,1,5,5,0,-1,1,-1
656,651,651,651,13,16,15,16,3,3,2,1,5,0,0,-3,1,-1
543,543,543,539,18,17,18,18,2,1,1,3,0,0,4,1,-1,0
229,229,229,229,18,17,18,16,2,5,2,1,0,0,0,1,-1,2
895,890,890,890,18,17,18,19,3,3,1,1,5,0,0,1,-1,-1
253,248,248,243,21,19,20,18,1,1,1,2,5,0,5,2,-1,2
750,750,750,759,17,16,15,16,3,2,1,2,0,0,-9,1,1,-1
787,773,778,778,18,19,18,18,1,2,1,1,14,-5,0,-1,1,0
750,750,745,745,17,19,18,18,1,1,1,2,0,5,0,-2,1,0
956,951,956,956,17,16,18,16,1,1,2,1,5,-5,0,1,-2,2
417,407,407,403,20,19,18,18,2,2,2,1,10,0,4,1,1,0
670,665,660,660,20,19,20,18,2,1,1,1,5,5,0,1,-1,2
206,196,192,196,14,14,13,13,2,1,2,1,10,4,-4,0,1,0
876,876,871,871,14,17,15,16,1,1,1,1,0,5,0,-3,2,-1
257,253,253,248,18,19,18,18,2,2,1,2,4,0,5,-1,1,0
473,468,464,464,17,16,15,16,2,3,2,1,5,4,0,1,1,-1
942,937,937,937,20,19,18,18,3,1,1,1,5,0,0,1,1,0
201,206,201,196,14,14,13,13,3,3,1,2,-5,5,5,0,1,0
857,857,853,853,18,19,18,18,2,3,1,1,0,4,0,-1,1,0
586,586,586,586,21,19,20,21,2,1,2,3,0,0,0,2,-1,-1
510,506,506,506,14,17,15,16,1,3,1,1,4,0,0,-3,2,-1
506,501,496,496,18,17,18,16,1,1,1,3,5,5,0,1,-1,2
482,473,473,478,14,16,15,16,2,2,1,1,9,0,-5,-2,1,-1
553,543,543,543,18,19,18,18,2,1,4,1,10,0,0,-1,1,0
253,243,243,243,18,17,18,18,1,2,1,3,10,0,0,1,-1,0
262,257,257,257,14,14,13,13,1,2,1,2,5,0,0,0,1,0
740,731,740,731,13,14,12,13,1,6,3,1,9,-9,9,-1,2,-1
1050,1050,1050,1050,20,19,20,21,2,3,2,1,0,0,0,1,-1,-1
712,707,707,707,17,16,15,16,2,2,1,1,5,0,0,1,1,-1
829,824,824,824,14,14,13,13,2,1,1,2,5,0,0,0,1,0
454,445,445,450,13,14,12,13,2,2,1,1,9,0,-5,-1,2,-1
886,876,881,881,14,17,15,16,1,2,4,1,10,-5,0,-3,2,-1
740,740,736,736,20,19,20,21,3,1,3,2,0,4,0,1,-1,-1
989,984,989,989,20,19,20,21,3,3,1,3,5,-5,0,1,-1,-1
384,379,374,379,13,14,15,13,3,2,3,1,5,5,-5,-1,-1,2
314,314,314,314,14,17,15,16,1,1,1,3,0,0,0,-3,2,-1
1073,1068,1064,1064,20,19,20,18,1,1,1,1,5,4,0,1,-1,2
1021,1017,1017,1017,13,14,12,13,1,1,2,3,4,0,0,-1,2,-1
459,454,454,454,13,14,12,13,1,2,1,1,5,0,0,-1,2,-1
862,857,857,857,21,19,20,18,5,2,1,2,5,0,0,2,-1,2
286,239,239,239,18,19,18,18,1,3,4,1,47,0,0,-1,1,0
576,576,576,567,18,17,18,18,3,3,2,2,0,0,9,1,-1,0
942,928,918,918,17,17,15,16,2,1,2,2,14,10,0,0,2,-1
454,454,445,450,13,14,15,13,1,2,1,2,0,9,-5,-1,-1,2
501,501,501,501,14,14,15,13,1,2,2,1,0,0,0,0,-1,2
867,201,843,839,14,14,15,13,3,1,2,1,666,-642,4,0,-1,2
314,304,309,309,14,14,13,13,1,2,2,3,10,-5,0,0,1,0
300,290,290,290,18,17,18,19,3,3,1,1,10,0,0,1,-1,-1
450,445,445,445,20,19,20,21,1,2,1,1,5,0,0,1,-1,-1
881,876,871,867,18,19,18,18,3,1,2,1,5,5,4,-1,1,0
290,286,281,281,18,17,18,19,2,2,1,1,4,5,0,1,-1,-1
1045,1036,1040,1045,20,19,18,18,1,2,1,1,9,-4,-5,1,1,0
642,642,642,637,13,14,15,13,3,3,2,2,0,0,5,-1,-1,2
346,346,346,342,13,14,12,13,1,3,3,1,0,0,4,-1,2,-1
632,628,628,623,13,14,13,13,1,1,1,2,4,0,5,-1,1,0
492,464,459,459,14,14,12,13,1,3,1,4,28,5,0,0,2,-1
398,393,398,393,13,14,12,13,2,3,2,1,5,-5,5,-1,2,-1
431,426,421,426,13,14,15,13,2,1,2,8,5,5,-5,-1,-1,2
342,332,337,337,17,16,18,18,1,2,1,3,10,-5,0,1,-2,0
224,220,224,224,21,19,20,21,2,3,1,1,4,-4,0,2,-1,-1
267,267,271,267,14,17,15,16,2,1,3,3,0,-4,4,-3,2,-1
595,586,586,586,14,14,15,13,3,2,1,3,9,0,0,0,-1,2
609,600,600,595,14,14,13,13,1,4,3,2,9,0,5,0,1,0
656,651,656,651,20,19,20,18,1,2,2,2,5,-5,5,1,-1,2
1040,1026,1021,1017,13,14,15,16,2,3,1,2,14,5,4,-1,-1,-1
965,960,956,956,17,16,18,18,3,1,3,3,5,4,0,1,-2,0
989,984,989,984,20,19,20,18,1,5,2,1,5,-5,5,1,-1,2
623,618,614,614,14,14,13,13,2,1,3,2,5,4,0,0,1,0
989,989,984,979,17,16,18,18,1,2,2,1,0,5,5,1,-2,0
614,604,618,623,18,17,18,16,1,3,1,2,10,-14,-5,1,-1,2
192,1073,1068,1068,14,14,15,13,1,2,1,1,-881,5,0,0,-1,2
1003,1003,1003,1003,20,19,20,18,1,1,1,2,0,0,0,1,-1,2
717,721,717,717,13,14,15,13,3,1,1,1,-4,4,0,-1,-1,2
674,665,665,670,17,16,18,18,1,2,3,2,9,0,-5,1,-2,0
224,215,215,220,18,19,18,19,2,2,3,1,9,0,-5,-1,1,-1
557,539,539,539,18,17,18,16,3,2,1,2,18,0,0,1,-1,2
750,759,745,740,17,19,18,18,1,1,3,1,-9,14,5,-2,1,0
365,360,356,356,20,19,20,18,2,3,2,3,5,4,0,1,-1,2
529,515,515,510,14,14,15,16,3,1,2,2,14,0,5,0,-1,-1
300,304,300,295,18,19,18,19,2,3,3,1,-4,4,5,-1,1,-1
604,595,590,595,18,19,18,19,1,1,1,1,9,5,-5,-1,1,-1
553,553,548,548,14,14,13,13,2,1,3,1,0,5,0,0,1,0
726,717,717,717,20,19,20,18,2,2,1,2,9,0,0,1,-1,2
224,206,201,201,14,14,13,13,1,2,1,1,18,5,0,0,1,0
487,482,487,487,21,19,21,19,2,1,2,1,5,-5,0,2,-2,2
440,431,436,436,13,14,12,13,2,2,2,1,9,-5,0,-1,2,-1
745,736,745,740,17,16,18,18,3,2,2,1,9,-9,5,1,-2,0
843,839,834,834,14,17,15,16,3,1,4,1,4,5,0,-3,2,-1
487,487,487,487,21,19,21,19,2,1,1,1,0,0,0,2,-2,2
286,276,281,281,14,14,13,13,1,1,1,3,10,-5,0,0,1,0
337,332,328,323,17,16,18,19,2,1,1,2,5,4,5,1,-2,-1
1059,1054,1045,1040,20,19,20,18,1,1,1,2,5,9,5,1,-1,2
337,332,328,323,13,14,15,13,2,2,2,2,5,4,5,-1,-1,2
604,600,600,604,21,19,20,19,2,1,1,1,4,0,-4,2,-1,1
736,726,726,726,17,16,18,18,2,2,2,1,10,0,0,1,-2,0
984,974,974,974,13,14,12,13,2,4,1,3,10,0,0,-1,2,-1
323,318,318,314,18,19,18,19,3,1,2,1,5,0,4,-1,1,-1
839,829,834,829,21,19,20,19,2,1,2,1,10,-5,5,2,-1,1
815,815,815,820,14,17,15,16,2,3,1,1,0,0,-5,-3,2,-1
773,764,773,768,17,16,18,18,2,1,3,2,9,-9,5,1,-2,0
407,403,393,389,13,14,15,13,1,1,1,2,4,10,4,-1,-1,2
674,674,665,665,13,14,12,13,1,3,3,1,0,9,0,-1,2,-1
946,942,942,942,20,19,20,21,1,2,1,1,4,0,0,1,-1,-1
300,295,295,295,14,14,15,13,3,3,2,2,5,0,0,0,-1,2
510,501,501,501,18,17,18,16,1,2,1,1,9,0,0,1,-1,2
309,300,295,290,14,17,15,16,1,1,2,2,9,5,5,-3,2,-1
1045,1040,1040,1040,13,14,15,13,1,3,1,3,5,0,0,-1,-1,2
182,1012,1012,1017,18,16,18,18,2,2,1,1,-830,0,-5,2,-2,0
857,839,839,839,14,14,13,13,3,2,2,1,18,0,0,0,1,0
267,267,267,271,21,19,20,21,2,3,2,1,0,0,-4,2,-1,-1
314,314,309,314,14,14,13,13,2,1,1,1,0,5,-5,0,1,0
553,548,543,543,21,19,20,18,2,3,1,2,5,5,0,2,-1,2
534,534,534,524,14,14,13,13,1,4,3,2,0,0,10,0,1,0
454,445,445,436,13,14,15,16,3,4,2,2,9,0,9,-1,-1,-1
848,839,839,839,14,14,15,16,1,2,1,1,9,0,0,0,-1,-1
679,684,679,670,13,14,12,13,3,3,2,2,-5,5,9,-1,2,-1
876,871,871,867,14,14,15,13,2,2,4,1,5,0,4,0,-1,2
886,881,881,876,14,17,15,16,2,1,3,2,5,0,5,-3,2,-1
1021,1012,1012,1012,20,19,18,18,2,2,2,3,9,0,0,1,1,0
689,679,684,684,13,14,15,13,2,2,2,1,10,-5,0,-1,-1,2
881,876,881,871,18,17,18,16,3,1,1,2,5,-5,10,1,-1,2
346,346,346,342,13,14,12,13,3,3,1,2,0,0,4,-1,2,-1
417,417,412,412,13,14,12,13,2,3,1,1,0,5,0,-1,2,-1
670,660,656,656,20,19,20,18,2,2,1,1,10,4,0,1,-1,2
1045,1036,1036,1031,17,16,18,16,4,2,2,1,9,0,5,1,-2,2
698,679,679,670,13,14,15,13,2,2,1,2,19,0,9,-1,-1,2
674,660,656,646,13,14,15,13,2,2,1,1,14,4,10,-1,-1,2
253,248,239,239,18,17,18,18,4,1,1,2,5,9,0,1,-1,0
314,309,309,309,18,17,18,16,1,1,1,3,5,0,0,1,-1,2
712,703,703,698,17,16,18,18,2,2,2,1,9,0,5,1,-2,0
960,951,951,951,13,16,15,16,3,2,1,3,9,0,0,-3,1,-1
346,337,332,332,20,19,18,18,2,2,1,2,9,5,0,1,1,0
450,445,445,440,20,19,20,21,3,2,3,2,5,0,5,1,-1,-1
524,524,520,520,18,17,18,19,1,3,1,1,0,4,0,1,-1,-1
862,857,857,853,14,17,15,16,1,3,2,2,5,0,4,-3,2,-1
224,220,220,220,14,14,15,13,2,1,1,1,4,0,0,0,-1,2
965,951,956,951,13,14,15,13,3,2,2,1,14,-5,5,-1,-1,2
890,881,871,876,14,17,15,16,3,1,1,1,9,10,-5,-3,2,-1
210,201,201,201,14,14,15,13,3,2,3,2,9,0,0,0,-1,2
201,192,187,187,21,19,21,19,1,1,1,2,9,5,0,2,-2,2
440,440,440,440,20,19,18,18,1,2,2,1,0,0,0,1,1,0
482,473,473,468,14,14,12,13,2,3,1,2,9,0,5,0,2,-1
360,356,356,356,13,14,12,13,1,2,3,1,4,0,0,-1,2,-1
862,857,862,857,21,19,20,18,4,3,2,1,5,-5,5,2,-1,2
862,862,862,867,21,19,20,18,1,2,1,1,0,0,-5,2,-1,2
586,571,553,548,14,14,15,13,3,1,3,3,15,18,5,0,-1,2
946,942,942,942,13,14,12,13,2,1,3,2,4,0,0,-1,2,-1
581,567,571,571,18,17,18,18,1,1,1,2,14,-4,0,1,-1,0
1036,1031,1026,1026,17,16,15,16,2,1,2,2,5,5,0,1,1,-1
904,900,900,900,14,14,15,13,1,2,2,2,4,0,0,0,-1,2
337,332,328,328,20,19,18,19,3,1,1,1,5,4,0,1,1,-1
314,309,309,309,21,19,21,21,3,1,1,2,5,0,0,2,-2,0
309,309,309,295,14,14,15,16,3,2,2,2,0,0,14,0,-1,-1
782,778,773,773,21,19,20,21,1,1,1,1,4,5,0,2,-1,-1
1045,1040,1040,1031,20,19,20,21,2,2,1,2,5,0,9,1,-1,-1
557,553,553,553,18,17,18,18,3,3,2,1,4,0,0,1,-1,0
764,754,759,759,13,14,15,13,4,2,1,2,10,-5,0,-1,-1,2
290,276,281,281,14,14,15,13,1,4,1,1,14,-5,0,0,-1,2
642,632,628,632,13,14,13,13,1,1,1,1,10,4,-4,-1,1,0
646,642,642,642,20,19,20,18,2,2,1,3,4,0,0,1,-1,2
1054,1050,1050,1045,13,14,15,13,3,3,1,3,4,0,5,-1,-1,2
539,534,529,529,18,17,18,16,2,1,1,2,5,5,0,1,-1,2
1007,1003,1003,1003,17,19,18,18,3,1,3,3,4,0,0,-2,1,0
271,267,267,267,21,19,20,21,3,1,1,1,4,0,0,2,-1,-1
590,586,581,581,18,19,18,19,1,2,3,3,4,5,0,-1,1,-1
323,323,318,318,18,17,18,16,2,3,3,1,0,5,0,1,-1,2
1045,1040,1036,1045,13,14,12,13,2,3,2,1,5,4,-9,-1,2,-1
707,698,698,698,17,16,18,18,1,2,2,1,9,0,0,1,-2,0
792,773,492,768,14,16,18,16,3,2,1,1,19,281,-276,-2,-2,2
562,553,553,548,14,14,13,13,2,3,2,1,9,0,5,0,1,0
459,454,459,459,13,14,15,16,5,2,3,1,5,-5,0,-1,-1,-1
984,984,979,974,13,14,15,13,1,1,2,1,0,5,5,-1,-1,2
993,984,979,979,13,16,15,16,2,3,1,2,9,5,0,-3,1,-1
623,623,623,623,21,19,21,21,2,2,1,1,0,0,0,2,-2,0
529,515,515,515,14,17,15,16,2,1,2,1,14,0,0,-3,2,-1
581,576,581,576,18,17,18,16,2,3,2,2,5,-5,5,1,-1,2
853,834,829,829,14,17,15,16,3,1,1,1,19,5,0,-3,2,-1
1026,1021,1021,1017,17,16,15,16,2,1,2,2,5,0,4,1,1,-1
557,548,557,553,18,19,18,16,2,2,2,2,9,-9,4,-1,1,2
773,768,773,773,17,16,18,18,1,4,1,1,5,-5,0,1,-2,0
946,946,946,946,13,14,15,16,2,4,1,1,0,0,0,-1,-1,-1
295,286,290,281,14,14,13,13,2,2,4,2,9,-4,9,0,1,0
253,243,248,248,18,19,18,18,1,2,2,1,10,-5,0,-1,1,0
674,665,670,670,13,14,12,13,2,2,2,1,9,-5,0,-1,2,-1
989,984,979,984,20,19,18,18,2,1,2,1,5,5,-5,1,1,0
745,740,740,740,13,16,15,16,3,2,3,2,5,0,0,-3,1,-1
496,496,487,492,14,14,13,13,2,3,3,3,0,9,-5,0,1,0
506,496,496,496,14,14,15,13,1,2,2,2,10,0,0,0,-1,2
426,426,426,426,13,14,12,13,1,2,2,2,0,0,0,-1,2,-1
224,224,224,215,18,17,18,19,1,2,5,2,0,0,9,1,-1,-1
571,567,567,567,14,14,13,13,1,2,3,1,4,0,0,0,1,0
510,501,501,496,14,14,15,13,3,2,3,2,9,0,5,0,-1,2
660,660,670,670,13,14,12,13,3,3,2,2,0,-10,0,-1,2,-1
492,482,482,487,18,19,18,19,1,1,1,2,10,0,-5,-1,1,-1
974,970,970,970,17,16,18,16,3,2,2,1,4,0,0,1,-2,2
960,956,951,951,17,16,15,16,1,1,1,1,4,5,0,1,1,-1
300,290,286,286,14,17,15,16,2,2,1,3,10,4,0,-3,2,-1
909,904,909,904,18,19,18,19,1,4,2,1,5,-5,5,-1,1,-1
398,389,389,389,13,14,15,13,2,3,2,1,9,0,0,-1,-1,2
886,886,886,881,14,17,15,16,2,3,2,1,0,0,5,-3,2,-1
1036,1031,1031,1026,13,14,15,13,2,2,2,2,5,0,5,-1,-1,2
215,201,206,206,14,17,15,16,3,1,1,2,14,-5,0,-3,2,-1
539,529,520,515,14,14,13,13,2,3,1,1,10,9,5,0,1,0
557,548,548,543,14,14,15,16,1,2,1,2,9,0,5,0,-1,-1
576,571,576,576,14,14,13,13,2,2,1,4,5,-5,0,0,1,0
515,501,501,506,14,14,13,13,1,3,2,2,14,0,-5,0,1,0
974,970,970,965,17,16,18,18,3,1,1,1,4,0,5,1,-2,0
946,942,942,942,20,19,20,21,1,1,1,2,4,0,0,1,-1,-1
1040,1031,1021,1026,17,19,18,18,1,1,1,1,9,10,-5,-2,1,0
337,332,337,426,17,16,18,13,2,2,2,1,5,-5,-89,1,-2,5
759,754,754,754,13,14,12,13,1,3,1,1,5,0,0,-1,2,-1
206,196,196,192,21,19,21,21,3,3,1,2,10,0,4,2,-2,0
581,571,571,571,18,17,18,18,1,2,3,1,10,0,0,1,-1,0
543,543,543,539,14,14,13,13,1,3,2,1,0,0,4,0,1,0
1078,1073,1059,1059,20,19,20,18,2,1,1,1,5,14,0,1,-1,2
1068,1064,1064,1059,20,19,20,21,3,1,1,2,4,0,5,1,-1,-1
848,843,848,848,14,14,15,13,3,2,3,1,5,-5,0,0,-1,2
928,918,914,909,14,14,15,13,1,3,1,2,10,4,5,0,-1,2
468,464,468,468,20,19,18,18,1,2,2,1,4,-4,0,1,1,0
895,895,895,895,18,17,18,19,1,2,1,1,0,0,0,1,-1,-1
853,843,843,843,21,19,20,21,1,2,1,1,10,0,0,2,-1,-1
403,398,398,393,20,19,18,18,2,1,2,2,5,0,5,1,1,0
360,356,360,360,17,16,18,18,3,1,1,1,4,-4,0,1,-2,0
323,309,314,309,18,17,18,16,3,3,2,2,14,-5,5,1,-1,2
374,370,374,374,13,16,15,16,2,4,2,1,4,-4,0,-3,1,-1
1073,1073,1064,1064,20,19,20,18,2,1,1,2,0,9,0,1,-1,2
520,520,520,520,18,17,18,19,2,3,2,1,0,0,0,1,-1,-1
979,974,974,970,20,19,18,18,1,2,1,2,5,0,4,1,1,0
1064,1050,243,1045,13,16,20,16,4,3,1,1,14,807,-802,-3,-4,4
974,970,970,970,17,16,15,16,2,3,2,1,4,0,0,1,1,-1
257,253,253,253,18,19,18,18,3,2,1,1,4,0,0,-1,1,0
782,778,778,773,21,19,20,18,1,1,1,1,4,0,5,2,-1,2
295,295,295,295,21,19,20,19,1,2,2,2,0,0,0,2,-1,1
454,450,445,445,20,19,20,21,2,1,1,1,4,5,0,1,-1,-1
881,876,876,876,14,17,15,16,2,2,1,2,5,0,0,-3,2,-1
1021,1007,1017,1007,13,14,12,13,3,2,2,3,14,-10,10,-1,2,-1
346,337,328,328,17,16,18,16,2,1,1,1,9,9,0,1,-2,2
1026,1021,1021,1021,20,19,20,18,2,1,1,3,5,0,0,1,-1,2
206,187,187,182,14,14,15,13,1,3,2,2,19,0,5,0,-1,2
248,243,243,239,14,14,13,13,1,2,1,3,5,0,4,0,1,0
403,398,393,389,13,14,15,13,4,3,3,2,5,5,4,-1,-1,2
1003,993,1007,993,17,16,18,16,3,2,1,1,10,-14,14,1,-2,2
290,286,281,281,14,14,15,16,1,2,2,1,4,5,0,0,-1,-1
557,562,557,557,21,19,20,18,2,3,2,2,-5,5,0,2,-1,2
989,989,984,984,17,16,15,16,1,1,1,2,0,5,0,1,1,-1
210,201,201,201,14,14,15,13,2,2,2,1,9,0,0,0,-1,2
196,187,187,187,14,14,13,13,3,2,1,1,9,0,0,0,1,0
768,768,764,764,17,16,18,18,1,1,2,1,0,4,0,1,-2,0
567,562,567,567,14,14,15,16,1,2,1,1,5,-5,0,0,-1,-1
342,337,398,337,17,16,15,18,1,2,1,1,5,-61,61,1,1,-3
815,810,810,806,14,14,13,13,1,3,2,2,5,0,4,0,1,0
548,543,543,539,14,14,15,13,1,4,2,6,5,0,4,0,-1,2
1054,1050,1050,1040,17,16,15,16,1,2,1,2,4,0,10,1,1,-1
234,210,201,201,14,14,13,13,3,3,1,1,24,9,0,0,1,0
796,796,792,796,14,17,15,16,4,1,2,3,0,4,-4,-3,2,-1
478,459,459,459,13,14,15,16,2,2,3,1,19,0,0,-1,-1,-1
904,904,900,895,18,17,18,19,2,1,2,1,0,4,5,1,-1,-1
196,187,182,187,14,14,15,13,2,1,1,1,9,5,-5,0,-1,2
970,965,970,965,13,14,12,13,2,1,2,3,5,-5,5,-1,2,-1
707,703,707,703,13,16,15,16,1,3,2,1,4,-4,4,-3,1,-1
436,421,421,417,17,16,15,16,2,3,2,1,15,0,4,1,1,-1
974,965,965,965,13,16,15,16,2,3,2,1,9,0,0,-3,1,-1
403,389,389,384,13,14,15,13,1,2,2,1,14,0,5,-1,-1,2
295,290,286,281,18,19,18,19,3,3,1,2,5,4,5,-1,1,-1
736,726,736,731,20,19,18,18,2,2,3,1,10,-10,5,1,1,0
562,478,473,473,14,14,12,13,1,1,2,3,84,5,0,0,2,-1
604,600,595,600,21,19,20,21,1,3,1,1,4,5,-5,2,-1,-1
815,810,806,806,18,17,18,16,2,1,2,3,5,4,0,1,-1,2
501,496,496,496,21,19,21,19,1,2,1,3,5,0,0,2,-2,2
1003,998,993,993,20,19,20,21,2,1,1,3,5,5,0,1,-1,-1
614,609,609,604,18,19,18,19,1,1,2,2,5,0,5,-1,1,-1
206,206,201,206,14,17,15,16,1,1,3,1,0,5,-5,-3,2,-1
192,192,192,192,21,19,21,21,1,3,1,1,0,0,0,2,-2,0
674,670,670,670,13,14,15,16,1,2,1,2,4,0,0,-1,-1,-1
539,529,529,529,18,17,18,19,3,3,2,1,10,0,0,1,-1,-1
501,496,496,496,18,17,18,16,1,2,1,3,5,0,0,1,-1,2
703,698,703,703,20,19,20,21,1,1,1,2,5,-5,0,1,-1,-1
960,951,956,965,17,16,18,16,2,2,4,1,9,-5,-9,1,-2,2
201,192,192,192,21,19,21,19,1,1,2,1,9,0,0,2,-2,2
646,642,642,637,13,14,15,13,2,1,2,1,4,0,5,-1,-1,2
492,487,487,492,18,17,18,16,2,4,1,1,5,0,-5,1,-1,2
501,496,496,492,14,14,15,16,2,2,1,2,5,0,4,0,-1,-1
314,304,304,304,18,19,18,19,2,2,1,1,10,0,0,-1,1,-1
665,665,665,660,17,16,18,18,1,1,2,3,0,0,5,1,-2,0
960,946,389,951,17,16,23,16,2,2,1,1,14,557,-562,1,-7,7
993,989,989,989,13,14,12,13,1,3,1,1,4,0,0,-1,2,-1
468,454,450,450,13,14,15,13,3,2,1,3,14,4,0,-1,-1,2
257,257,257,257,21,19,20,18,2,2,2,1,0,0,0,2,-1,2
187,187,187,182,18,19,18,19,1,2,2,2,0,0,5,-1,1,-1
1045,1040,1040,1045,17,19,18,18,1,1,1,1,5,0,-5,-2,1,0
923,923,928,928,14,17,15,16,2,2,2,1,0,-5,0,-3,2,-1
267,257,262,262,14,14,13,13,1,1,2,3,10,-5,0,0,1,0
389,393,389,389,13,14,12,13,1,3,2,1,-4,4,0,-1,2,-1
717,712,726,731,20,19,20,18,1,1,1,1,5,-14,-5,1,-1,2
750,740,745,745,13,14,12,13,2,2,2,1,10,-5,0,-1,2,-1
581,571,571,571,18,17,18,18,1,2,1,2,10,0,0,1,-1,0
703,693,693,698,17,16,15,16,1,2,2,3,10,0,-5,1,1,-1
337,323,323,323,17,17,18,16,2,2,1,2,14,0,0,0,-1,2
782,773,773,773,14,14,12,13,1,2,3,1,9,0,0,0,2,-1
562,567,562,562,18,19,18,18,2,1,1,1,-5,5,0,-1,1,0
360,360,356,356,20,19,20,21,3,2,2,1,0,4,0,1,-1,-1
248,234,253,267,14,14,13,13,1,3,2,2,14,-19,-14,0,1,0
506,501,506,501,21,19,20,19,2,1,2,2,5,-5,5,2,-1,1
839,824,829,820,14,14,13,13,1,1,2,2,15,-5,9,0,1,0
445,431,576,426,17,16,18,16,3,2,1,3,14,-145,150,1,-2,2
295,281,281,271,14,14,13,13,2,2,2,2,14,0,10,0,1,0
853,853,853,853,21,19,20,21,1,1,1,1,0,0,0,2,-1,-1
848,839,834,829,18,17,15,16,3,3,1,2,9,5,5,1,2,-1
998,989,989,993,13,16,15,16,2,3,3,1,9,0,-4,-3,1,-1
290,286,286,290,14,14,15,13,1,2,2,1,4,0,-4,0,-1,2
881,881,871,871,18,17,18,16,2,1,3,3,0,10,0,1,-1,2
365,356,356,356,17,16,15,16,2,2,1,2,9,0,0,1,1,-1
642,642,642,642,17,16,18,16,1,1,1,1,0,0,0,1,-2,2
707,698,698,698,20,19,20,21,2,1,1,2,9,0,0,1,-1,-1
993,989,989,989,13,14,15,13,1,1,1,1,4,0,0,-1,-1,2
862,857,857,857,14,17,15,16,3,1,1,1,5,0,0,-3,2,-1
914,909,904,904,18,17,18,16,1,1,1,1,5,5,0,1,-1,2
374,356,356,356,17,16,18,16,1,1,1,2,18,0,0,1,-2,2
768,768,768,768,13,14,15,13,3,3,2,1,0,0,0,-1,-1,2
867,862,862,862,14,17,15,16,1,3,3,1,5,0,0,-3,2,-1
468,454,450,445,13,16,15,16,6,3,1,1,14,4,5,-3,1,-1
609,604,604,609,18,17,18,19,2,2,1,3,5,0,-5,1,-1,-1
417,403,403,407,13,14,15,13,1,2,3,3,14,0,-4,-1,-1,2
356,351,342,346,17,16,18,16,3,1,1,3,5,9,-4,1,-2,2
1040,1040,1036,1031,20,19,20,21,1,3,1,2,0,4,5,1,-1,-1
182,1068,1068,1068,18,19,18,18,1,2,1,2,-886,0,0,-1,1,0
984,974,979,974,13,14,12,13,2,3,2,5,10,-5,5,-1,2,-1
421,412,417,412,13,14,12,13,1,2,2,3,9,-5,5,-1,2,-1
618,614,618,614,18,19,18,19,1,1,2,2,4,-4,4,-1,1,-1
960,956,951,951,20,19,20,18,1,2,1,1,4,5,0,1,-1,2
787,782,773,773,18,17,18,16,3,2,1,2,5,9,0,1,-1,2
234,234,229,229,18,17,18,19,1,1,3,3,0,5,0,1,-1,-1
646,646,651,646,20,19,20,18,1,1,2,1,0,-5,5,1,-1,2
487,487,482,482,21,19,21,19,1,1,1,1,0,5,0,2,-2,2
773,773,768,768,17,16,15,16,1,1,2,1,0,5,0,1,1,-1
595,576,571,567,14,17,15,16,2,1,2,3,19,5,4,-3,2,-1
810,806,810,806,14,17,15,16,3,2,2,1,4,-4,4,-3,2,-1
989,984,989,984,13,14,12,13,3,2,2,2,5,-5,5,-1,2,-1
215,210,210,206,14,17,15,16,2,3,2,2,5,0,4,-3,2,-1
946,937,937,937,20,19,20,21,2,2,1,1,9,0,0,1,-1,-1
403,398,393,403,20,19,20,21,2,3,5,1,5,5,-10,1,-1,-1
346,337,337,337,13,14,12,13,2,2,1,2,9,0,0,-1,2,-1
506,496,492,492,18,19,18,19,1,2,1,3,10,4,0,-1,1,-1
759,754,754,754,20,19,18,18,2,2,2,1,5,0,0,1,1,0
436,436,431,436,20,19,20,21,3,3,3,1,0,5,-5,1,-1,-1
1059,1059,1054,1059,13,14,15,13,3,3,3,1,0,5,-5,-1,-1,2
984,984,979,979,20,19,20,18,1,1,1,1,0,5,0,1,-1,2
792,787,787,787,14,14,13,13,2,3,1,1,5,0,0,0,1,0
796,792,787,782,14,14,13,13,2,3,2,1,4,5,5,0,1,0
295,290,290,290,18,17,18,19,1,3,1,1,5,0,0,1,-1,-1
276,271,271,262,21,19,20,21,1,2,1,2,5,0,9,2,-1,-1
632,628,628,628,13,14,15,13,1,1,1,1,4,0,0,-1,-1,2
1050,1054,1045,1050,13,16,15,16,3,1,4,1,-4,9,-5,-3,1,-1
782,773,773,773,18,19,18,18,1,2,2,1,9,0,0,-1,1,0
768,759,759,754,13,14,12,13,1,2,2,2,9,0,5,-1,2,-1
407,403,403,403,20,19,18,18,2,3,2,2,4,0,0,1,1,0
351,346,342,337,20,19,20,18,1,1,2,1,5,4,5,1,-1,2
562,557,562,562,14,14,13,13,2,4,2,2,5,-5,0,0,1,0
295,281,276,281,18,19,18,19,2,3,3,1,14,5,-5,-1,1,-1
360,318,318,318,17,17,15,16,2,1,1,3,42,0,0,0,2,-1
871,867,867,857,14,17,15,16,1,2,1,4,4,0,10,-3,2,-1
501,487,482,482,14,14,15,13,1,2,1,1,14,5,0,0,-1,2
590,590,586,586,14,14,13,13,3,3,3,2,0,4,0,0,1,0
707,707,703,698,13,16,15,16,1,2,2,1,0,4,5,-3,1,-1
1036,1031,1036,1036,17,16,18,18,1,2,1,1,5,-5,0,1,-2,0
295,286,290,295,14,14,13,13,1,4,1,2,9,-4,-5,0,1,0
693,693,689,693,17,16,15,16,1,1,1,2,0,4,-4,1,1,-1
754,750,754,750,13,14,12,13,3,1,2,2,4,-4,4,-1,2,-1
210,206,295,210,21,19,23,19,2,1,1,1,4,-89,85,2,-4,4
257,253,253,248,18,19,18,18,1,2,3,2,4,0,5,-1,1,0
567,567,567,567,21,19,20,21,2,2,1,1,0,0,0,2,-1,-1
1059,1050,1050,1050,20,19,18,18,2,2,3,1,9,0,0,1,1,0
482,473,478,473,21,19,20,21,2,2,2,1,9,-5,5,2,-1,-1
604,604,604,600,14,14,15,13,2,1,2,1,0,0,4,0,-1,2
192,182,182,182,18,17,18,19,3,1,1,1,10,0,0,1,-1,-1
1040,1026,1026,1021,13,14,12,13,2,2,1,2,14,0,5,-1,2,-1
796,792,782,782,18,17,18,16,2,1,1,1,4,10,0,1,-1,2
1036,1036,1036,1031,17,16,18,18,1,2,2,2,0,0,5,1,-2,0
267,257,257,262,18,17,18,16,2,3,2,1,10,0,-5,1,-1,2
942,937,932,932,13,16,15,16,1,3,1,1,5,5,0,-3,1,-1
904,881,881,881,14,14,15,13,2,2,2,2,23,0,0,0,-1,2
782,787,787,782,14,17,15,16,1,1,2,2,-5,0,5,-3,2,-1
187,182,182,182,18,19,18,19,1,2,1,1,5,0,0,-1,1,-1
914,909,909,909,14,17,15,16,1,2,3,1,5,0,0,-3,2,-1
759,754,759,750,17,16,18,18,2,2,2,2,5,-5,9,1,-2,0
271,262,257,257,14,17,15,16,1,1,1,1,9,5,0,-3,2,-1
332,323,328,328,17,19,18,19,1,2,1,1,9,-5,0,-2,1,-1
351,346,342,342,20,19,18,18,1,2,1,1,5,4,0,1,1,0
590,576,571,567,18,19,18,18,3,2,2,2,14,5,4,-1,1,0
1003,1003,1003,1003,17,19,18,18,2,2,1,2,0,0,0,-2,1,0
328,318,304,300,14,14,13,13,1,3,2,3,10,14,4,0,1,0
810,801,801,796,14,14,13,13,1,2,2,2,9,0,5,0,1,0
871,867,871,876,18,19,20,18,3,3,1,3,4,-4,-5,-1,-1,2
731,726,721,721,17,16,18,18,2,2,2,1,5,5,0,1,-2,0
1050,1050,1045,1045,13,14,12,13,2,3,2,2,0,5,0,-1,2,-1
403,403,407,403,13,14,12,13,3,3,2,1,0,-4,4,-1,2,-1
487,482,478,473,21,19,20,21,1,1,1,2,5,4,5,2,-1,-1
440,431,431,431,13,14,12,13,1,3,3,1,9,0,0,-1,2,-1
970,1012,965,965,13,14,12,13,1,1,2,1,-42,47,0,-1,2,-1
604,586,581,590,14,14,15,13,1,2,3,1,18,5,-9,0,-1,2
581,581,581,586,18,19,18,19,4,1,1,1,0,0,-5,-1,1,-1
946,942,942,942,13,14,12,13,2,2,1,1,4,0,0,-1,2,-1
295,290,290,281,18,17,18,19,2,3,2,2,5,0,9,1,-1,-1
454,454,450,450,17,16,18,18,1,3,1,1,0,4,0,1,-2,0
192,187,1078,1078,14,14,15,16,1,1,1,1,5,-891,0,0,-1,-1
515,501,501,501,14,17,15,16,1,3,1,2,14,0,0,-3,2,-1
557,548,539,539,21,19,20,18,1,1,1,1,9,9,0,2,-1,2
417,417,417,412,17,19,18,18,1,1,2,1,0,0,5,-2,1,0
389,398,389,389,13,14,12,13,3,1,3,1,-9,9,0,-1,2,-1
229,215,215,215,14,17,15,16,1,1,1,2,14,0,0,-3,2,-1
707,703,703,698,17,16,15,16,3,2,2,2,4,0,5,1,1,-1
239,239,234,229,14,14,13,13,1,3,2,2,0,5,5,0,1,0
276,267,262,262,21,19,20,21,2,2,1,1,9,5,0,2,-1,-1
1017,1012,1017,1003,13,14,15,13,3,3,1,2,5,-5,14,-1,-1,2
937,942,937,937,13,14,12,13,1,3,3,3,-5,5,0,-1,2,-1
510,492,482,478,14,14,15,16,1,2,1,1,18,10,4,0,-1,-1
426,421,421,417,13,14,15,16,3,1,2,1,5,0,4,-1,-1,-1
309,309,309,304,14,14,13,13,2,2,1,4,0,0,5,0,1,0
182,182,182,182,21,19,21,21,1,1,1,1,0,0,0,2,-2,0
1007,998,1003,1003,17,16,18,16,2,2,4,1,9,-5,0,1,-2,2
759,750,754,754,17,16,18,16,2,2,1,1,9,-4,0,1,-2,2
529,529,539,520,14,14,13,13,2,3,1,1,0,-10,19,0,1,0
365,370,360,360,17,16,15,16,1,1,1,2,-5,10,0,1,1,-1
243,243,239,234,18,17,18,16,1,1,4,2,0,4,5,1,-1,2
890,876,867,867,18,19,18,18,1,2,2,2,14,9,0,-1,1,0
239,220,224,224,21,19,20,21,3,2,1,3,19,-4,0,2,-1,-1
360,356,351,346,13,16,15,16,3,1,2,2,4,5,5,-3,1,-1
792,787,782,787,18,17,18,19,1,1,1,1,5,5,-5,1,-1,-1
323,314,309,304,14,14,13,13,2,5,2,1,9,5,5,0,1,0
501,501,501,501,18,17,18,16,2,2,2,1,0,0,0,1,-1,2
482,482,478,473,14,14,15,13,1,1,1,2,0,4,5,0,-1,2
360,328,328,328,20,19,21,21,2,1,1,1,32,0,0,1,-2,0
210,206,206,201,14,17,15,16,2,3,2,2,4,0,5,-3,2,-1
239,229,229,229,21,19,20,21,1,1,1,2,10,0,0,2,-1,-1
590,581,576,576,18,19,18,18,2,1,2,1,9,5,0,-1,1,0
234,229,234,229,14,17,15,16,4,2,2,3,5,-5,5,-3,2,-1
689,684,689,684,20,19,20,21,1,2,1,1,5,-5,5,1,-1,-1
595,586,590,590,18,19,18,19,1,3,1,2,9,-4,0,-1,1,-1
590,581,576,576,14,14,13,13,3,3,2,1,9,5,0,0,1,0
553,557,539,543,21,19,20,18,1,1,1,1,-4,18,-4,2,-1,2
412,403,403,403,20,19,20,21,2,1,1,1,9,0,0,1,-1,-1
196,196,196,192,14,14,15,13,1,3,1,2,0,0,4,0,-1,2
524,520,515,510,14,14,15,13,2,2,2,2,4,5,5,0,-1,2
890,886,881,881,14,14,15,16,3,3,1,2,4,5,0,0,-1,-1
1026,1021,1026,1021,17,19,18,18,3,2,2,1,5,-5,5,-2,1,0
1050,1045,1045,1040,13,14,15,13,2,2,2,2,5,0,5,-1,-1,2
473,464,464,468,17,19,18,18,1,3,1,3,9,0,-4,-2,1,0
867,853,853,843,14,17,15,16,3,1,2,1,14,0,10,-3,2,-1
857,848,853,853,14,17,15,16,1,4,2,1,9,-5,0,-3,2,-1
557,553,557,553,14,14,15,16,3,3,2,1,4,-4,4,0,-1,-1
801,792,792,792,14,14,15,16,3,2,1,1,9,0,0,0,-1,-1
473,473,473,473,17,16,15,16,1,3,2,1,0,0,0,1,1,-1
210,206,206,206,14,14,15,13,3,3,2,3,4,0,0,0,-1,2
567,557,562,562,18,19,18,18,3,2,1,1,10,-5,0,-1,1,0
496,487,482,482,14,14,15,16,3,1,1,2,9,5,0,0,-1,-1
581,581,581,581,14,17,15,16,1,2,1,1,0,0,0,-3,2,-1
445,440,440,440,20,19,20,21,3,3,1,1,5,0,0,1,-1,-1
1045,1050,1045,1040,13,14,12,13,3,3,2,1,-5,5,5,-1,2,-1
839,834,839,839,21,19,20,18,1,1,3,1,5,-5,0,2,-1,2
1078,1068,1073,1078,20,19,20,18,1,2,1,1,10,-5,-5,1,-1,2
998,993,998,998,20,19,20,18,1,3,1,1,5,-5,0,1,-1,2
867,843,843,853,14,14,13,13,1,5,2,2,24,0,-10,0,1,0
468,360,464,464,17,16,18,18,3,1,3,1,108,-104,0,1,-2,0
557,557,557,553,14,17,15,16,1,1,2,1,0,0,4,-3,2,-1
890,876,881,876,18,17,18,18,1,3,3,1,14,-5,5,1,-1,0
257,257,257,253,18,19,18,18,2,1,1,2,0,0,4,-1,1,0
459,459,459,459,20,19,20,21,3,1,2,3,0,0,0,1,-1,-1
229,224,224,224,14,14,15,13,1,1,1,1,5,0,0,0,-1,2
867,862,857,857,14,14,15,13,3,2,2,2,5,5,0,0,-1,2
881,876,871,871,18,17,18,18,3,1,1,1,5,5,0,1,-1,0
829,824,820,824,14,17,15,16,1,2,1,1,5,4,-4,-3,2,-1
431,328,323,323,13,17,15,16,1,1,1,1,103,5,0,-4,2,-1
534,534,529,529,14,14,15,13,3,2,3,4,0,5,0,0,-1,2
890,886,886,881,18,17,18,19,2,1,2,1,4,0,5,1,-1,-1
543,543,543,548,18,19,18,18,2,2,1,1,0,0,-5,-1,1,0
571,562,562,557,21,19,20,21,3,2,1,2,9,0,5,2,-1,-1
614,600,782,600,14,14,18,13,1,3,1,1,14,-182,182,0,-4,5
792,787,787,787,18,17,18,19,1,1,2,1,5,0,0,1,-1,-1
389,384,389,389,17,16,15,16,3,4,2,1,5,-5,0,1,1,-1
323,318,323,318,14,14,15,13,2,4,1,2,5,-5,5,0,-1,2
520,510,510,510,18,19,18,19,1,2,2,1,10,0,0,-1,1,-1
318,323,323,318,14,17,15,16,2,3,2,2,-5,0,5,-3,2,-1
426,421,426,421,17,16,15,16,1,2,2,2,5,-5,5,1,1,-1
792,787,787,792,18,19,18,19,3,2,1,3,5,0,-5,-1,1,-1
515,520,515,510,14,14,13,13,2,3,2,4,-5,5,5,0,1,0
623,614,609,614,14,17,15,16,2,1,1,1,9,5,-5,-3,2,-1
656,651,651,651,17,16,18,18,1,2,1,1,5,0,0,1,-2,0
834,782,787,796,18,17,15,16,1,1,1,1,52,-5,-9,1,2,-1
867,862,862,862,14,14,13,13,2,2,1,1,5,0,0,0,1,0
365,360,365,356,13,14,12,13,2,3,4,2,5,-5,9,-1,2,-1
192,187,187,192,14,17,15,16,1,2,1,1,5,0,-5,-3,2,-1
600,595,595,595,18,19,18,19,2,1,1,1,5,0,0,-1,1,-1
867,867,862,862,14,17,15,16,1,2,1,1,0,5,0,-3,2,-1
815,810,815,810,21,19,20,19,2,1,2,2,5,-5,5,2,-1,1
721,707,707,707,13,14,12,13,2,2,3,1,14,0,0,-1,2,-1
693,689,693,689,17,16,18,18,3,2,4,2,4,-4,4,1,-2,0
886,871,867,867,14,14,13,13,4,3,1,1,15,4,0,0,1,0
614,614,614,614,18,19,18,19,3,1,1,1,0,0,0,-1,1,-1
1040,1040,1036,1031,20,19,18,18,3,1,1,2,0,4,5,1,1,0
206,210,206,206,14,14,15,13,2,2,1,1,-4,4,0,0,-1,2
206,192,187,187,14,17,15,16,4,2,2,1,14,5,0,-3,2,-1
234,234,224,224,18,19,18,19,1,2,2,3,0,10,0,-1,1,-1
196,196,196,196,21,19,21,21,2,2,1,1,0,0,0,2,-2,0
674,674,674,670,13,14,12,13,1,2,2,1,0,0,4,-1,2,-1
773,768,764,764,20,19,20,18,3,2,1,2,5,4,0,1,-1,2
904,895,895,900,14,17,15,16,3,2,3,1,9,0,-5,-3,2,-1
314,300,295,295,14,17,15,16,2,1,1,2,14,5,0,-3,2,-1
501,501,506,496,14,14,13,13,1,1,2,2,0,-5,10,0,1,0
824,820,820,820,18,17,18,19,2,1,1,1,4,0,0,1,-1,-1
1031,1017,1021,1017,13,14,15,16,2,6,3,1,14,-4,4,-1,-1,-1
210,206,206,201,14,14,15,16,2,1,2,2,4,0,5,0,-1,-1
187,182,1078,1073,14,17,15,16,3,1,1,2,5,-896,5,-3,2,-1
567,567,562,567,18,17,18,18,2,1,1,1,0,5,-5,1,-1,0
267,257,253,253,18,19,18,18,1,1,1,2,10,4,0,-1,1,0
843,834,824,829,18,17,18,19,1,1,3,1,9,10,-5,1,-1,-1
674,665,665,665,13,14,12,13,1,4,2,1,9,0,0,-1,2,-1
501,487,496,496,18,17,18,19,1,2,1,1,14,-9,0,1,-1,-1
506,501,496,501,14,14,13,13,2,3,2,1,5,5,-5,0,1,0
614,604,604,600,18,19,18,19,2,3,2,1,10,0,4,-1,1,-1
487,487,487,487,14,17,15,16,3,2,3,1,0,0,0,-3,2,-1
389,374,365,370,13,14,12,13,1,2,1,1,15,9,-5,-1,2,-1
764,759,759,764,13,14,12,13,1,1,1,2,5,0,-5,-1,2,-1
262,253,248,248,21,19,20,18,3,1,1,1,9,5,0,2,-1,2
876,876,871,867,18,19,20,18,2,1,3,1,0,5,4,-1,-1,2
867,867,867,862,14,17,15,16,2,1,2,2,0,0,5,-3,2,-1
974,970,970,970,13,14,12,13,3,2,3,2,4,0,0,-1,2,-1
314,309,309,309,21,19,21,21,1,1,1,1,5,0,0,2,-2,0
529,520,515,515,14,14,13,13,3,1,3,2,9,5,0,0,1,0
360,356,351,346,13,14,12,13,2,3,2,2,4,5,5,-1,2,-1
745,745,750,750,17,16,18,16,1,3,2,1,0,-5,0,1,-2,2
1040,1031,1031,1026,13,14,15,16,2,2,2,1,9,0,5,-1,-1,-1
717,712,712,712,20,19,20,18,3,2,1,1,5,0,0,1,-1,2
829,829,829,824,18,19,18,19,2,1,2,3,0,0,5,-1,1,-1
224,210,309,220,21,19,23,21,1,2,1,1,14,-99,89,2,-4,2
445,445,445,445,20,19,20,18,3,3,1,1,0,0,0,1,-1,2
726,726,726,726,17,16,15,16,1,1,2,1,0,0,0,1,1,-1
1059,1050,1054,1054,20,19,20,18,1,2,1,1,9,-4,0,1,-1,2
553,543,553,562,21,19,20,21,3,2,2,2,10,-10,-9,2,-1,-1
1078,1068,1073,1073,17,16,18,16,1,4,2,3,10,-5,0,1,-2,2
848,834,834,824,14,17,15,16,2,2,2,1,14,0,10,-3,2,-1
726,721,721,721,20,19,20,18,3,1,1,2,5,0,0,1,-1,2
262,253,253,248,21,19,20,18,1,1,2,1,9,0,5,2,-1,2
206,206,201,201,18,17,18,19,3,3,1,1,0,5,0,1,-1,-1
951,937,946,946,17,16,15,16,4,2,2,1,14,-9,0,1,1,-1
243,239,229,234,14,14,15,13,2,1,3,1,4,10,-5,0,-1,2
454,450,445,445,17,19,18,18,2,3,1,1,4,5,0,-2,1,0
1054,1045,1050,1050,20,19,20,21,1,1,1,2,9,-5,0,1,-1,-1
689,679,684,679,13,14,15,16,1,2,2,1,10,-5,5,-1,-1,-1
201,196,196,187,14,14,13,13,2,2,1,2,5,0,9,0,1,0
787,782,787,778,14,14,15,16,1,2,2,1,5,-5,9,0,-1,-1
637,623,623,623,13,14,15,13,2,2,1,1,14,0,0,-1,-1,2
524,524,520,520,18,19,18,19,3,1,3,1,0,4,0,-1,1,-1
1012,1003,998,1003,20,19,20,21,2,2,3,1,9,5,-5,1,-1,-1
346,337,337,332,13,16,15,16,1,2,2,1,9,0,5,-3,1,-1
609,595,600,595,14,17,15,16,3,3,1,2,14,-5,5,-3,2,-1
717,707,703,712,13,14,12,13,3,4,3,3,10,4,-9,-1,2,-1
1040,970,960,960,13,14,15,13,1,1,1,1,70,10,0,-1,-1,2
309,309,309,300,14,14,15,16,1,1,3,2,0,0,9,0,-1,-1
853,843,848,843,14,14,15,13,1,2,2,3,10,-5,5,0,-1,2
290,281,286,281,14,14,13,13,2,2,1,2,9,-5,5,0,1,0
1059,1050,1050,1050,17,19,18,18,2,1,2,3,9,0,0,-2,1,0
881,871,871,871,18,17,18,16,1,1,2,1,10,0,0,1,-1,2
351,342,346,342,17,16,18,16,3,2,1,2,9,-4,4,1,-2,2
904,904,900,900,18,17,18,19,3,2,1,1,0,4,0,1,-1,-1
900,993,871,871,18,19,18,18,3,1,1,2,-93,122,0,-1,1,0
740,736,736,731,13,14,12,13,1,2,2,1,4,0,5,-1,2,-1
496,492,492,487,18,17,18,16,1,3,2,1,4,0,5,1,-1,2
1007,1003,1003,998,17,16,18,16,3,1,2,2,4,0,5,1,-2,2
501,487,492,487,14,14,15,16,4,2,2,1,14,-5,5,0,-1,-1
426,417,417,417,13,14,12,13,2,3,1,2,9,0,0,-1,2,-1
239,234,229,229,14,14,13,13,2,1,1,2,5,5,0,0,1,0
571,557,543,548,14,14,13,13,2,2,1,2,14,14,-5,0,1,0
539,529,524,520,21,19,20,21,2,1,1,2,10,5,4,2,-1,-1
300,295,290,286,14,14,15,13,2,3,1,2,5,5,4,0,-1,2
360,356,356,356,13,14,15,13,3,2,1,1,4,0,0,-1,-1,2
187,192,192,192,21,19,21,21,1,3,1,2,-5,0,0,2,-2,0
215,206,210,206,18,19,18,19,3,1,1,1,9,-4,4,-1,1,-1
787,778,778,773,21,19,20,21,1,1,1,2,9,0,5,2,-1,-1
234,234,229,229,14,17,15,16,2,3,1,1,0,5,0,-3,2,-1
243,239,234,234,18,19,18,18,3,3,1,1,4,5,0,-1,1,0
257,253,248,248,14,14,13,13,2,1,1,3,4,5,0,0,1,0
768,768,764,754,17,16,18,16,1,1,2,2,0,4,10,1,-2,2
820,815,810,815,14,14,13,13,2,5,1,1,5,5,-5,0,1,0
389,379,379,384,13,16,15,16,1,4,2,1,10,0,-5,-3,1,-1
909,904,904,895,18,17,18,19,1,1,2,1,5,0,9,1,-1,-1
239,224,229,229,14,14,15,16,2,4,3,1,15,-5,0,0,-1,-1
464,454,454,454,13,14,12,13,1,2,2,3,10,0,0,-1,2,-1
693,684,679,679,13,14,15,13,2,3,3,2,9,5,0,-1,-1,2
656,656,660,656,13,14,15,13,1,2,2,2,0,-4,4,-1,-1,2
989,979,979,974,17,16,18,16,1,1,2,1,10,0,5,1,-2,2
721,717,717,721,13,14,12,13,5,3,2,2,4,0,-4,-1,2,-1
1017,1012,1012,1007,20,19,18,18,1,2,6,1,5,0,5,1,1,0
1054,1045,1045,1045,13,14,12,13,1,6,1,1,9,0,0,-1,2,-1
520,506,501,501,18,19,18,19,3,2,2,1,14,5,0,-1,1,-1
1021,1012,1012,1003,13,16,15,16,1,1,2,2,9,0,9,-3,1,-1
407,403,393,389,13,16,15,16,1,2,2,2,4,10,4,-3,1,-1
262,257,257,257,18,17,18,18,3,3,1,1,5,0,0,1,-1,0
942,942,937,937,13,14,12,13,1,3,1,1,0,5,0,-1,2,-1
206,196,192,192,14,17,15,16,4,1,1,3,10,4,0,-3,2,-1
731,726,731,731,17,16,18,16,3,2,1,1,5,-5,0,1,-2,2
600,600,604,600,18,19,18,19,1,3,2,1,0,-4,4,-1,1,-1
623,623,628,623,21,19,21,21,1,3,1,3,0,-5,5,2,-2,0
1012,1003,1017,1017,20,19,18,18,1,4,1,2,9,-14,0,1,1,0
1059,1050,1050,1050,20,19,20,18,2,3,1,1,9,0,0,1,-1,2
942,937,942,942,13,14,15,13,3,1,2,2,5,-5,0,-1,-1,2
693,689,689,684,13,14,12,13,3,3,2,3,4,0,5,-1,2,-1
801,796,792,787,14,14,13,13,1,3,3,2,5,4,5,0,1,0
656,656,656,656,20,19,18,18,1,2,2,1,0,0,0,1,1,0
876,871,871,867,18,17,18,16,2,1,1,3,5,0,4,1,-1,2
600,600,600,595,14,14,15,13,2,3,2,2,0,0,5,0,-1,2
304,300,300,295,18,19,18,19,2,1,2,2,4,0,5,-1,1,-1
393,398,393,393,13,14,12,13,4,5,2,2,-5,5,0,-1,2,-1
796,792,796,796,18,17,18,16,1,2,1,3,4,-4,0,1,-1,2
623,618,618,614,18,17,18,16,2,2,2,1,5,0,4,1,-1,2
337,332,328,323,17,16,15,16,1,2,1,1,5,4,5,1,1,-1
853,848,848,843,14,14,13,13,2,5,3,2,5,0,5,0,1,0
703,703,698,698,17,16,18,18,1,1,1,2,0,5,0,1,-2,0
501,501,496,496,14,17,15,16,1,3,4,1,0,5,0,-3,2,-1
506,496,501,496,14,17,15,16,1,2,2,1,10,-5,5,-3,2,-1
604,595,595,595,14,14,13,13,3,1,3,1,9,0,0,0,1,0
834,824,829,829,21,19,20,21,1,2,1,1,10,-5,0,2,-1,-1
660,646,646,642,13,14,12,13,1,2,2,2,14,0,4,-1,2,-1
290,290,290,286,14,14,13,13,4,3,2,2,0,0,4,0,1,0
937,923,928,206,17,17,18,16,2,3,1,1,14,-5,722,0,-1,2
529,524,524,524,21,19,20,21,1,1,1,1,5,0,0,2,-1,-1
914,914,914,914,18,17,18,19,1,2,1,1,0,0,0,1,-1,-1
562,562,562,562,18,17,18,16,2,2,1,1,0,0,0,1,-1,2
196,192,192,187,14,14,15,13,1,3,1,2,4,0,5,0,-1,2
520,515,520,515,14,17,15,16,2,2,1,1,5,-5,5,-3,2,-1
848,843,843,839,14,14,13,13,2,3,1,2,5,0,4,0,1,0
1059,1054,1054,1054,17,16,18,16,3,2,2,1,5,0,0,1,-2,2
492,487,487,487,14,14,15,13,1,1,3,1,5,0,0,0,-1,2
323,314,314,314,14,17,15,16,1,3,1,1,9,0,0,-3,2,-1
853,848,848,848,21,19,20,18,2,2,1,1,5,0,0,2,-1,2
431,426,426,421,17,16,15,16,1,1,2,2,5,0,5,1,1,-1
267,257,253,253,18,17,18,18,2,1,1,1,10,4,0,1,-1,0
637,628,628,623,17,17,18,19,2,1,1,1,9,0,5,0,-1,-1
853,843,848,843,14,17,15,16,1,1,2,1,10,-5,5,-3,2,-1
571,571,567,567,14,17,15,16,2,1,3,3,0,4,0,-3,2,-1
1054,1050,1040,1045,13,14,15,13,2,1,2,2,4,10,-5,-1,-1,2
960,956,956,951,20,19,18,18,2,1,1,5,4,0,5,1,1,0
984,979,979,979,13,14,15,13,1,2,1,2,5,0,0,-1,-1,2
473,473,468,468,17,16,18,16,1,1,1,1,0,5,0,1,-2,2
923,909,914,909,14,17,15,16,1,2,5,3,14,-5,5,-3,2,-1
960,956,956,956,20,19,20,18,2,1,1,1,4,0,0,1,-1,2
801,801,796,792,14,14,15,16,2,3,1,1,0,5,4,0,-1,-1
215,206,220,210,18,17,18,19,1,2,2,1,9,-14,10,1,-1,-1
993,979,984,984,13,14,15,16,1,2,2,2,14,-5,0,-1,-1,-1
492,492,492,487,14,14,13,13,1,2,1,1,0,0,5,0,1,0
295,281,271,267,14,14,15,13,3,2,1,4,14,10,4,0,-1,2
229,220,220,220,14,14,15,13,3,3,2,2,9,0,0,0,-1,2
187,182,1078,1073,21,19,20,18,1,1,1,2,5,-896,5,2,-1,2
1003,998,998,993,17,16,15,16,3,2,2,1,5,0,5,1,1,-1
431,426,426,421,20,19,18,18,2,2,1,2,5,0,5,1,1,0
309,300,300,300,21,19,20,19,3,2,1,2,9,0,0,2,-1,1
300,295,295,295,14,17,15,16,3,2,3,5,5,0,0,-3,2,-1
262,262,262,262,18,19,18,18,1,1,1,1,0,0,0,-1,1,0
365,360,351,356,13,14,12,13,1,4,3,1,5,9,-5,-1,2,-1
909,895,904,904,14,14,15,16,1,2,3,3,14,-9,0,0,-1,-1
586,571,576,576,14,17,15,16,3,2,1,2,15,-5,0,-3,2,-1
426,421,421,417,20,19,18,18,2,2,2,2,5,0,4,1,1,0
210,210,206,206,18,17,18,19,3,2,1,1,0,4,0,1,-1,-1
843,848,848,843,14,17,15,16,3,5,2,3,-5,0,5,-3,2,-1
839,834,834,834,18,17,18,18,1,3,1,1,5,0,0,1,-1,0
843,834,834,834,21,19,20,18,3,1,1,1,9,0,0,2,-1,2
890,886,886,881,14,14,13,13,2,3,2,3,4,0,5,0,1,0
553,548,543,543,18,19,18,18,1,2,1,2,5,5,0,-1,1,0
1078,1073,1068,1073,20,19,20,18,1,2,3,2,5,5,-5,1,-1,2
571,557,548,548,18,19,18,18,3,1,3,1,14,9,0,-1,1,0
721,717,721,721,17,16,15,16,1,2,3,1,4,-4,0,1,1,-1
581,576,581,571,18,17,18,16,1,2,2,1,5,-5,10,1,-1,2
960,956,960,960,20,19,18,18,1,2,2,1,4,-4,0,1,1,0
787,782,778,768,14,17,15,16,3,2,1,2,5,4,10,-3,2,-1
801,796,792,792,14,14,15,13,3,3,1,1,5,4,0,0,-1,2
932,923,923,918,17,17,15,16,1,2,2,2,9,0,5,0,2,-1
834,834,834,829,21,19,20,21,1,1,2,1,0,0,5,2,-1,-1
642,637,637,632,13,14,15,16,2,1,3,1,5,0,5,-1,-1,-1
900,900,895,895,18,19,18,19,2,2,1,2,0,5,0,-1,1,-1
224,215,201,201,14,14,13,13,1,3,3,3,9,14,0,0,1,0
946,937,937,928,13,14,12,13,2,2,2,1,9,0,9,-1,2,-1
398,393,398,398,13,16,15,16,1,1,4,1,5,-5,0,-3,1,-1
365,370,360,360,20,19,20,18,1,1,1,1,-5,10,0,1,-1,2
618,609,614,614,18,17,18,19,2,1,4,1,9,-5,0,1,-1,-1
590,590,586,586,18,19,18,19,3,1,1,1,0,4,0,-1,1,-1
314,309,309,304,18,19,18,19,2,3,2,1,5,0,5,-1,1,-1
1045,1031,1031,1031,13,14,15,13,2,2,3,2,14,0,0,-1,-1,2
1040,1040,1036,1064,17,16,18,18,1,1,1,2,0,4,-28,1,-2,0
1078,1073,1073,1073,20,19,20,18,1,2,3,1,5,0,0,1,-1,2
407,407,407,403,17,16,18,16,3,5,2,2,0,0,4,1,-2,2
234,229,253,262,21,19,20,21,2,3,1,1,5,-24,-9,2,-1,-1
215,206,210,206,14,14,13,13,3,2,2,2,9,-4,4,0,1,0
1064,1054,1050,1054,13,14,12,13,2,4,3,1,10,4,-4,-1,2,-1
684,674,674,674,13,14,15,13,1,3,1,1,10,0,0,-1,-1,2
1068,1064,1064,1059,13,14,12,13,2,1,1,2,4,0,5,-1,2,-1
515,510,510,510,14,14,15,13,1,2,1,3,5,0,0,0,-1,2
740,740,731,726,13,14,12,13,2,3,2,3,0,9,5,-1,2,-1
412,412,412,407,17,16,15,16,1,1,2,2,0,0,5,1,1,-1
1017,1012,210,1012,17,16,18,16,1,1,1,1,5,802,-802,1,-2,2
960,951,951,951,20,19,18,18,2,1,1,1,9,0,0,1,1,0
754,745,750,750,13,14,12,13,3,2,1,3,9,-5,0,-1,2,-1
1059,1054,1054,1045,13,14,15,13,2,3,2,2,5,0,9,-1,-1,2
290,281,286,286,18,17,18,16,1,1,2,2,9,-5,0,1,-1,2
187,187,182,182,18,19,18,19,2,1,1,1,0,5,0,-1,1,-1
1003,1003,1003,1003,13,14,12,13,3,1,1,1,0,0,0,-1,2,-1
389,389,384,379,13,14,15,13,2,3,5,2,0,5,5,-1,-1,2
623,623,623,623,14,14,15,13,2,1,2,3,0,0,0,0,-1,2
253,243,243,248,14,17,15,16,2,2,3,1,10,0,-5,-3,2,-1
557,553,557,553,18,19,18,18,3,2,2,2,4,-4,4,-1,1,0
356,286,281,286,13,14,15,13,1,2,1,1,70,5,-5,-1,-1,2
914,909,904,900,21,19,20,21,1,1,3,2,5,5,4,2,-1,-1
773,768,764,764,17,16,18,18,4,2,1,1,5,4,0,1,-2,0
543,539,539,539,18,19,18,18,1,1,3,1,4,0,0,-1,1,0
881,876,876,876,18,17,18,16,2,1,1,2,5,0,0,1,-1,2
271,267,267,262,14,14,15,13,2,1,2,1,4,0,5,0,-1,2
534,529,529,529,18,19,18,19,2,1,2,1,5,0,0,-1,1,-1
900,890,886,881,18,19,18,19,1,2,1,1,10,4,5,-1,1,-1
234,229,234,234,14,17,15,16,3,4,2,1,5,-5,0,-3,2,-1
815,810,806,806,18,19,18,19,1,2,1,2,5,4,0,-1,1,-1
473,468,468,468,20,19,20,21,3,2,1,1,5,0,0,1,-1,-1
698,693,693,693,20,19,20,18,2,1,3,1,5,0,0,1,-1,2
886,881,881,881,18,19,18,19,2,2,1,1,5,0,0,-1,1,-1
342,337,337,337,17,16,15,16,2,1,2,1,5,0,0,1,1,-1
426,421,417,417,13,14,12,13,2,3,1,2,5,4,0,-1,2,-1
300,286,295,295,21,19,20,19,1,3,1,1,14,-9,0,2,-1,1
787,773,778,773,18,19,18,18,1,2,1,2,14,-5,5,-1,1,0
1054,1054,1050,1054,20,19,20,18,2,1,1,3,0,4,-4,1,-1,2
834,834,829,834,18,19,18,18,2,3,4,1,0,5,-5,-1,1,0
374,356,351,356,13,14,15,13,2,3,2,1,18,5,-5,-1,-1,2
210,201,206,206,14,14,13,13,2,1,3,3,9,-5,0,0,1,0
239,224,229,224,18,17,18,19,1,2,2,1,15,-5,5,1,-1,-1
379,374,370,370,13,14,12,13,2,1,3,1,5,4,0,-1,2,-1
731,726,731,726,13,14,15,13,3,3,1,1,5,-5,5,-1,-1,2
989,974,974,979,17,16,15,16,2,2,1,3,15,0,-5,1,1,-1
229,215,215,215,14,14,13,13,1,2,2,1,14,0,0,0,1,0
426,426,421,421,20,19,18,18,1,1,3,2,0,5,0,1,1,0
426,431,421,421,13,14,12,13,1,3,1,1,-5,10,0,-1,2,-1
196,187,187,187,14,14,15,13,2,2,1,1,9,0,0,0,-1,2
576,571,571,571,18,19,18,18,1,2,1,1,5,0,0,-1,1,0
581,562,553,553,18,19,18,18,3,3,3,3,19,9,0,-1,1,0
464,459,464,468,20,19,18,18,2,2,1,1,5,-5,-4,1,1,0
1064,1059,1059,1059,20,19,18,18,1,2,1,2,5,0,0,1,1,0
506,501,492,496,18,17,18,16,1,3,3,1,5,9,-4,1,-1,2
890,886,886,890,21,19,20,19,1,2,1,2,4,0,-4,2,-1,1
267,257,257,253,18,17,18,18,3,2,3,2,10,0,4,1,-1,0
365,370,365,365,17,16,15,16,3,1,2,1,-5,5,0,1,1,-1
829,820,820,815,18,19,18,19,2,1,3,2,9,0,5,-1,1,-1
417,407,417,412,17,16,18,16,2,1,2,2,10,-10,5,1,-2,2
262,253,257,262,21,19,20,18,2,2,1,1,9,-4,-5,2,-1,2
1026,1026,1021,1017,17,16,18,18,2,1,2,2,0,5,4,1,-2,0
1040,1036,1031,1031,17,16,18,16,3,1,1,1,4,5,0,1,-2,2
290,281,754,281,18,17,20,16,1,3,1,1,9,-473,473,1,-3,4
712,707,703,703,13,14,15,13,2,3,1,1,5,4,0,-1,-1,2
1040,1036,1036,1031,17,16,18,16,2,3,2,1,4,0,5,1,-2,2
764,759,754,754,13,16,15,16,1,1,2,2,5,5,0,-3,1,-1
721,712,712,712,13,14,15,16,1,2,3,1,9,0,0,-1,-1,-1
257,248,253,248,18,19,18,18,1,3,2,2,9,-5,5,-1,1,0
239,229,220,215,14,17,15,16,1,2,3,2,10,9,5,-3,2,-1
843,839,839,834,14,14,15,16,1,2,3,2,4,0,5,0,-1,-1
642,642,642,642,17,19,18,18,5,1,3,1,0,0,0,-2,1,0
989,974,993,974,13,14,15,13,2,1,2,2,15,-19,19,-1,-1,2
328,323,318,314,18,17,18,16,1,1,1,2,5,5,4,1,-1,2
796,801,796,792,18,17,18,19,2,1,1,2,-5,5,4,1,-1,-1
1073,1068,1073,1068,13,16,15,16,2,1,2,1,5,-5,5,-3,1,-1
468,464,464,459,13,14,15,16,3,2,1,1,4,0,5,-1,-1,-1
834,829,829,829,18,19,18,19,1,2,2,1,5,0,0,-1,1,-1
778,768,773,768,13,14,12,13,2,2,3,5,10,-5,5,-1,2,-1
215,210,206,206,18,19,18,19,1,2,3,2,5,4,0,-1,1,-1
778,768,773,773,13,14,15,13,2,1,1,1,10,-5,0,-1,-1,2
1007,1007,1007,1003,13,14,12,13,4,3,2,2,0,0,4,-1,2,-1
693,689,689,684,20,19,20,18,1,2,1,1,4,0,5,1,-1,2
909,909,914,909,14,17,15,16,2,3,2,2,0,-5,5,-3,2,-1
918,909,904,904,14,14,15,13,2,3,1,1,9,5,0,0,-1,2
253,248,253,248,14,14,13,13,3,2,3,1,5,-5,5,0,1,0
454,450,478,445,13,14,13,13,1,3,2,4,4,-28,33,-1,1,0
642,637,632,632,17,16,18,16,2,2,1,2,5,5,0,1,-2,2
773,768,768,768,20,19,20,18,3,2,1,1,5,0,0,1,-1,2
473,459,464,468,17,16,18,18,1,2,1,1,14,-5,-4,1,-2,0
210,196,201,206,21,19,21,21,1,3,1,1,14,-5,-5,2,-2,0
206,201,201,201,18,17,18,19,3,1,2,1,5,0,0,1,-1,-1
304,295,295,295,18,17,18,16,2,2,1,1,9,0,0,1,-1,2
389,374,370,370,13,14,12,13,2,3,4,1,15,4,0,-1,2,-1
886,886,890,881,14,14,13,13,2,1,2,1,0,-4,9,0,1,0
248,243,248,243,14,14,13,13,1,2,1,2,5,-5,5,0,1,0
937,937,932,932,20,19,18,18,1,1,1,1,0,5,0,1,1,0
829,824,820,824,14,14,15,16,3,3,1,1,5,4,-4,0,-1,-1
829,829,824,824,14,17,15,16,1,1,1,2,0,5,0,-3,2,-1
412,403,403,407,17,16,18,18,3,2,1,1,9,0,-4,1,-2,0
436,436,436,436,20,19,20,21,2,3,1,1,0,0,0,1,-1,-1
1050,1050,1050,1054,20,19,18,18,1,1,1,1,0,0,-4,1,1,0
370,360,365,365,13,14,12,13,2,2,1,1,10,-5,0,-1,2,-1
224,309,220,215,18,19,18,16,2,2,3,2,-85,89,5,-1,1,2
398,389,389,389,17,19,18,18,1,2,1,1,9,0,0,-2,1,0
829,829,824,824,18,19,18,19,3,2,1,2,0,5,0,-1,1,-1
848,839,839,839,14,17,15,16,2,2,2,2,9,0,0,-3,2,-1
993,984,989,984,17,16,18,16,1,2,1,3,9,-5,5,1,-2,2
192,187,187,187,18,17,15,16,1,2,1,1,5,0,0,1,2,-1
834,815,815,810,14,14,13,13,2,5,2,1,19,0,5,0,1,0
267,257,257,257,21,19,20,18,1,3,1,3,10,0,0,2,-1,2
942,937,937,932,13,14,15,16,1,2,2,1,5,0,5,-1,-1,-1
206,201,206,201,18,19,18,19,3,1,2,1,5,-5,5,-1,1,-1
684,679,684,684,13,14,15,13,1,1,2,1,5,-5,0,-1,-1,2
839,820,815,820,14,14,13,13,1,1,3,1,19,5,-5,0,1,0
553,548,548,553,14,14,15,13,1,2,1,1,5,0,-5,0,-1,2
501,501,501,501,18,17,18,19,2,1,1,1,0,0,0,1,-1,-1
721,707,717,721,13,14,12,13,4,1,2,3,14,-10,-4,-1,2,-1
187,187,187,182,18,19,18,19,1,1,2,2,0,0,5,-1,1,-1
595,590,586,604,18,17,18,16,3,2,4,2,5,4,-18,1,-1,2
717,712,707,707,17,19,18,18,4,2,1,2,5,5,0,-2,1,0
586,576,581,581,14,14,15,13,1,2,2,1,10,-5,0,0,-1,2
1007,998,998,998,17,19,18,18,1,2,1,2,9,0,0,-2,1,0
595,590,586,586,14,14,15,13,1,2,1,1,5,4,0,0,-1,2
524,524,524,520,21,19,20,19,2,1,1,2,0,0,4,2,-1,1
773,773,1003,773,17,16,23,16,1,2,1,1,0,-230,230,1,-7,7
586,586,581,581,18,19,18,19,3,1,1,3,0,5,0,-1,1,-1
281,276,271,276,14,14,13,13,3,3,3,1,5,5,-5,0,1,0
1003,1003,998,998,13,14,15,13,2,1,1,1,0,5,0,-1,-1,2
646,637,642,637,13,16,15,16,2,2,2,3,9,-5,5,-3,1,-1
764,759,754,754,17,16,18,18,1,2,5,1,5,5,0,1,-2,0
942,932,937,932,13,14,15,13,2,1,2,1,10,-5,5,-1,-1,2
374,370,370,370,13,14,15,13,3,1,1,1,4,0,0,-1,-1,2
473,473,468,468,20,19,18,18,3,1,1,3,0,5,0,1,1,0
309,309,304,309,14,14,15,13,1,4,1,1,0,5,-5,0,-1,2
520,515,515,515,14,14,15,13,2,2,3,2,5,0,0,0,-1,2
932,932,937,923,17,16,15,16,1,1,2,2,0,-5,14,1,1,-1
674,670,670,665,13,16,15,16,1,3,2,2,4,0,5,-3,1,-1
684,684,679,679,17,16,18,18,3,3,2,1,0,5,0,1,-2,0
398,389,384,389,17,16,18,18,2,2,1,1,9,5,-5,1,-2,0
1040,1031,1036,1036,17,16,18,16,2,2,3,1,9,-5,0,1,-2,2
745,740,740,736,17,16,18,18,1,2,1,3,5,0,4,1,-2,0
750,740,740,736,13,14,12,13,4,2,2,2,10,0,4,-1,2,-1
196,192,187,187,18,17,18,16,1,3,3,1,4,5,0,1,-1,2
529,524,524,520,18,17,18,19,3,1,2,1,5,0,4,1,-1,-1
721,721,712,712,20,19,20,21,3,3,1,2,0,9,0,1,-1,-1
928,918,918,914,14,14,13,13,1,4,1,3,10,0,4,0,1,0
857,848,848,843,21,19,20,18,1,4,1,3,9,0,5,2,-1,2
1073,1068,1068,1068,13,16,15,16,1,1,4,1,5,0,0,-3,1,-1
417,407,412,407,20,19,20,21,2,1,2,2,10,-5,5,1,-1,-1
374,370,374,365,13,14,12,13,1,2,2,2,4,-4,9,-1,2,-1
665,656,656,656,17,16,18,18,1,2,1,1,9,0,0,1,-2,0
553,543,548,543,18,17,18,16,3,2,3,2,10,-5,5,1,-1,2
257,253,248,253,21,19,20,18,2,2,1,1,4,5,-5,2,-1,2
890,881,881,876,21,19,20,18,1,1,2,1,9,0,5,2,-1,2
412,403,403,398,13,14,12,13,2,3,2,1,9,0,5,-1,2,-1
604,600,600,600,21,19,20,21,1,1,1,1,4,0,0,2,-1,-1
829,810,806,806,14,17,15,16,3,2,2,1,19,4,0,-3,2,-1
468,464,459,464,20,19,20,21,1,2,3,2,4,5,-5,1,-1,-1
229,1068,1064,1059,14,14,15,13,1,3,1,1,-839,4,5,0,-1,2
215,201,196,192,14,14,13,13,1,2,2,1,14,5,4,0,1,0
295,290,290,290,18,17,18,16,1,3,2,1,5,0,0,1,-1,2
304,300,300,295,14,17,15,16,1,3,3,1,4,0,5,-3,2,-1
1017,1007,1007,1007,17,16,18,18,3,2,1,3,10,0,0,1,-2,0
492,482,482,487,21,19,21,21,1,2,1,1,10,0,-5,2,-2,0
253,253,248,253,18,19,18,18,2,1,1,1,0,5,-5,-1,1,0
886,881,886,881,14,17,15,16,3,3,2,1,5,-5,5,-3,2,-1
304,295,295,295,14,14,13,13,1,2,1,4,9,0,0,0,1,0
914,914,909,909,18,19,18,19,2,1,1,3,0,5,0,-1,1,-1
304,304,309,304,18,19,21,19,4,3,2,2,0,-5,5,-1,-2,2
562,562,562,557,14,14,13,13,2,3,1,2,0,0,5,0,1,0
543,543,548,548,18,19,18,18,3,2,1,1,0,-5,0,-1,1,0
370,360,360,360,20,19,20,21,2,1,1,2,10,0,0,1,-1,-1
637,632,637,632,20,19,20,21,3,1,1,1,5,-5,5,1,-1,-1
965,960,951,946,20,19,20,18,2,1,3,2,5,9,5,1,-1,2
421,417,412,412,13,14,15,16,1,3,1,1,4,5,0,-1,-1,-1
1036,1031,1017,1017,13,14,12,13,1,3,3,1,5,14,0,-1,2,-1
928,918,923,918,14,14,15,16,1,2,2,2,10,-5,5,0,-1,-1
412,412,412,398,20,19,18,18,1,3,2,2,0,0,14,1,1,0
1036,1036,1036,1031,17,16,18,18,1,2,3,1,0,0,5,1,-2,0
693,684,684,693,13,14,15,13,2,1,3,4,9,0,-9,-1,-1,2
248,239,239,239,18,17,18,18,3,2,1,1,9,0,0,1,-1,0
337,332,328,323,20,19,21,19,1,1,1,2,5,4,5,1,-2,2
970,960,970,960,17,16,18,18,2,1,2,4,10,-10,10,1,-2,0
768,759,764,759,20,19,20,18,2,2,1,1,9,-5,5,1,-1,2
351,346,346,346,17,16,18,16,1,1,1,1,5,0,0,1,-2,2
1068,1064,1064,1064,13,16,15,16,3,2,1,1,4,0,0,-3,1,-1
834,834,829,829,14,17,15,16,1,1,1,1,0,5,0,-3,2,-1
337,337,337,332,13,14,15,13,1,1,2,1,0,0,5,-1,-1,2
403,407,403,403,13,14,15,13,3,2,2,2,-4,4,0,-1,-1,2
468,464,464,468,17,16,18,16,1,2,1,3,4,0,-4,1,-2,2
736,726,726,731,20,19,20,18,1,2,1,1,10,0,-5,1,-1,2
342,337,332,337,17,16,18,16,1,2,1,1,5,5,-5,1,-2,2
248,243,243,243,21,19,20,18,1,1,1,1,5,0,0,2,-1,2
187,187,187,187,14,17,15,16,1,2,2,1,0,0,0,-3,2,-1
571,567,567,567,14,14,15,16,1,2,2,2,4,0,0,0,-1,-1
712,712,712,712,20,19,18,18,2,1,2,1,0,0,0,1,1,0
656,646,651,651,17,16,18,18,2,2,1,1,10,-5,0,1,-2,0
740,736,740,736,13,14,12,13,1,2,3,3,4,-4,4,-1,2,-1
1068,1064,1059,1064,17,16,18,18,2,2,1,1,4,5,-5,1,-2,0
496,492,492,492,18,17,18,16,2,2,2,1,4,0,0,1,-1,2
571,562,562,557,14,17,15,16,2,1,1,1,9,0,5,-3,2,-1
1045,1040,1036,1040,17,16,15,16,1,1,5,1,5,4,-4,1,1,-1
510,492,501,510,14,14,15,13,3,2,2,1,18,-9,-9,0,-1,2
281,276,281,276,18,19,18,18,1,1,1,1,5,-5,5,-1,1,0
262,262,262,393,18,17,18,16,2,1,2,1,0,0,-131,1,-1,2
642,637,637,637,13,14,15,13,3,3,2,1,5,0,0,-1,-1,2
609,604,609,600,14,14,15,13,3,1,2,3,5,-5,9,0,-1,2
407,407,403,403,20,19,20,21,3,1,1,2,0,4,0,1,-1,-1
318,314,314,314,18,17,18,16,1,1,1,1,4,0,0,1,-1,2
571,576,571,567,14,14,15,13,2,1,1,1,-5,5,4,0,-1,2
984,979,970,960,13,14,12,13,3,4,2,2,5,9,10,-1,2,-1
886,876,881,876,14,14,15,13,1,2,3,3,10,-5,5,0,-1,2
909,900,909,900,14,14,15,16,2,2,2,1,9,-9,9,0,-1,-1
360,351,356,356,20,19,20,21,2,2,1,1,9,-5,0,1,-1,-1
431,417,412,412,13,16,15,16,3,2,1,1,14,5,0,-3,1,-1
267,267,262,262,21,19,20,18,1,1,1,1,0,5,0,2,-1,2
754,745,745,736,13,14,12,13,2,1,1,3,9,0,9,-1,2,-1
895,895,895,895,14,17,15,16,2,2,1,1,0,0,0,-3,2,-1
318,314,314,309,14,14,13,13,3,3,2,3,4,0,5,0,1,0
637,632,637,632,17,16,18,16,2,1,2,2,5,-5,5,1,-2,2
731,721,726,721,13,16,15,16,2,1,1,3,10,-5,5,-3,1,-1
393,393,393,389,17,16,15,16,3,1,2,2,0,0,4,1,1,-1
806,801,806,801,18,19,18,19,3,2,2,1,5,-5,5,-1,1,-1
581,571,567,567,21,19,20,18,1,1,1,1,10,4,0,2,-1,2
989,979,979,979,17,16,18,16,2,2,2,1,10,0,0,1,-2,2
557,553,548,548,18,19,18,18,3,1,1,1,4,5,0,-1,1,0
792,792,787,787,14,17,15,16,2,1,2,1,0,5,0,-3,2,-1
384,374,374,370,13,14,15,13,2,2,1,2,10,0,4,-1,-1,2
918,923,918,918,14,17,15,16,2,1,3,1,-5,5,0,-3,2,-1
787,787,778,773,21,19,20,21,2,1,1,2,0,9,5,2,-1,-1
764,750,745,745,17,19,18,18,2,2,2,1,14,5,0,-2,1,0
492,482,478,478,14,14,15,13,3,1,1,1,10,4,0,0,-1,2
224,220,220,215,14,17,15,16,2,3,3,1,4,0,5,-3,2,-1
965,956,956,951,20,19,20,18,2,1,2,2,9,0,5,1,-1,2
459,454,454,450,17,16,18,16,2,2,1,2,5,0,4,1,-2,2
356,351,356,356,20,19,20,18,1,1,2,1,5,-5,0,1,-1,2
281,281,276,276,14,17,15,16,3,2,1,1,0,5,0,-3,2,-1
721,717,712,712,20,19,20,21,3,1,1,1,4,5,0,1,-1,-1
693,698,693,698,17,16,18,18,1,1,1,1,-5,5,-5,1,-2,0
937,937,937,937,20,19,20,18,1,1,2,1,0,0,0,1,-1,2
468,473,473,468,13,14,15,13,3,3,2,3,-5,0,5,-1,-1,2
721,717,721,717,20,19,20,18,1,2,2,3,4,-4,4,1,-1,2
187,182,1078,1078,14,14,13,13,1,2,1,1,5,-896,0,0,1,0
1054,1045,1050,1045,17,16,18,18,1,2,2,2,9,-5,5,1,-2,0
323,323,323,323,18,17,18,16,2,2,3,2,0,0,0,1,-1,2
965,960,965,960,20,19,20,18,1,2,1,2,5,-5,5,1,-1,2
576,567,567,567,21,19,20,18,3,3,1,1,9,0,0,2,-1,2
210,206,206,206,18,19,18,19,2,2,1,1,4,0,0,-1,1,-1
946,942,942,942,13,14,15,16,2,2,2,1,4,0,0,-1,-1,-1
529,529,529,524,21,19,20,21,1,2,1,2,0,0,5,2,-1,-1
295,295,300,300,14,14,13,13,4,2,1,2,0,-5,0,0,1,0
389,384,384,384,13,14,15,13,1,2,1,3,5,0,0,-1,-1,2
937,932,937,932,17,16,15,16,2,1,2,1,5,-5,5,1,1,-1
890,871,871,871,14,14,15,13,1,2,2,1,19,0,0,0,-1,2
679,674,670,674,20,19,20,18,1,2,1,1,5,4,-4,1,-1,2
426,421,421,421,20,19,18,18,1,3,2,1,5,0,0,1,1,0
764,754,759,754,17,16,15,16,3,2,2,1,10,-5,5,1,1,-1
656,646,651,660,20,19,20,18,2,1,1,1,10,-5,-9,1,-1,2
192,187,1073,1073,18,19,18,18,3,1,1,1,5,-886,0,-1,1,0
946,937,942,937,17,16,18,16,3,2,2,3,9,-5,5,1,-2,2
464,464,459,459,20,19,20,18,4,1,2,1,0,5,0,1,-1,2
693,689,693,689,20,19,20,21,1,1,2,1,4,-4,4,1,-1,-1
1045,1045,1040,1045,13,14,15,16,1,3,1,1,0,5,-5,-1,-1,-1
215,984,979,974,18,16,18,18,1,1,2,3,-769,5,5,2,-2,0
881,871,876,871,18,19,18,18,1,4,2,2,10,-5,5,-1,1,0
482,473,473,473,14,16,15,16,1,2,3,1,9,0,0,-2,1,-1
731,726,721,721,17,19,18,18,1,1,1,1,5,5,0,-2,1,0
286,276,276,271,14,14,15,13,3,1,3,1,10,0,5,0,-1,2
679,670,670,665,13,14,15,13,2,3,4,1,9,0,5,-1,-1,2
637,632,637,632,13,14,12,13,2,2,2,1,5,-5,5,-1,2,-1
656,646,651,651,17,16,15,16,1,4,1,1,10,-5,0,1,1,-1
450,440,450,436,13,14,12,13,2,2,2,1,10,-10,14,-1,2,-1
759,750,750,750,20,19,20,18,2,2,3,1,9,0,0,1,-1,2
224,220,220,224,18,17,18,19,1,2,1,1,4,0,-4,1,-1,-1
271,267,267,267,14,14,13,13,1,2,2,3,4,0,0,0,1,0
646,637,637,637,20,19,18,18,1,2,2,1,9,0,0,1,1,0
562,553,557,562,18,19,18,18,2,1,1,3,9,-4,-5,-1,1,0
609,600,590,590,14,17,15,16,1,1,2,1,9,10,0,-3,2,-1
754,750,740,745,17,19,18,18,2,2,2,1,4,10,-5,-2,1,0
707,707,707,712,17,19,18,18,1,1,3,3,0,0,-5,-2,1,0
890,886,886,886,18,19,18,19,1,2,1,1,4,0,0,-1,1,-1
646,642,637,637,13,14,12,13,2,1,2,3,4,5,0,-1,2,-1
951,946,946,946,13,14,15,13,2,3,3,2,5,0,0,-1,-1,2
1050,1045,1045,1045,17,16,15,16,4,1,3,3,5,0,0,1,1,-1
1026,1012,1021,1021,17,16,18,16,3,2,2,1,14,-9,0,1,-2,2
810,792,787,782,14,14,13,13,2,4,2,1,18,5,5,0,1,0
421,412,684,393,20,19,20,18,1,1,1,2,9,-272,291,1,-1,2
543,539,543,543,21,19,20,18,2,2,1,4,4,-4,0,2,-1,2
862,857,853,853,14,14,13,13,2,2,1,1,5,4,0,0,1,0
412,407,407,407,17,16,15,16,1,2,1,1,5,0,0,1,1,-1
478,473,468,464,20,19,18,18,2,2,2,1,5,5,4,1,1,0
890,886,881,876,14,17,15,16,1,1,3,2,4,5,5,-3,2,-1
1068,1064,1068,1064,20,19,18,18,1,2,2,1,4,-4,4,1,1,0
796,792,787,792,14,14,15,13,2,1,1,1,4,5,-5,0,-1,2
876,871,867,867,14,14,13,13,2,3,1,2,5,4,0,0,1,0
529,520,510,506,21,19,20,21,3,1,1,2,9,10,4,2,-1,-1
506,510,510,506,21,19,20,21,2,1,2,2,-4,0,4,2,-1,-1
304,295,290,290,14,14,15,13,2,3,3,1,9,5,0,0,-1,2
829,820,820,815,18,19,18,19,1,2,2,1,9,0,5,-1,1,-1
473,468,473,468,17,16,18,18,1,2,2,2,5,-5,5,1,-2,0
1050,1040,1040,1040,20,19,18,18,1,2,1,3,10,0,0,1,1,0
398,393,393,393,20,19,20,18,1,1,1,1,5,0,0,1,-1,2
510,501,496,496,14,14,15,13,2,4,3,3,9,5,0,0,-1,2
867,857,857,857,18,19,18,18,1,3,2,1,10,0,0,-1,1,0
824,824,820,824,18,17,18,19,2,2,1,3,0,4,-4,1,-1,-1
314,309,309,304,14,14,13,13,2,2,1,1,5,0,5,0,1,0
482,473,473,473,14,14,15,13,1,2,1,1,9,0,0,0,-1,2
623,623,618,618,18,17,18,19,2,2,1,1,0,5,0,1,-1,-1
182,1073,1078,1073,18,19,18,18,2,2,2,2,-891,-5,5,-1,1,0
192,187,192,187,14,14,13,13,2,2,2,2,5,-5,5,0,1,0
984,979,974,974,20,19,20,18,3,4,1,1,5,5,0,1,-1,2
487,487,487,482,14,14,15,13,3,1,2,1,0,0,5,0,-1,2
946,946,942,942,20,19,18,18,1,1,2,1,0,4,0,1,1,0
970,965,965,965,20,19,20,18,1,2,1,1,5,0,0,1,-1,2
1021,1017,1017,1017,20,19,20,21,3,1,1,2,4,0,0,1,-1,-1
881,876,876,871,14,14,13,13,1,6,1,2,5,0,5,0,1,0
848,839,843,839,21,19,20,21,1,2,1,2,9,-4,4,2,-1,-1
623,618,614,614,14,17,15,16,1,2,3,1,5,4,0,-3,2,-1
759,754,754,754,13,16,15,16,2,5,2,1,5,0,0,-3,1,-1
750,745,750,745,13,14,12,13,2,2,1,1,5,-5,5,-1,2,-1
417,412,412,412,20,19,20,18,3,1,1,1,5,0,0,1,-1,2
201,187,192,192,21,19,21,19,1,1,2,1,14,-5,0,2,-2,2
1073,1064,1068,1068,20,19,20,21,3,2,1,2,9,-4,0,1,-1,-1
909,904,904,904,18,19,18,19,1,1,1,2,5,0,0,-1,1,-1
1026,1021,1021,1021,17,16,15,16,1,1,1,3,5,0,0,1,1,-1
539,539,539,534,18,17,18,18,3,2,2,1,0,0,5,1,-1,0
1021,1017,318,1017,20,19,23,18,1,3,1,1,4,699,-699,1,-4,5
829,824,815,810,21,19,20,19,1,3,1,1,5,9,5,2,-1,1
407,393,393,389,13,14,12,13,2,4,1,2,14,0,4,-1,2,-1
328,318,318,323,14,14,15,13,1,4,1,2,10,0,-5,0,-1,2
745,1036,754,750,20,14,20,21,3,1,2,1,-291,282,4,6,-6,-1
717,712,712,707,20,19,20,18,1,4,1,1,5,0,5,1,-1,2
909,895,890,886,14,14,13,13,2,2,3,2,14,5,4,0,1,0
674,670,670,670,17,16,18,16,1,2,1,1,4,0,0,1,-2,2
904,895,900,900,21,19,20,19,2,2,2,2,9,-5,0,2,-1,1
998,993,998,998,20,19,18,18,2,1,2,1,5,-5,0,1,1,0
670,660,665,665,13,14,12,13,1,2,3,3,10,-5,0,-1,2,-1
600,586,571,571,14,14,13,13,3,2,3,2,14,15,0,0,1,0
918,909,909,904,14,17,15,16,2,1,2,3,9,0,5,-3,2,-1
1068,1059,1064,1059,13,14,12,13,2,2,2,2,9,-5,5,-1,2,-1
187,182,182,182,21,19,21,19,3,1,1,1,5,0,0,2,-2,2
192,187,187,182,21,19,21,21,1,1,1,1,5,0,5,2,-2,0
721,712,717,717,13,14,15,13,1,4,1,1,9,-5,0,-1,-1,2
234,229,229,224,14,14,15,13,1,2,3,2,5,0,5,0,-1,2
262,253,253,248,14,14,15,13,1,2,2,1,9,0,5,0,-1,2
206,201,201,201,18,17,18,19,1,2,3,2,5,0,0,1,-1,-1
318,314,318,318,21,19,21,21,2,2,1,1,4,-4,0,2,-2,0
871,871,871,867,14,14,15,13,2,2,2,2,0,0,4,0,-1,2
970,970,974,965,13,16,15,16,1,2,2,1,0,-4,9,-3,1,-1
459,450,454,454,17,16,18,16,2,1,1,2,9,-4,0,1,-2,2
881,876,876,876,14,14,15,13,2,1,2,1,5,0,0,0,-1,2
187,187,182,182,18,19,18,19,2,2,1,1,0,5,0,-1,1,-1
689,679,684,674,13,14,15,13,1,5,1,2,10,-5,10,-1,-1,2
829,824,829,829,21,19,20,21,3,1,2,1,5,-5,0,2,-1,-1
942,942,942,942,17,16,18,16,1,4,1,1,0,0,0,1,-2,2
243,243,243,248,21,19,20,18,2,3,1,1,0,0,-5,2,-1,2
670,656,642,637,13,14,12,13,3,3,2,2,14,14,5,-1,2,-1
900,895,900,900,18,19,18,19,3,2,2,1,5,-5,0,-1,1,-1
595,590,586,586,14,14,15,13,1,1,1,1,5,4,0,0,-1,2
651,646,651,646,13,14,12,13,1,4,2,2,5,-5,5,-1,2,-1
717,703,703,703,17,16,15,16,1,2,2,2,14,0,0,1,1,-1
656,646,651,651,20,19,18,18,3,2,2,1,10,-5,0,1,1,0
482,482,473,468,14,14,12,13,2,1,2,2,0,9,5,0,2,-1
890,881,876,881,14,14,15,13,3,3,1,1,9,5,-5,0,-1,2
932,918,923,932,13,14,13,13,1,4,1,1,14,-5,-9,-1,1,0
398,389,389,384,13,14,15,13,1,4,2,1,9,0,5,-1,-1,2
914,914,909,904,18,17,18,16,1,1,1,3,0,5,5,1,-1,2
445,436,431,426,17,16,18,16,2,4,2,3,9,5,5,1,-2,2
407,403,398,398,13,14,12,13,2,2,2,1,4,5,0,-1,2,-1
342,337,342,346,20,19,20,18,3,1,4,1,5,-5,-4,1,-1,2
674,670,674,670,13,14,15,13,2,2,2,2,4,-4,4,-1,-1,2
1073,1064,1068,1064,13,14,12,13,3,4,2,3,9,-4,4,-1,2,-1
436,440,436,426,17,19,18,18,1,3,1,2,-4,4,10,-2,1,0
436,431,431,426,20,19,20,18,3,2,2,3,5,0,5,1,-1,2
229,220,224,215,18,19,18,19,2,2,2,1,9,-4,9,-1,1,-1
829,824,824,824,14,14,15,16,1,1,2,2,5,0,0,0,-1,-1
674,665,665,670,13,14,12,13,2,2,1,1,9,0,-5,-1,2,-1
524,524,524,529,18,19,18,19,2,1,1,1,0,0,-5,-1,1,-1
421,417,417,417,20,19,20,21,2,1,3,1,4,0,0,1,-1,-1
956,951,951,951,17,16,15,16,3,2,3,1,5,0,0,1,1,-1
384,379,370,374,13,16,15,16,2,1,3,1,5,9,-4,-3,1,-1
1059,1054,1045,1050,13,14,12,13,1,3,3,6,5,9,-5,-1,2,-1
1045,1040,1040,1040,13,14,12,13,5,1,1,1,5,0,0,-1,2,-1
224,206,210,215,14,17,15,16,4,3,3,2,18,-4,-5,-3,2,-1
1003,998,1003,1007,20,19,18,18,2,1,3,1,5,-5,-4,1,1,0
370,365,365,365,13,14,15,13,2,3,2,3,5,0,0,-1,-1,2
815,810,810,810,14,14,13,13,1,2,1,1,5,0,0,0,1,0
248,234,224,224,21,19,20,19,2,2,3,2,14,10,0,2,-1,1
281,276,276,271,14,17,15,16,1,2,1,1,5,0,5,-3,2,-1
370,356,356,356,17,16,15,16,3,3,1,3,14,0,0,1,1,-1
1017,1012,1007,1007,17,16,18,16,2,2,2,1,5,5,0,1,-2,2
1073,1064,1064,1064,17,19,18,18,1,1,3,1,9,0,0,-2,1,0
1064,1064,1064,1064,20,19,20,21,3,3,1,1,0,0,0,1,-1,-1
365,360,356,356,13,14,12,13,2,2,2,1,5,4,0,-1,2,-1
478,473,473,468,13,14,12,13,1,3,3,2,5,0,5,-1,2,-1
318,318,318,318,18,19,18,19,2,4,1,2,0,0,0,-1,1,-1
187,187,182,182,18,19,21,19,2,1,1,1,0,5,0,-1,-2,2
562,562,557,557,18,17,18,18,3,1,2,1,0,5,0,1,-1,0
337,332,328,328,13,14,13,13,2,2,2,1,5,4,0,-1,1,0
370,370,370,370,17,19,18,18,3,2,2,3,0,0,0,-2,1,0
356,342,346,351,20,19,20,21,2,2,1,2,14,-4,-5,1,-1,-1
356,346,346,337,13,14,15,13,2,2,1,4,10,0,9,-1,-1,2
974,974,979,970,13,16,15,16,1,1,1,1,0,-5,9,-3,1,-1
398,393,393,384,17,16,15,16,4,3,1,3,5,0,9,1,1,-1
740,726,721,721,13,14,15,13,2,3,1,3,14,5,0,-1,-1,2
482,468,454,450,14,14,15,13,2,1,2,2,14,14,4,0,-1,2
360,351,346,346,17,16,15,16,2,2,1,1,9,5,0,1,1,-1
731,731,731,731,20,19,20,18,2,1,1,1,0,0,0,1,-1,2
243,239,229,234,14,17,15,16,3,4,3,1,4,10,-5,-3,2,-1
674,670,670,670,20,19,18,18,2,2,2,2,4,0,0,1,1,0
876,862,867,867,14,17,15,16,3,4,1,2,14,-5,0,-3,2,-1
182,1068,1068,1068,14,14,12,13,1,2,3,1,-886,0,0,0,2,-1
900,900,895,886,18,19,18,19,2,1,2,2,0,5,9,-1,1,-1
300,295,300,300,18,17,18,19,2,2,2,1,5,-5,0,1,-1,-1
1003,998,1003,998,20,19,20,18,1,1,1,3,5,-5,5,1,-1,2
356,351,346,346,17,16,18,18,3,3,1,1,5,5,0,1,-2,0
567,562,562,562,18,19,18,18,2,1,1,1,5,0,0,-1,1,0
487,487,487,482,14,14,15,13,1,1,2,1,0,0,5,0,-1,2
590,586,576,581,14,14,13,13,1,1,1,1,4,10,-5,0,1,0
300,300,300,295,14,14,15,13,2,3,1,3,0,0,5,0,-1,2
271,271,262,262,14,17,15,16,2,3,1,4,0,9,0,-3,2,-1
314,304,300,300,14,17,15,16,1,2,1,1,10,4,0,-3,2,-1
918,904,914,914,18,19,18,19,1,2,3,3,14,-10,0,-1,1,-1
689,679,684,674,13,14,12,13,1,2,2,1,10,-5,10,-1,2,-1
829,829,824,824,14,14,13,13,1,1,3,1,0,5,0,0,1,0
370,360,360,356,13,16,15,16,2,2,2,2,10,0,4,-3,1,-1
187,182,1073,1068,14,17,15,16,3,1,3,2,5,-891,5,-3,2,-1
890,890,886,886,14,17,15,16,2,3,1,1,0,4,0,-3,2,-1
698,689,684,689,13,14,12,13,1,2,2,3,9,5,-5,-1,2,-1
539,539,529,529,14,14,15,13,2,3,1,1,0,10,0,0,-1,2
365,356,356,356,13,16,15,16,1,2,3,1,9,0,0,-3,1,-1
736,736,740,736,20,19,18,18,3,1,2,1,0,-4,4,1,1,0
651,642,637,637,17,19,18,18,1,2,1,2,9,5,0,-2,1,0
506,506,506,506,21,19,20,19,2,1,1,1,0,0,0,2,-1,1
417,407,412,412,20,19,18,18,4,2,6,1,10,-5,0,1,1,0
881,876,876,871,14,17,15,16,1,2,1,2,5,0,5,-3,2,-1
909,909,904,904,18,17,18,19,3,2,3,3,0,5,0,1,-1,-1
614,609,609,604,14,14,13,13,1,3,2,1,5,0,5,0,1,0
248,248,253,248,14,14,15,13,2,2,2,1,0,-5,5,0,-1,2
576,576,576,571,18,17,18,16,2,3,1,2,0,0,5,1,-1,2
1007,974,974,974,13,14,12,13,1,2,1,1,33,0,0,-1,2,-1
750,745,750,754,13,14,12,13,1,3,1,1,5,-5,-4,-1,2,-1
843,824,824,824,14,14,15,13,3,2,2,1,19,0,0,0,-1,2
506,506,506,506,18,19,18,19,3,1,1,1,0,0,0,-1,1,-1
271,267,267,267,14,17,15,16,1,4,2,3,4,0,0,-3,2,-1
843,834,824,829,14,17,15,16,3,2,1,2,9,10,-5,-3,2,-1
337,332,328,328,17,16,15,16,3,2,2,1,5,4,0,1,1,-1
365,356,351,351,13,14,12,13,2,3,1,1,9,5,0,-1,2,-1
1031,262,1026,1021,20,19,20,18,3,1,1,2,769,-764,5,1,-1,2
674,665,660,656,13,16,15,16,2,1,2,2,9,5,4,-3,1,-1
923,918,918,914,21,19,21,19,2,3,1,2,5,0,4,2,-2,2
295,295,290,290,14,17,15,16,2,3,1,1,0,5,0,-3,2,-1
187,1073,1078,1073,14,14,15,13,1,2,2,2,-886,-5,5,0,-1,2
571,487,501,520,14,14,13,13,3,2,1,2,84,-14,-19,0,1,0
689,679,679,679,20,19,20,18,1,2,1,1,10,0,0,1,-1,2
989,979,979,979,13,14,15,13,3,2,2,1,10,0,0,-1,-1,2
370,365,370,370,20,19,20,18,2,2,1,2,5,-5,0,1,-1,2
314,318,314,318,18,17,18,19,2,3,1,3,-4,4,-4,1,-1,-1
1031,1031,1031,1021,13,14,15,13,2,3,1,1,0,0,10,-1,-1,2
346,342,337,337,17,16,15,16,2,3,2,1,4,5,0,1,1,-1
501,496,492,492,18,17,18,19,2,2,1,1,5,4,0,1,-1,-1
928,923,918,918,14,14,15,13,1,1,2,4,5,5,0,0,-1,2
1068,1064,1064,1059,17,16,18,18,2,2,1,3,4,0,5,1,-2,0
276,271,271,267,14,14,13,13,2,1,2,2,5,0,4,0,1,0
281,271,276,276,18,19,18,18,1,1,2,1,10,-5,0,-1,1,0
989,984,984,984,17,16,18,18,2,1,1,3,5,0,0,1,-2,0
726,721,726,721,20,19,20,18,1,2,2,1,5,-5,5,1,-1,2
600,595,595,595,14,14,15,13,2,3,1,1,5,0,0,0,-1,2
956,946,946,946,13,14,12,13,1,1,1,3,10,0,0,-1,2,-1
792,773,768,764,14,14,12,13,1,2,2,2,19,5,4,0,2,-1
534,524,524,520,18,17,18,16,1,2,2,1,10,0,4,1,-1,2
806,792,792,787,14,14,15,16,1,2,2,1,14,0,5,0,-1,-1
942,937,937,932,17,16,18,16,2,1,2,2,5,0,5,1,-2,2
693,689,689,684,20,19,18,18,1,2,1,2,4,0,5,1,1,0
407,403,740,403,13,14,12,13,1,4,1,2,4,-337,337,-1,2,-1
553,548,543,543,18,19,18,18,3,3,1,1,5,5,0,-1,1,0
656,646,646,646,17,16,18,16,2,1,1,1,10,0,0,1,-2,2
454,450,445,445,20,19,20,18,4,2,1,2,4,5,0,1,-1,2
670,660,660,665,20,19,20,21,2,2,1,1,10,0,-5,1,-1,-1
810,806,796,914,18,17,18,19,2,1,1,1,4,10,-118,1,-1,-1
867,848,848,853,14,14,13,13,3,2,1,3,19,0,-5,0,1,0
848,834,829,824,14,14,13,13,3,1,2,1,14,5,5,0,1,0
290,281,281,281,18,19,18,19,3,1,1,3,9,0,0,-1,1,-1
736,736,731,726,20,19,20,21,1,1,1,2,0,5,5,1,-1,-1
796,796,792,796,14,14,15,13,1,1,1,1,0,4,-4,0,-1,2
276,262,257,262,14,14,15,13,1,2,1,1,14,5,-5,0,-1,2
618,609,614,609,14,14,15,13,3,2,2,1,9,-5,5,0,-1,2
960,960,956,960,17,16,15,16,3,1,1,1,0,4,-4,1,1,-1
506,506,501,501,14,17,15,16,2,1,1,1,0,5,0,-3,2,-1
271,243,239,239,21,19,20,18,1,1,1,1,28,4,0,2,-1,2
820,801,834,792,14,14,13,13,3,1,1,2,19,-33,42,0,1,0
824,820,820,820,18,19,18,19,1,3,1,2,4,0,0,-1,1,-1
862,853,853,848,21,19,20,21,2,1,2,1,9,0,5,2,-1,-1
342,337,337,337,17,16,15,16,2,3,1,1,5,0,0,1,1,-1
515,510,510,510,18,17,18,16,2,2,1,2,5,0,0,1,-1,2
923,918,923,918,18,17,18,19,1,2,3,1,5,-5,5,1,-1,-1
389,384,384,384,17,16,18,16,2,1,2,1,5,0,0,1,-2,2
989,989,984,984,13,14,12,13,1,3,2,1,0,5,0,-1,2,-1
628,628,628,632,21,19,21,21,1,1,1,1,0,0,-4,2,-2,0
468,464,468,464,20,19,20,21,1,1,1,1,4,-4,4,1,-1,-1
501,487,482,487,21,19,21,19,3,2,1,1,14,5,-5,2,-2,2
243,239,239,239,14,14,15,13,2,2,1,2,4,0,0,0,-1,2
520,506,496,492,14,14,13,13,3,3,2,1,14,10,4,0,1,0
1036,1040,1031,1031,20,19,20,18,2,1,1,2,-4,9,0,1,-1,2
1073,1068,1068,1068,20,19,18,18,1,2,3,1,5,0,0,1,1,0
665,660,665,660,13,14,12,13,3,2,1,3,5,-5,5,-1,2,-1
604,604,600,600,18,19,18,19,3,2,1,1,0,4,0,-1,1,-1
529,524,524,520,21,19,20,21,1,1,2,2,5,0,4,2,-1,-1
557,562,553,557,14,17,15,16,2,3,1,1,-5,9,-4,-3,2,-1
539,524,520,524,14,14,15,13,3,2,1,2,15,4,-4,0,-1,2
314,309,304,304,18,17,18,19,1,3,1,2,5,5,0,1,-1,-1
360,356,351,346,17,16,18,16,2,1,1,2,4,5,5,1,-2,2
543,539,539,534,14,14,13,13,1,3,4,2,4,0,5,0,1,0
187,1054,1054,1050,14,14,12,13,1,2,1,2,-867,0,4,0,2,-1
304,304,300,304,21,19,20,19,1,1,1,1,0,4,-4,2,-1,1
206,206,196,201,14,17,15,16,1,1,2,1,0,10,-5,-3,2,-1
965,965,965,974,17,19,18,18,4,1,2,1,0,0,-9,-2,1,0
674,665,670,660,20,19,20,18,2,2,2,4,9,-5,10,1,-1,2
1064,1054,1054,1050,13,14,15,16,4,2,2,2,10,0,4,-1,-1,-1
182,1073,1068,1073,14,14,12,13,1,2,1,2,-891,5,-5,0,2,-1
965,956,951,951,13,14,12,13,1,1,1,2,9,5,0,-1,2,-1
248,234,220,220,18,17,18,16,3,1,1,1,14,14,0,1,-1,2
384,379,379,389,13,14,12,13,1,1,1,3,5,0,-10,-1,2,-1
562,557,562,557,21,19,20,21,3,4,2,1,5,-5,5,2,-1,-1
539,534,529,529,18,17,18,19,2,1,1,1,5,5,0,1,-1,-1
618,618,614,614,21,19,21,21,1,1,1,1,0,4,0,2,-2,0
323,314,314,314,14,14,13,13,1,2,1,1,9,0,0,0,1,0
571,571,567,567,18,19,18,18,1,3,2,1,0,4,0,-1,1,0
304,295,295,295,18,19,18,19,1,3,1,3,9,0,0,-1,1,-1
745,740,750,745,20,19,20,21,3,3,1,1,5,-10,5,1,-1,-1
923,923,923,923,14,17,15,16,2,1,1,3,0,0,0,-3,2,-1
482,478,473,473,14,16,15,16,1,1,1,1,4,5,0,-2,1,-1
1064,1054,1059,1054,20,19,18,18,4,1,2,1,10,-5,5,1,1,0
529,520,524,515,18,19,18,19,3,2,2,4,9,-4,9,-1,1,-1
398,393,403,403,13,14,12,13,3,3,2,1,5,-10,0,-1,2,-1
389,384,384,384,13,14,12,13,3,1,2,2,5,0,0,-1,2,-1
1031,1040,1036,1031,20,19,20,21,2,1,2,2,-9,4,5,1,-1,-1
604,600,604,604,18,17,18,16,3,1,2,1,4,-4,0,1,-1,2
524,520,520,510,14,17,15,16,2,1,3,2,4,0,10,-3,2,-1
356,351,356,360,20,19,20,18,3,2,3,1,5,-5,-4,1,-1,2
787,787,768,773,14,14,12,13,1,1,3,2,0,19,-5,0,2,-1
642,623,618,623,13,14,13,13,2,2,1,1,19,5,-5,-1,1,0
853,843,843,839,21,19,20,21,3,2,2,2,10,0,4,2,-1,-1
853,843,843,843,14,14,15,13,3,2,1,2,10,0,0,0,-1,2
942,937,937,942,13,14,12,13,1,1,1,1,5,0,-5,-1,2,-1
1040,1036,1040,1040,20,19,18,18,2,1,2,1,4,-4,0,1,1,0
271,262,257,257,14,14,13,13,2,1,1,1,9,5,0,0,1,0
473,464,468,464,13,14,15,16,2,2,2,3,9,-4,4,-1,-1,-1
224,224,224,220,18,17,18,16,5,2,3,1,0,0,4,1,-1,2
196,182,182,187,14,17,15,16,1,1,1,3,14,0,-5,-3,2,-1
656,646,651,646,20,19,20,21,2,3,1,2,10,-5,5,1,-1,-1
553,543,543,543,14,14,15,13,1,1,1,2,10,0,0,0,-1,2
862,857,862,853,18,17,18,16,2,2,2,3,5,-5,9,1,-1,2
881,876,876,876,18,19,18,18,1,2,2,1,5,0,0,-1,1,0
1054,1050,1050,1050,13,14,15,16,3,3,3,2,4,0,0,-1,-1,-1
450,445,440,436,13,14,12,13,1,3,3,1,5,5,4,-1,2,-1
257,253,257,257,18,17,18,18,3,2,1,1,4,-4,0,1,-1,0
646,646,642,637,13,14,15,13,3,6,2,2,0,4,5,-1,-1,2
403,393,393,393,13,14,12,13,2,2,1,2,10,0,0,-1,2,-1
571,571,567,567,21,19,20,18,4,3,2,1,0,4,0,2,-1,2
937,937,937,932,20,19,20,21,2,1,2,1,0,0,5,1,-1,-1
979,970,970,970,20,19,20,18,2,1,1,2,9,0,0,1,-1,2
707,698,693,693,13,14,15,13,2,1,1,1,9,5,0,-1,-1,2
651,642,646,642,13,14,12,13,2,2,1,2,9,-4,4,-1,2,-1
1036,1031,1031,1031,13,14,15,13,1,2,4,1,5,0,0,-1,-1,2
1026,1021,1026,1026,20,19,18,18,3,2,1,2,5,-5,0,1,1,0
918,918,918,914,18,17,18,16,1,3,2,1,0,0,4,1,-1,2
693,689,689,689,17,16,18,16,5,2,1,1,4,0,0,1,-2,2
1021,1031,1017,1017,17,16,15,16,1,1,3,2,-10,14,0,1,1,-1
778,768,768,768,13,14,12,13,1,2,3,1,10,0,0,-1,2,-1
548,553,548,543,21,19,20,18,3,3,1,1,-5,5,5,2,-1,2
693,684,689,684,13,14,15,13,3,2,2,2,9,-5,5,-1,-1,2
740,736,740,731,20,19,18,18,2,1,2,2,4,-4,9,1,1,0
787,764,745,745,14,14,15,13,4,1,2,1,23,19,0,0,-1,2
848,853,843,843,18,17,18,16,1,1,1,3,-5,10,0,1,-1,2
557,543,534,529,18,17,18,16,1,1,2,1,14,9,5,1,-1,2
750,745,754,750,13,14,12,13,1,2,2,3,5,-9,4,-1,2,-1
182,182,1078,1078,21,19,20,21,1,2,1,1,0,-896,0,2,-1,-1
290,276,262,267,14,14,15,13,1,2,1,1,14,14,-5,0,-1,2
412,412,403,403,13,14,15,16,1,1,1,1,0,9,0,-1,-1,-1
557,553,548,553,14,14,15,13,4,3,1,3,4,5,-5,0,-1,2
1068,1064,1064,1064,17,16,15,16,1,1,2,1,4,0,0,1,1,-1
923,918,928,923,18,17,18,19,2,2,2,1,5,-10,5,1,-1,-1
220,210,210,206,14,14,13,13,3,3,1,2,10,0,4,0,1,0
473,468,473,464,13,14,15,13,2,1,2,1,5,-5,9,-1,-1,2
895,895,890,895,14,17,15,16,2,2,3,3,0,5,-5,-3,2,-1
271,267,267,262,14,14,15,13,1,5,3,3,4,0,5,0,-1,2
243,229,215,220,14,17,15,16,1,3,2,2,14,14,-5,-3,2,-1
370,365,365,365,13,14,15,13,3,3,2,1,5,0,0,-1,-1,2
642,623,628,632,13,14,13,13,2,2,1,2,19,-5,-4,-1,1,0
220,206,206,196,14,14,15,13,3,3,3,2,14,0,10,0,-1,2
651,646,646,646,17,16,15,16,2,3,1,1,5,0,0,1,1,-1
824,815,820,820,14,17,15,16,3,4,2,3,9,-5,0,-3,2,-1
1017,1012,1012,1012,13,14,12,13,1,3,1,2,5,0,0,-1,2,-1
206,201,196,196,14,17,15,16,3,2,1,1,5,5,0,-3,2,-1
1003,993,989,984,13,14,12,13,2,1,1,4,10,4,5,-1,2,-1
1026,1021,1021,1017,17,19,18,18,1,2,1,3,5,0,4,-2,1,0
674,684,787,881,17,16,15,16,2,2,1,1,-10,-103,-94,1,1,-1
937,937,937,937,13,14,12,13,1,3,2,2,0,0,0,-1,2,-1
932,932,928,928,20,19,21,19,1,1,1,1,0,4,0,1,-2,2
276,271,267,267,18,17,18,16,3,1,3,1,5,4,0,1,-1,2
989,989,993,989,20,19,20,18,1,1,2,1,0,-4,4,1,-1,2
750,745,745,740,13,14,15,13,3,1,1,1,5,0,5,-1,-1,2
829,824,824,824,21,19,20,21,1,3,1,1,5,0,0,2,-1,-1
946,942,942,942,20,19,18,18,2,1,2,3,4,0,0,1,1,0
431,417,412,417,17,16,18,16,4,2,1,1,14,5,-5,1,-2,2
262,257,262,257,18,19,18,18,2,2,3,1,5,-5,5,-1,1,0
674,660,674,665,20,19,20,21,2,2,2,3,14,-14,9,1,-1,-1
384,360,356,351,13,14,15,13,2,2,2,2,24,4,5,-1,-1,2
979,979,974,974,13,14,12,13,3,1,1,3,0,5,0,-1,2,-1
595,595,595,586,14,14,13,13,2,2,3,1,0,0,9,0,1,0
332,323,328,323,17,17,18,16,1,2,1,1,9,-5,5,0,-1,2
670,665,665,665,13,14,12,13,2,1,2,1,5,0,0,-1,2,-1
234,229,224,224,14,17,15,16,2,3,3,1,5,5,0,-3,2,-1
1073,1073,1068,1068,20,19,18,18,1,1,1,1,0,5,0,1,1,0
342,337,342,342,13,14,12,13,3,1,2,2,5,-5,0,-1,2,-1
1007,998,1003,1003,20,19,20,21,2,2,1,3,9,-5,0,1,-1,-1
454,454,454,454,13,14,15,13,3,2,4,2,0,0,0,-1,-1,2
454,450,454,450,13,14,15,13,3,2,2,2,4,-4,4,-1,-1,2
998,993,993,998,20,19,20,21,3,1,1,1,5,0,-5,1,-1,-1
468,464,459,459,20,19,20,21,2,2,1,2,4,5,0,1,-1,-1
867,857,853,853,18,17,18,16,2,2,3,1,10,4,0,1,-1,2
1073,1068,1068,1068,17,19,18,18,2,2,1,1,5,0,0,-2,1,0
712,707,712,707,20,19,20,18,1,1,2,1,5,-5,5,1,-1,2
201,196,192,187,21,19,21,19,1,3,2,2,5,4,5,2,-2,2
623,618,623,618,18,19,18,19,2,1,2,2,5,-5,5,-1,1,-1
548,553,543,721,14,17,15,16,3,1,2,1,-5,10,-178,-3,2,-1
1040,1036,1036,1036,13,14,12,13,3,2,2,1,4,0,0,-1,2,-1
604,590,595,595,14,14,13,13,2,2,2,3,14,-5,0,0,1,0
1021,1017,1017,1017,17,16,15,16,3,2,3,2,4,0,0,1,1,-1
698,689,698,698,13,14,15,13,1,1,1,2,9,-9,0,-1,-1,2
637,618,623,628,17,19,18,19,1,3,1,1,19,-5,-5,-2,1,-1
407,398,393,393,20,19,18,18,1,3,1,2,9,5,0,1,1,0
253,253,248,248,14,14,15,16,1,3,3,1,0,5,0,0,-1,-1
839,839,834,829,14,14,15,13,2,1,1,1,0,5,5,0,-1,2
871,998,857,857,14,14,15,13,1,1,5,1,-127,141,0,0,-1,2
712,698,698,703,20,19,20,21,2,4,3,1,14,0,-5,1,-1,-1
679,674,674,670,17,16,18,18,2,5,1,2,5,0,4,1,-2,0
346,332,332,337,13,14,15,13,2,1,1,2,14,0,-5,-1,-1,2
1040,1036,1036,1031,17,16,18,16,2,2,2,2,4,0,5,1,-2,2
1064,1059,1059,1059,17,16,18,16,2,2,1,1,5,0,0,1,-2,2
562,557,562,553,14,14,13,13,3,2,2,2,5,-5,9,0,1,0
309,300,300,300,14,17,15,16,3,4,2,1,9,0,0,-3,2,-1
384,374,379,374,17,16,18,16,2,2,2,1,10,-5,5,1,-2,2
750,740,745,740,13,14,12,13,2,2,3,1,10,-5,5,-1,2,-1
834,824,815,810,14,14,13,13,3,1,2,2,10,9,5,0,1,0
1045,1040,1040,1045,13,14,12,13,1,2,2,3,5,0,-5,-1,2,-1
482,473,478,492,21,19,20,21,2,2,2,1,9,-5,-14,2,-1,-1
286,276,276,271,14,14,13,13,1,1,1,2,10,0,5,0,1,0
553,548,543,539,18,17,18,18,1,1,3,2,5,5,4,1,-1,0
745,740,740,740,17,16,15,16,2,1,2,1,5,0,0,1,1,-1
281,276,276,276,21,19,20,21,1,1,1,2,5,0,0,2,-1,-1
239,234,239,234,18,19,18,18,1,2,2,2,5,-5,5,-1,1,0
717,712,717,712,17,16,15,16,2,2,1,1,5,-5,5,1,1,-1
257,253,248,243,14,14,15,13,2,1,3,6,4,5,5,0,-1,2
740,736,736,736,13,14,15,13,2,1,2,3,4,0,0,-1,-1,2
946,937,928,923,13,14,13,13,3,2,1,1,9,9,5,-1,1,0
609,604,600,600,14,17,15,16,1,3,1,2,5,4,0,-3,2,-1
1073,1073,1068,1068,20,19,20,21,3,1,1,1,0,5,0,1,-1,-1
1045,1036,1040,1040,13,14,12,13,1,2,3,4,9,-4,0,-1,2,-1
543,534,534,534,14,14,13,13,1,3,1,1,9,0,0,0,1,0
346,342,342,337,20,19,20,18,3,1,1,4,4,0,5,1,-1,2
867,857,862,862,18,17,18,18,1,2,1,3,10,-5,0,1,-1,0
365,365,360,360,17,16,15,16,1,1,1,1,0,5,0,1,1,-1
257,253,253,248,18,19,18,18,1,1,2,2,4,0,5,-1,1,0
918,914,909,909,14,14,13,13,1,1,1,1,4,5,0,0,1,0
524,524,515,520,14,14,15,13,2,1,3,3,0,9,-5,0,-1,2
304,300,300,304,18,17,18,19,2,3,3,1,4,0,-4,1,-1,-1
904,904,900,900,14,14,13,13,2,2,1,2,0,4,0,0,1,0
792,782,787,792,14,14,13,13,1,1,1,1,10,-5,-5,0,1,0
482,473,473,473,18,16,18,16,2,2,1,2,9,0,0,2,-2,2
1026,1017,1012,1007,17,16,18,16,2,1,1,2,9,5,5,1,-2,2
1078,1068,192,1073,17,19,18,18,2,2,1,1,10,876,-881,-2,1,0
548,543,539,539,18,19,18,18,2,1,1,2,5,4,0,-1,1,0
618,618,618,618,14,14,15,13,1,2,2,1,0,0,0,0,-1,2
290,286,286,286,21,19,20,19,2,2,1,1,4,0,0,2,-1,1
1040,1026,1031,1031,17,16,15,16,2,2,1,2,14,-5,0,1,1,-1
1031,1021,1026,1021,20,19,20,21,2,2,2,2,10,-5,5,1,-1,-1
243,239,239,234,21,19,20,18,1,1,2,2,4,0,5,2,-1,2
1012,1012,1007,1007,17,16,15,16,1,1,1,1,0,5,0,1,1,-1
290,290,286,286,14,17,15,16,2,1,1,2,0,4,0,-3,2,-1
328,323,323,323,18,19,18,19,1,1,2,1,5,0,0,-1,1,-1
370,318,314,314,17,17,15,16,1,1,3,2,52,4,0,0,2,-1
984,984,984,979,13,14,15,16,1,1,3,1,0,0,5,-1,-1,-1
609,581,576,576,14,14,15,16,1,1,1,1,28,5,0,0,-1,-1
623,614,618,614,14,17,15,16,1,2,1,2,9,-4,4,-3,2,-1
543,534,539,534,14,14,13,13,1,2,2,2,9,-5,5,0,1,0
721,707,712,703,13,14,12,13,4,3,4,2,14,-5,9,-1,2,-1
750,736,736,736,13,14,12,13,2,2,2,1,14,0,0,-1,2,-1
740,731,731,726,17,16,15,16,2,1,1,1,9,0,5,1,1,-1
421,417,417,412,20,19,18,18,1,2,1,1,4,0,5,1,1,0
370,370,370,370,20,19,20,18,1,1,3,1,0,0,0,1,-1,2
496,496,496,492,18,17,18,19,3,2,2,2,0,0,4,1,-1,-1
984,979,984,989,13,14,15,13,3,1,2,1,5,-5,-5,-1,-1,2
839,839,839,834,21,19,20,21,1,1,2,1,0,0,5,2,-1,-1
1078,1073,1073,1073,17,16,18,18,2,1,1,3,5,0,0,1,-2,0
637,623,623,623,13,14,13,13,2,2,1,1,14,0,0,-1,1,0
782,787,782,782,21,19,21,19,2,1,1,1,-5,5,0,2,-2,2
871,862,867,867,18,17,18,18,1,4,1,1,9,-5,0,1,-1,0
286,286,281,281,21,19,20,21,4,2,1,2,0,5,0,2,-1,-1
454,440,445,445,20,19,20,21,1,2,1,3,14,-5,0,1,-1,-1
403,398,393,389,17,16,18,18,2,1,1,2,5,5,4,1,-2,0
989,979,984,979,20,19,20,18,2,2,2,1,10,-5,5,1,-1,2
712,703,698,698,17,16,15,16,1,2,1,2,9,5,0,1,1,-1
1073,1068,1068,1064,13,14,15,13,2,1,2,1,5,0,4,-1,-1,2
337,332,318,323,17,16,18,16,2,1,1,2,5,14,-5,1,-2,2
290,281,281,281,18,17,18,19,1,3,3,1,9,0,0,1,-1,-1
764,759,759,759,13,14,12,13,1,1,3,4,5,0,0,-1,2,-1
909,900,904,900,14,14,15,13,1,2,2,3,9,-4,4,0,-1,2
192,187,192,192,14,14,13,13,1,3,2,3,5,-5,0,0,1,0
534,539,534,534,14,14,15,13,2,1,3,3,-5,5,0,0,-1,2
623,618,614,618,18,19,18,19,3,3,4,3,5,4,-4,-1,1,-1
374,374,374,374,13,14,15,16,3,3,1,1,0,0,0,-1,-1,-1
454,450,450,445,17,16,15,16,1,2,2,2,4,0,5,1,1,-1
942,937,937,932,17,16,15,16,2,3,2,2,5,0,5,1,1,-1
253,243,239,234,14,14,15,16,2,2,1,2,10,4,5,0,-1,-1
1036,1021,1017,1017,13,14,12,13,1,2,1,1,15,4,0,-1,2,-1
576,571,571,571,21,19,20,18,2,1,3,1,5,0,0,2,-1,2
201,192,187,187,14,14,15,13,2,2,2,2,9,5,0,0,-1,2
707,703,703,703,13,14,15,16,1,3,1,1,4,0,0,-1,-1,-1
487,478,478,473,14,14,13,13,2,1,2,2,9,0,5,0,1,0
224,220,224,224,21,19,20,21,3,2,1,1,4,-4,0,2,-1,-1
318,290,290,290,14,17,15,16,2,2,2,1,28,0,0,-3,2,-1
764,754,759,759,20,19,20,18,1,1,3,1,10,-5,0,1,-1,2
853,848,848,843,14,17,15,16,1,2,1,2,5,0,5,-3,2,-1
623,614,614,614,21,19,21,21,1,3,1,2,9,0,0,2,-2,0
1012,1012,1007,1007,17,16,18,16,2,3,1,1,0,5,0,1,-2,2
309,300,295,290,14,14,13,13,2,1,2,2,9,5,5,0,1,0
806,796,796,792,14,14,15,13,2,3,1,2,10,0,4,0,-1,2
670,656,660,656,20,19,20,18,2,1,2,3,14,-4,4,1,-1,2
923,923,923,923,18,17,18,19,2,2,1,1,0,0,0,1,-1,-1
243,229,229,234,14,14,15,13,3,1,3,3,14,0,-5,0,-1,2
379,365,374,374,17,16,18,18,1,2,2,1,14,-9,0,1,-2,0
487,478,473,478,18,19,18,18,1,1,1,1,9,5,-5,-1,1,0
796,796,787,792,14,17,15,16,2,3,1,3,0,9,-5,-3,2,-1
356,346,342,337,17,19,18,18,1,3,1,1,10,4,5,-2,1,0
1036,1031,1026,1021,17,16,18,18,2,3,2,2,5,5,5,1,-2,0
698,693,698,693,20,19,18,18,1,3,2,1,5,-5,5,1,1,0
407,407,398,403,13,14,12,13,1,4,1,2,0,9,-5,-1,2,-1
646,637,637,637,17,16,18,18,1,2,1,1,9,0,0,1,-2,0
600,581,571,576,14,14,13,13,2,1,1,3,19,10,-5,0,1,0
286,281,276,276,14,17,15,16,2,1,1,1,5,5,0,-3,2,-1
431,421,412,412,17,16,18,18,3,1,2,1,10,9,0,1,-2,0
665,660,660,656,20,19,18,18,2,1,1,2,5,0,4,1,1,0
693,689,689,684,17,16,15,16,2,2,2,2,4,0,5,1,1,-1
360,360,360,356,17,16,15,16,1,1,1,2,0,0,4,1,1,-1
614,614,614,614,18,17,18,19,2,2,1,1,0,0,0,1,-1,-1
820,820,815,820,18,17,18,16,2,2,3,1,0,5,-5,1,-1,2
253,239,243,253,18,19,18,18,3,3,3,2,14,-4,-10,-1,1,0
290,286,281,286,14,14,13,13,1,3,3,2,4,5,-5,0,1,0
829,824,829,824,14,14,15,13,2,2,2,2,5,-5,5,0,-1,2
234,224,229,224,14,14,15,13,2,3,2,1,10,-5,5,0,-1,2
717,712,712,712,17,16,15,16,1,1,2,2,5,0,0,1,1,-1
815,810,810,810,18,17,18,19,1,1,1,1,5,0,0,1,-1,-1
586,581,581,567,14,14,13,13,1,3,1,4,5,0,14,0,1,0
206,201,201,196,14,17,15,16,1,2,6,2,5,0,5,-3,2,-1
586,581,581,576,18,19,18,18,1,3,2,2,5,0,5,-1,1,0
351,356,346,346,20,19,20,21,1,3,1,2,-5,10,0,1,-1,-1
314,309,309,304,18,19,18,19,2,1,2,2,5,0,5,-1,1,-1
721,717,721,721,13,14,12,13,3,2,1,1,4,-4,0,-1,2,-1
876,876,867,871,14,14,13,13,2,1,1,3,0,9,-4,0,1,0
389,384,379,379,17,16,18,16,1,1,1,1,5,5,0,1,-2,2
553,548,548,548,18,17,18,18,2,6,1,2,5,0,0,1,-1,0
1054,1054,1050,1050,17,16,18,18,1,3,3,1,0,4,0,1,-2,0
937,923,923,928,20,19,21,21,2,2,1,1,14,0,-5,1,-2,0
904,890,886,881,21,19,20,19,1,1,1,3,14,4,5,2,-1,1
365,365,356,351,20,19,20,21,3,1,1,1,0,9,5,1,-1,-1
674,665,670,665,20,19,20,21,3,4,2,2,9,-5,5,1,-1,-1
524,515,510,510,14,17,15,16,1,3,1,1,9,5,0,-3,2,-1
726,731,721,721,17,16,15,16,1,1,1,1,-5,10,0,1,1,-1
473,473,468,468,17,16,15,16,2,1,1,3,0,5,0,1,1,-1
979,974,974,970,13,14,15,13,2,1,2,1,5,0,4,-1,-1,2
736,736,736,731,17,16,18,16,3,1,1,1,0,0,5,1,-2,2
281,281,276,271,18,17,18,18,1,3,2,2,0,5,5,1,-1,0
342,342,342,342,20,19,18,18,1,4,2,1,0,0,0,1,1,0
459,445,445,445,20,19,18,18,1,5,1,1,14,0,0,1,1,0
900,895,895,890,21,19,20,19,2,1,2,2,5,0,5,2,-1,1
478,468,473,468,20,19,20,18,1,2,1,2,10,-5,5,1,-1,2
787,773,773,782,18,19,18,19,1,2,1,1,14,0,-9,-1,1,-1
721,717,712,707,20,19,18,18,1,2,1,1,4,5,5,1,1,0
337,337,337,337,13,14,12,13,3,1,1,1,0,0,0,-1,2,-1
487,473,473,468,14,14,12,13,3,3,3,4,14,0,5,0,2,-1
623,614,614,618,14,17,15,16,1,2,3,1,9,0,-4,-3,2,-1
970,965,965,965,17,16,15,16,1,1,2,1,5,0,0,1,1,-1
567,562,567,567,14,14,13,13,3,2,1,1,5,-5,0,0,1,0
684,670,660,660,13,14,15,13,2,3,2,1,14,10,0,-1,-1,2
210,210,215,210,14,17,15,16,2,2,2,1,0,-5,5,-3,2,-1
750,740,736,736,13,14,15,13,3,2,1,1,10,4,0,-1,-1,2
801,801,801,796,14,17,15,16,1,1,4,1,0,0,5,-3,2,-1
576,576,576,567,18,19,18,18,2,3,2,6,0,0,9,-1,1,0
328,318,318,314,21,19,21,19,1,2,2,1,10,0,4,2,-2,2
618,614,618,609,14,14,13,13,1,2,3,2,4,-4,9,0,1,0
412,384,384,384,17,16,15,16,1,1,1,1,28,0,0,1,1,-1
309,314,309,309,18,17,18,19,1,3,1,1,-5,5,0,1,-1,-1
1073,201,1059,1059,13,14,12,13,2,1,1,2,872,-858,0,-1,2,-1
529,506,506,501,14,14,13,13,2,1,2,2,23,0,5,0,1,0
253,253,257,267,18,17,18,18,2,2,2,3,0,-4,-10,1,-1,0
1050,1045,1045,1045,20,19,20,18,3,1,1,1,5,0,0,1,-1,2
946,937,937,942,13,14,12,13,3,4,3,1,9,0,-5,-1,2,-1
346,342,342,337,13,16,15,16,3,1,1,2,4,0,5,-3,1,-1
754,750,754,745,20,19,20,21,3,3,2,2,4,-4,9,1,-1,-1
539,534,534,529,14,14,13,13,2,2,1,2,5,0,5,0,1,0
407,398,398,398,13,14,12,13,1,3,2,1,9,0,0,-1,2,-1
524,520,520,520,18,17,18,19,1,1,1,1,4,0,0,1,-1,-1
417,417,412,407,20,19,18,18,3,1,3,2,0,5,5,1,1,0
600,604,600,600,14,14,13,13,2,1,1,1,-4,4,0,0,1,0
271,271,271,267,18,19,18,18,2,2,2,1,0,0,4,-1,1,0
389,384,384,379,17,16,18,16,2,2,2,2,5,0,5,1,-2,2
332,332,332,332,20,19,20,18,1,1,1,1,0,0,0,1,-1,2
726,721,721,717,13,14,12,13,1,2,4,2,5,0,4,-1,2,-1
993,984,979,979,17,19,18,18,2,2,3,1,9,5,0,-2,1,0
1064,1059,1054,1054,13,14,12,13,2,3,1,2,5,5,0,-1,2,-1
557,562,562,557,14,17,15,16,2,1,3,2,-5,0,5,-3,2,-1
979,974,974,974,17,16,18,16,1,2,1,1,5,0,0,1,-2,2
1007,1003,1003,993,13,14,15,13,1,3,1,4,4,0,10,-1,-1,2
989,984,984,1017,17,16,15,16,2,1,1,1,5,0,-33,1,1,-1
834,834,829,829,14,17,15,16,1,1,1,1,0,5,0,-3,2,-1
590,590,586,586,14,17,15,16,2,1,1,2,0,4,0,-3,2,-1
590,586,586,581,14,17,15,16,3,1,1,3,4,0,5,-3,2,-1
604,600,604,604,18,19,18,19,1,2,1,1,4,-4,0,-1,1,-1
398,393,389,389,20,19,20,18,4,1,1,2,5,4,0,1,-1,2
206,192,192,192,18,17,18,19,1,2,1,2,14,0,0,1,-1,-1
473,468,464,468,13,16,15,16,2,1,3,1,5,4,-4,-3,1,-1
726,721,721,717,17,19,18,18,1,2,1,1,5,0,4,-2,1,0
370,356,351,351,13,14,12,13,2,4,1,2,14,5,0,-1,2,-1
614,609,614,609,18,19,21,19,1,2,2,1,5,-5,5,-1,-2,2
974,974,974,974,20,19,20,21,2,1,1,1,0,0,0,1,-1,-1
604,595,600,600,18,19,18,19,2,3,1,1,9,-5,0,-1,1,-1
220,206,206,206,18,19,18,19,2,2,2,1,14,0,0,-1,1,-1
224,215,215,215,18,17,18,16,3,2,1,1,9,0,0,1,-1,2
309,300,300,309,18,17,18,16,1,2,2,1,9,0,-9,1,-1,2
993,989,989,984,20,19,20,21,2,1,2,2,4,0,5,1,-1,-1
698,693,693,693,20,19,20,18,2,1,3,1,5,0,0,1,-1,2
182,192,1078,1073,18,17,18,18,1,1,1,2,-10,-886,5,1,-1,0
862,857,857,857,14,14,13,13,1,3,1,3,5,0,0,0,1,0
656,651,656,651,20,19,18,18,2,1,3,3,5,-5,5,1,1,0
426,426,421,421,20,19,20,21,1,1,1,1,0,5,0,1,-1,-1
1017,1012,1012,1012,13,16,15,16,1,2,4,1,5,0,0,-3,1,-1
900,890,895,890,14,14,13,13,1,2,1,2,10,-5,5,0,1,0
1007,1003,993,993,17,16,15,16,3,3,3,2,4,10,0,1,1,-1
693,684,679,679,13,16,15,16,2,3,2,1,9,5,0,-3,1,-1
787,782,773,773,18,19,18,18,3,1,2,2,5,9,0,-1,1,0
543,539,529,524,14,17,15,16,2,3,1,2,4,10,5,-3,2,-1
1021,1021,1021,1017,17,16,18,18,3,1,2,1,0,0,4,1,-2,0
196,192,192,192,14,14,15,13,3,3,2,1,4,0,0,0,-1,2
576,557,562,562,14,14,13,13,3,1,4,2,19,-5,0,0,1,0
571,567,567,562,14,17,15,16,4,1,2,4,4,0,5,-3,2,-1
412,403,393,389,17,16,15,16,2,1,1,1,9,10,4,1,1,-1
323,323,323,323,14,14,15,13,2,3,2,1,0,0,0,0,-1,2
365,360,360,360,20,19,18,18,1,3,1,2,5,0,0,1,1,0
1059,1059,1054,1054,20,19,20,21,2,1,1,3,0,5,0,1,-1,-1
843,843,839,834,14,14,15,13,3,1,1,2,0,4,5,0,-1,2
524,520,520,524,21,19,20,19,2,1,1,1,4,0,-4,2,-1,1
487,473,468,468,14,14,15,13,2,2,3,2,14,5,0,0,-1,2
937,932,928,923,20,19,21,19,2,1,1,2,5,4,5,1,-2,2
239,229,239,239,14,14,13,13,1,2,2,1,10,-10,0,0,1,0
459,450,450,450,17,16,18,18,2,2,3,1,9,0,0,1,-2,0
309,290,281,281,14,14,15,13,1,2,1,2,19,9,0,0,-1,2
689,684,689,684,13,14,15,13,2,2,3,2,5,-5,5,-1,-1,2
1054,1045,1045,1040,13,14,15,13,2,2,1,2,9,0,5,-1,-1,2
989,979,974,965,13,14,12,13,2,3,2,2,10,5,9,-1,2,-1
937,932,932,932,20,19,20,18,1,2,1,1,5,0,0,1,-1,2
876,871,876,871,14,17,15,16,2,3,2,2,5,-5,5,-3,2,-1
431,426,421,421,20,19,18,18,1,2,1,1,5,5,0,1,1,0
792,792,787,796,14,14,15,16,2,4,1,1,0,5,-9,0,-1,-1
215,201,206,201,18,19,18,19,2,2,4,2,14,-5,5,-1,1,-1
993,993,993,989,13,14,15,13,3,3,1,4,0,0,4,-1,-1,2
904,904,900,900,14,17,15,16,1,3,1,3,0,4,0,-3,2,-1
239,239,234,234,21,19,20,21,1,5,1,1,0,5,0,2,-1,-1
895,867,867,867,14,14,13,13,1,2,6,1,28,0,0,0,1,0
187,182,1078,1078,14,14,13,13,3,1,1,1,5,-896,0,0,1,0
534,529,529,524,21,19,20,19,1,1,2,1,5,0,5,2,-1,1
843,843,839,843,14,17,15,16,2,1,2,1,0,4,-4,-3,2,-1
918,914,1017,909,18,17,18,16,1,4,1,2,4,-103,108,1,-1,2
918,918,914,909,18,17,18,19,2,1,2,1,0,4,5,1,-1,-1
1003,998,998,998,13,14,12,13,1,1,1,1,5,0,0,-1,2,-1
1007,993,993,989,13,14,15,13,3,2,1,5,14,0,4,-1,-1,2
1068,1059,1059,1059,13,14,15,13,2,1,2,1,9,0,0,-1,-1,2
731,721,721,721,13,14,15,13,1,2,3,2,10,0,0,-1,-1,2
206,201,201,196,14,14,13,13,1,3,2,2,5,0,5,0,1,0
590,581,586,586,14,17,15,16,3,2,1,3,9,-5,0,-3,2,-1
543,539,529,529,21,19,20,21,1,1,1,1,4,10,0,2,-1,-1
187,1073,1073,1073,21,19,20,21,1,2,1,3,-886,0,0,2,-1,-1
267,257,257,257,14,14,13,13,1,3,3,3,10,0,0,0,1,0
548,539,539,792,14,14,15,13,1,1,1,1,9,0,-253,0,-1,2
829,824,815,810,18,19,18,19,1,1,1,1,5,9,5,-1,1,-1
993,993,989,993,20,19,20,21,1,1,4,1,0,4,-4,1,-1,-1
515,510,510,506,14,14,13,13,2,2,2,3,5,0,4,0,1,0
768,764,764,764,20,19,20,18,1,2,1,2,4,0,0,1,-1,2
187,1073,1068,1064,21,19,20,18,2,2,3,1,-886,5,4,2,-1,2
1045,1036,1036,1036,13,14,15,16,2,2,3,2,9,0,0,-1,-1,-1
515,506,515,515,18,17,18,19,1,1,2,1,9,-9,0,1,-1,-1
595,590,590,586,18,19,18,19,1,1,2,1,5,0,4,-1,1,-1
220,220,215,215,14,14,13,13,2,3,1,3,0,5,0,0,1,0
604,604,604,600,18,19,18,19,2,1,2,2,0,0,4,-1,1,-1
970,965,970,974,20,19,18,18,3,2,2,1,5,-5,-4,1,1,0
286,276,281,276,21,19,20,18,1,2,2,1,10,-5,5,2,-1,2
360,356,365,365,20,19,18,18,1,2,1,3,4,-9,0,1,1,0
257,253,248,243,18,19,18,18,2,1,1,2,4,5,5,-1,1,0
337,342,332,337,20,19,20,21,3,1,1,2,-5,10,-5,1,-1,-1
262,257,262,257,18,17,18,18,1,2,2,1,5,-5,5,1,-1,0
581,571,567,567,14,14,15,16,3,2,1,3,10,4,0,0,-1,-1
286,351,286,281,18,19,18,16,1,2,2,2,-65,65,5,-1,1,2
637,623,623,628,13,14,15,13,2,2,1,1,14,0,-5,-1,-1,2
478,473,478,468,17,16,18,18,2,1,2,1,5,-5,10,1,-2,0
487,473,478,473,14,14,15,13,2,2,1,3,14,-5,5,0,-1,2
492,482,487,482,14,17,15,16,3,2,2,1,10,-5,5,-3,2,-1
623,618,618,623,18,19,18,19,1,2,1,1,5,0,-5,-1,1,-1
1012,1007,1012,1003,13,14,15,16,1,3,1,2,5,-5,9,-1,-1,-1
220,210,206,210,14,17,15,16,2,2,1,1,10,4,-4,-3,2,-1
393,389,389,384,17,16,18,18,3,3,2,1,4,0,5,1,-2,0
210,206,201,206,18,17,18,16,1,1,5,1,4,5,-5,1,-1,2
665,651,651,651,13,16,15,16,2,2,1,2,14,0,0,-3,1,-1
224,220,215,215,21,19,20,21,3,2,1,1,4,5,0,2,-1,-1
736,736,726,731,17,16,15,16,2,5,3,1,0,10,-5,1,1,-1
365,360,365,365,20,19,18,18,2,2,2,2,5,-5,0,1,1,0
445,445,440,440,13,14,15,13,1,2,1,1,0,5,0,-1,-1,2
571,571,571,567,14,14,13,13,5,3,1,2,0,0,4,0,1,0
210,215,210,206,14,14,15,13,2,2,2,2,-5,5,4,0,-1,2
581,571,567,562,14,14,15,16,1,3,2,1,10,4,5,0,-1,-1
220,210,220,215,14,14,15,13,3,2,1,2,10,-10,5,0,-1,2
267,253,253,253,14,17,15,16,2,1,2,2,14,0,0,-3,2,-1
839,839,839,834,14,17,15,16,2,2,2,2,0,0,5,-3,2,-1
346,346,351,351,13,16,15,16,3,2,2,1,0,-5,0,-3,1,-1
801,796,796,796,18,19,18,19,2,1,2,1,5,0,0,-1,1,-1
820,815,829,820,18,19,18,19,3,2,2,1,5,-14,9,-1,1,-1
970,965,970,965,17,16,18,16,3,2,2,1,5,-5,5,1,-2,2
759,754,759,754,20,19,20,18,1,1,1,1,5,-5,5,1,-1,2
768,759,764,759,20,19,20,18,3,2,2,2,9,-5,5,1,-1,2
693,689,689,689,17,16,15,16,1,2,1,1,4,0,0,1,1,-1
764,759,759,759,17,16,18,18,3,1,3,1,5,0,0,1,-2,0
590,567,567,576,14,14,13,13,1,2,3,1,23,0,-9,0,1,0
974,970,960,965,20,19,20,21,2,2,1,1,4,10,-5,1,-1,-1
768,768,759,759,13,14,15,13,3,3,1,3,0,9,0,-1,-1,2
304,295,295,295,18,19,18,19,3,1,2,1,9,0,0,-1,1,-1
267,262,253,248,14,14,13,13,2,1,1,2,5,9,5,0,1,0
810,810,806,806,14,14,15,13,2,3,3,1,0,4,0,0,-1,2
979,974,970,970,13,14,15,16,2,1,2,1,5,4,0,-1,-1,-1
674,665,665,670,20,19,18,18,2,1,1,1,9,0,-5,1,1,0
557,548,553,548,14,14,15,13,3,2,1,3,9,-5,5,0,-1,2
792,787,787,787,18,17,18,19,2,2,3,2,5,0,0,1,-1,-1
890,881,876,881,14,17,15,16,1,3,3,1,9,5,-5,-3,2,-1
703,698,693,693,13,14,15,13,1,3,2,4,5,5,0,-1,-1,2
407,403,398,398,20,19,20,21,1,1,1,3,4,5,0,1,-1,-1
337,337,332,332,13,14,13,13,2,1,1,1,0,5,0,-1,1,0
548,548,548,553,18,17,18,18,1,1,1,1,0,0,-5,1,-1,0
450,445,450,450,20,19,20,21,2,1,1,1,5,-5,0,1,-1,-1
370,365,365,360,13,14,15,13,1,3,1,2,5,0,5,-1,-1,2
417,412,412,412,17,16,15,16,3,2,1,2,5,0,0,1,1,-1
510,510,506,506,14,17,15,16,2,1,1,1,0,4,0,-3,2,-1
487,482,478,473,21,19,20,21,1,1,1,1,5,4,5,2,-1,-1
731,721,721,726,17,16,15,16,1,2,2,1,10,0,-5,1,1,-1
604,600,595,595,18,19,18,19,2,2,1,2,4,5,0,-1,1,-1
454,450,450,450,17,16,18,16,3,1,1,1,4,0,0,1,-2,2
1050,1045,1040,1045,20,19,20,21,2,2,2,1,5,5,-5,1,-1,-1
951,421,946,942,17,14,18,16,3,1,2,1,530,-525,4,3,-4,2
393,398,389,389,17,19,18,18,1,3,1,2,-5,9,0,-2,1,0
740,740,740,736,17,16,15,16,1,1,1,2,0,0,4,1,1,-1
759,754,759,750,13,14,15,13,2,3,2,2,5,-5,9,-1,-1,2
314,314,309,309,14,14,15,13,2,3,1,1,0,5,0,0,-1,2
703,707,703,698,13,16,15,16,1,3,1,2,-4,4,5,-3,1,-1
998,989,984,984,20,19,20,18,4,2,1,1,9,5,0,1,-1,2
693,684,684,684,17,16,15,16,2,2,1,3,9,0,0,1,1,-1
374,370,370,370,20,19,20,18,3,1,2,1,4,0,0,1,-1,2
942,937,932,937,20,19,20,21,1,2,1,3,5,5,-5,1,-1,-1
740,736,736,736,17,16,15,16,1,2,1,1,4,0,0,1,1,-1
374,360,365,374,13,14,12,13,2,2,1,3,14,-5,-9,-1,2,-1
942,937,932,937,20,19,18,18,2,3,1,1,5,5,-5,1,1,0
487,487,492,487,18,19,18,19,1,1,2,2,0,-5,5,-1,1,-1
970,970,970,970,13,14,15,13,1,1,1,3,0,0,0,-1,-1,2
806,801,796,796,14,14,13,13,1,2,1,1,5,5,0,0,1,0
529,524,524,520,18,19,18,19,3,1,2,1,5,0,4,-1,1,-1
220,220,220,215,14,14,15,16,1,1,2,1,0,0,5,0,-1,-1
421,421,421,421,13,14,12,13,1,3,2,3,0,0,0,-1,2,-1
454,450,445,445,13,16,15,16,2,2,1,1,4,5,0,-3,1,-1
243,234,243,239,14,14,13,13,1,4,2,2,9,-9,4,0,1,0
1040,1040,1045,1036,13,14,12,13,2,3,2,2,0,-5,9,-1,2,-1
290,281,290,281,18,19,18,19,3,2,2,2,9,-9,9,-1,1,-1
787,787,787,782,21,19,21,21,3,1,2,1,0,0,5,2,-2,0
210,187,182,192,14,14,13,13,3,1,1,3,23,5,-10,0,1,0
773,764,768,764,20,19,20,18,1,2,1,1,9,-4,4,1,-1,2
796,796,796,792,14,14,15,13,3,3,2,3,0,0,4,0,-1,2
229,234,229,229,14,14,15,13,3,2,2,1,-5,5,0,0,-1,2
693,684,684,679,13,14,15,13,1,3,1,2,9,0,5,-1,-1,2
665,646,660,660,17,16,15,16,1,1,1,3,19,-14,0,1,1,-1
318,309,309,431,14,14,15,16,2,2,2,1,9,0,-122,0,-1,-1
356,351,351,351,17,16,15,16,3,2,1,1,5,0,0,1,1,-1
346,342,342,342,20,19,18,18,1,1,1,1,4,0,0,1,1,0
1012,1007,998,1003,13,14,12,13,1,5,5,1,5,9,-5,-1,2,-1
778,773,773,773,13,14,15,13,1,3,1,1,5,0,0,-1,-1,2
1003,989,1003,993,13,14,12,13,1,2,1,1,14,-14,10,-1,2,-1
989,984,993,993,20,19,18,18,2,2,1,1,5,-9,0,1,1,0
674,670,665,665,20,19,20,18,1,2,2,1,4,5,0,1,-1,2
895,890,890,895,21,19,20,21,2,4,1,1,5,0,-5,2,-1,-1
229,220,215,215,14,17,15,16,1,3,3,1,9,5,0,-3,2,-1
234,224,229,224,18,17,18,19,1,2,1,2,10,-5,5,1,-1,-1
773,764,768,759,17,16,15,16,1,1,1,2,9,-4,9,1,1,-1
974,965,965,960,20,19,18,18,1,3,1,2,9,0,5,1,1,0
229,229,234,234,18,19,18,18,2,2,1,1,0,-5,0,-1,1,0
323,314,314,314,14,14,15,13,3,2,3,1,9,0,0,0,-1,2
1036,1026,1031,1040,17,16,15,16,2,1,1,1,10,-5,-9,1,1,-1
1031,1031,1026,1026,13,16,15,16,1,2,1,3,0,5,0,-3,1,-1
984,974,979,974,20,19,18,18,1,2,2,1,10,-5,5,1,1,0
918,909,923,914,21,19,21,21,3,2,1,3,9,-14,9,2,-2,0
792,764,778,778,14,14,13,13,1,3,2,1,28,-14,0,0,1,0
506,482,487,482,14,14,13,13,1,2,2,1,24,-5,5,0,1,0
239,234,234,234,14,14,13,13,1,3,3,1,5,0,0,0,1,0
276,271,271,271,14,14,15,16,2,2,1,1,5,0,0,0,-1,-1
998,993,989,989,20,19,20,18,1,2,1,1,5,4,0,1,-1,2
346,342,337,337,17,16,18,16,1,2,1,1,4,5,0,1,-2,2
276,267,257,253,14,17,15,16,1,3,1,4,9,10,4,-3,2,-1
389,384,389,379,13,14,15,13,2,2,2,2,5,-5,10,-1,-1,2
726,721,721,717,13,14,15,13,3,5,3,2,5,0,4,-1,-1,2
187,192,187,187,14,14,13,13,2,2,3,1,-5,5,0,0,1,0
224,220,210,210,14,14,15,13,1,1,1,3,4,10,0,0,-1,2
989,979,984,984,17,16,15,16,3,1,2,1,10,-5,0,1,1,-1
960,965,960,960,13,16,15,16,3,2,3,2,-5,5,0,-3,1,-1
417,421,412,407,13,14,15,13,1,2,2,4,-4,9,5,-1,-1,2
970,960,956,956,20,19,20,21,2,1,1,1,10,4,0,1,-1,-1
510,506,506,506,18,19,18,19,2,3,1,1,4,0,0,-1,1,-1
1068,1064,1064,1064,13,14,15,13,3,4,1,1,4,0,0,-1,-1,2
768,768,764,764,17,16,18,18,3,1,2,1,0,4,0,1,-2,0
454,450,445,445,17,16,18,18,2,1,1,1,4,5,0,1,-2,0
721,721,717,717,20,19,20,21,3,1,1,1,0,4,0,1,-1,-1
543,534,534,534,14,14,15,16,2,2,1,2,9,0,0,0,-1,-1
450,445,450,445,20,19,20,21,2,2,2,4,5,-5,5,1,-1,-1
314,309,309,309,18,17,18,16,1,2,1,1,5,0,0,1,-1,2
506,501,501,501,14,14,13,13,3,3,2,1,5,0,0,0,1,0
529,529,529,524,21,19,20,21,1,1,3,3,0,0,5,2,-1,-1
412,403,407,403,17,16,18,18,1,2,2,2,9,-4,4,1,-2,0
712,707,707,717,17,16,18,18,1,2,1,1,5,0,-10,1,-2,0
768,759,768,768,13,14,12,13,3,4,2,1,9,-9,0,-1,2,-1
482,482,478,478,21,19,20,21,1,1,1,1,0,4,0,2,-1,-1
248,234,234,229,14,14,15,13,3,1,2,2,14,0,5,0,-1,2
506,501,496,496,14,14,15,13,1,2,1,1,5,5,0,0,-1,2
543,543,543,539,18,17,18,18,2,1,4,2,0,0,4,1,-1,0
834,824,829,824,14,17,15,16,1,1,2,1,10,-5,5,-3,2,-1
1059,1050,1045,1040,13,14,12,13,2,4,1,2,9,5,5,-1,2,-1
604,595,595,600,14,14,13,13,1,3,1,1,9,0,-5,0,1,0
862,867,867,862,14,14,15,13,1,1,1,1,-5,0,5,0,-1,2
398,393,389,389,17,19,18,18,1,1,3,2,5,4,0,-2,1,0
473,468,468,468,17,16,18,16,3,3,2,1,5,0,0,1,-2,2
370,365,360,360,20,19,20,21,1,2,1,1,5,5,0,1,-1,-1
337,337,337,337,13,14,12,13,3,3,2,3,0,0,0,-1,2,-1
271,267,267,262,18,19,18,18,1,3,2,1,4,0,5,-1,1,0
820,820,820,815,14,14,13,13,1,3,1,1,0,0,5,0,1,0
1007,998,989,989,20,19,18,18,1,3,1,3,9,9,0,1,1,0
1003,998,993,993,17,19,18,18,2,2,1,1,5,5,0,-2,1,0
782,773,778,773,14,16,15,16,1,2,2,2,9,-5,5,-2,1,-1
281,281,276,281,18,19,18,19,3,1,1,1,0,5,-5,-1,1,-1
346,309,318,323,20,19,18,19,1,2,2,3,37,-9,-5,1,1,-1
262,243,243,239,14,17,15,16,3,2,2,1,19,0,4,-3,2,-1
248,248,243,243,21,19,20,18,2,1,1,1,0,5,0,2,-1,2
417,412,412,407,20,19,20,18,3,1,1,1,5,0,5,1,-1,2
576,571,571,567,18,19,18,18,1,1,2,2,5,0,4,-1,1,0
637,637,637,632,13,14,15,13,1,1,2,1,0,0,5,-1,-1,2
496,492,496,496,18,17,18,19,3,2,2,1,4,-4,0,1,-1,-1
618,604,600,604,14,17,15,16,3,1,1,1,14,4,-4,-3,2,-1
843,843,843,839,18,19,18,18,3,3,2,2,0,0,4,-1,1,0
787,787,778,773,21,19,20,18,2,2,1,2,0,9,5,2,-1,2
731,726,731,726,17,16,18,16,2,3,2,2,5,-5,5,1,-2,2
487,482,487,482,18,17,18,16,3,1,2,1,5,-5,5,1,-1,2
707,707,707,703,13,14,15,16,1,3,2,1,0,0,4,-1,-1,-1
384,379,374,379,13,14,12,13,3,3,1,2,5,5,-5,-1,2,-1
1021,1012,1007,1003,20,19,20,18,2,3,1,2,9,5,4,1,-1,2
548,524,524,529,14,17,15,16,3,2,1,1,24,0,-5,-3,2,-1
342,346,342,342,13,14,15,13,1,3,1,1,-4,4,0,-1,-1,2
646,642,651,646,17,16,18,16,1,2,6,1,4,-9,5,1,-2,2
253,248,248,248,18,19,18,18,3,3,1,1,5,0,0,-1,1,0
900,895,886,881,18,17,18,16,1,3,2,3,5,9,5,1,-1,2
1045,1036,1040,1036,17,16,18,16,3,2,1,2,9,-4,4,1,-2,2
871,867,867,867,18,17,18,16,1,2,2,1,4,0,0,1,-1,2
843,839,843,843,21,19,20,21,2,3,3,1,4,-4,0,2,-1,-1
792,787,787,782,18,17,18,19,1,1,1,2,5,0,5,1,-1,-1
421,412,412,407,17,16,15,16,2,2,1,2,9,0,5,1,1,-1
492,496,492,492,14,17,15,16,2,1,1,3,-4,4,0,-3,2,-1
918,914,914,914,18,19,18,19,1,1,1,1,4,0,0,-1,1,-1
618,618,618,618,21,19,21,21,1,2,1,1,0,0,0,2,-2,0
365,346,346,351,17,16,18,16,4,2,1,1,19,0,-5,1,-2,2
464,454,459,454,20,19,18,18,2,2,1,1,10,-5,5,1,1,0
679,674,674,674,17,16,15,16,2,2,1,1,5,0,0,1,1,-1
450,445,440,440,17,16,18,18,3,1,1,1,5,5,0,1,-2,0
792,792,792,787,14,14,13,13,3,3,1,1,0,0,5,0,1,0
886,886,886,890,21,19,20,21,2,1,1,1,0,0,-4,2,-1,-1
759,750,750,750,13,14,15,13,3,3,1,1,9,0,0,-1,-1,2
881,871,871,867,18,17,18,18,2,2,2,1,10,0,4,1,-1,0
984,979,984,979,17,16,15,16,2,1,3,1,5,-5,5,1,1,-1
932,928,923,928,17,17,15,16,1,1,1,1,4,5,-5,0,2,-1
1026,1012,1017,1012,17,16,15,16,1,2,2,3,14,-5,5,1,1,-1
445,440,440,436,17,16,18,16,3,1,2,3,5,0,4,1,-2,2
445,440,440,436,17,16,18,16,3,3,1,2,5,0,4,1,-2,2
642,642,642,642,13,14,12,13,2,3,1,1,0,0,0,-1,2,-1
267,248,248,243,18,19,18,18,1,2,2,1,19,0,5,-1,1,0
553,543,543,534,14,14,15,13,1,1,3,2,10,0,9,0,-1,2
787,782,778,778,18,19,18,18,1,1,2,1,5,4,0,-1,1,0
496,482,487,492,14,17,15,16,5,2,1,1,14,-5,-5,-3,2,-1
276,276,271,271,14,14,13,13,3,1,3,3,0,5,0,0,1,0
271,267,262,267,18,17,18,18,1,1,3,5,4,5,-5,1,-1,0
1050,1050,1050,1050,20,19,20,21,3,2,1,1,0,0,0,1,-1,-1
389,384,384,379,20,19,20,18,4,1,1,3,5,0,5,1,-1,2
642,632,637,637,13,14,12,13,1,2,1,1,10,-5,0,-1,2,-1
253,253,253,253,14,14,15,13,1,1,2,1,0,0,0,0,-1,2
834,829,829,834,18,17,18,18,1,2,1,2,5,0,-5,1,-1,0
346,337,337,332,17,16,15,16,1,3,2,1,9,0,5,1,1,-1
318,309,304,304,14,14,15,13,3,1,1,3,9,5,0,0,-1,2
942,932,932,937,20,19,20,18,1,2,1,1,10,0,-5,1,-1,2
1017,1021,1017,1012,17,16,15,16,1,3,1,2,-4,4,5,1,1,-1
848,843,843,839,21,19,20,21,1,2,2,2,5,0,4,2,-1,-1
745,740,740,740,20,19,20,18,2,1,1,1,5,0,0,1,-1,2
510,506,506,506,14,14,15,13,1,3,2,1,4,0,0,0,-1,2
1026,1026,1026,1026,13,14,15,16,3,3,2,1,0,0,0,-1,-1,-1
993,824,824,824,13,14,13,13,1,3,2,1,169,0,0,-1,1,0
229,229,224,220,14,14,13,13,3,2,3,1,0,5,4,0,1,0
914,900,914,909,14,14,13,13,1,5,1,2,14,-14,5,0,1,0
871,867,867,867,21,19,20,21,1,1,1,3,4,0,0,2,-1,-1
192,182,187,187,14,14,15,13,1,2,2,1,10,-5,0,0,-1,2
703,703,698,698,20,19,20,18,1,1,2,1,0,5,0,1,-1,2
557,557,557,553,21,19,20,18,2,1,2,2,0,0,4,2,-1,2
515,501,506,506,14,17,15,16,1,4,1,1,14,-5,0,-3,2,-1
886,881,871,871,14,14,15,13,1,2,3,3,5,10,0,0,-1,2
628,618,609,609,18,17,18,16,1,1,3,1,10,9,0,1,-1,2
909,895,886,886,18,17,18,16,1,1,1,1,14,9,0,1,-1,2
267,267,267,267,21,19,20,18,2,1,3,1,0,0,0,2,-1,2
436,445,431,431,17,16,15,16,2,1,1,2,-9,14,0,1,1,-1
342,342,337,337,13,14,15,13,3,1,1,3,0,5,0,-1,-1,2
201,192,187,182,14,14,13,13,2,2,2,2,9,5,5,0,1,0
646,642,646,642,13,14,15,13,1,2,2,1,4,-4,4,-1,-1,2
642,637,632,632,20,19,20,18,2,1,1,1,5,5,0,1,-1,2
210,206,206,206,14,14,15,13,1,2,1,3,4,0,0,0,-1,2
792,782,778,778,18,17,18,16,3,1,1,1,10,4,0,1,-1,2
510,510,492,496,14,14,15,13,1,3,2,2,0,18,-4,0,-1,2
792,768,768,759,18,16,18,16,1,2,1,2,24,0,9,2,-2,2
689,679,684,684,17,16,15,16,2,2,2,1,10,-5,0,1,1,-1
421,417,421,417,13,16,15,16,2,4,1,2,4,-4,4,-3,1,-1
393,384,379,379,17,16,15,16,3,2,2,2,9,5,0,1,1,-1
993,993,989,989,20,19,20,18,1,3,1,4,0,4,0,1,-1,2
984,984,979,979,13,14,15,13,1,3,2,2,0,5,0,-1,-1,2
768,759,764,764,20,19,20,21,2,2,2,2,9,-5,0,1,-1,-1
951,951,951,951,13,14,12,13,5,1,3,3,0,0,0,-1,2,-1
351,346,342,342,13,14,12,13,1,3,1,1,5,4,0,-1,2,-1
1031,1031,1026,1031,17,16,18,18,1,3,1,1,0,5,-5,1,-2,0
1017,1012,1007,1012,13,16,15,16,2,2,3,1,5,5,-5,-3,1,-1
979,979,979,974,20,19,18,18,1,3,3,1,0,0,5,1,1,0
707,703,703,698,13,14,15,13,3,3,2,2,4,0,5,-1,-1,2
520,520,515,614,14,17,15,13,3,1,1,1,0,5,-99,-3,2,2
736,726,731,731,20,19,20,18,1,2,1,1,10,-5,0,1,-1,2
412,407,567,407,20,19,18,21,2,1,1,1,5,-160,160,1,1,-3
928,918,918,918,14,17,15,16,1,4,2,3,10,0,0,-3,2,-1
618,614,618,614,14,14,15,13,4,2,2,1,4,-4,4,0,-1,2
506,496,506,506,14,17,15,16,1,2,2,1,10,-10,0,-3,2,-1
1073,1073,1073,1073,13,14,15,13,1,2,2,2,0,0,0,-1,-1,2
562,562,562,590,14,14,15,13,2,3,2,1,0,0,-28,0,-1,2
290,290,290,290,18,19,20,19,3,1,1,3,0,0,0,-1,-1,1
693,684,684,679,17,16,18,18,1,1,1,1,9,0,5,1,-2,0
290,286,286,286,18,17,18,16,1,1,1,1,4,0,0,1,-1,2
295,286,286,286,14,14,15,13,1,2,3,2,9,0,0,0,-1,2
712,707,707,703,20,19,18,18,3,2,1,2,5,0,4,1,1,0
782,773,778,778,21,19,20,21,1,2,1,1,9,-5,0,2,-1,-1
848,815,806,806,14,14,15,13,3,2,1,1,33,9,0,0,-1,2
510,506,510,506,14,17,15,16,1,3,2,2,4,-4,4,-3,2,-1
431,421,426,421,13,14,15,13,3,2,2,3,10,-5,5,-1,-1,2
1050,1045,1050,1045,20,19,18,18,3,4,1,2,5,-5,5,1,1,0
468,468,468,464,20,19,20,18,3,1,2,2,0,0,4,1,-1,2
300,290,290,290,14,17,15,16,2,1,1,1,10,0,0,-3,2,-1
454,450,445,445,13,14,15,13,1,2,2,1,4,5,0,-1,-1,2
1017,1003,998,993,17,16,18,16,1,1,2,2,14,5,5,1,-2,2
1045,1045,1036,1036,17,16,18,18,1,1,3,1,0,9,0,1,-2,0
224,215,210,210,18,17,18,16,3,1,3,2,9,5,0,1,-1,2
1068,1059,1054,1054,20,19,20,21,2,1,3,1,9,5,0,1,-1,-1
243,243,234,239,14,14,15,16,2,3,1,1,0,9,-5,0,-1,-1
201,201,192,192,18,19,18,19,1,2,4,2,0,9,0,-1,1,-1
834,824,824,829,14,17,15,16,2,2,1,1,10,0,-5,-3,2,-1
773,773,768,768,20,19,20,21,2,1,1,1,0,5,0,1,-1,-1
792,792,792,787,18,19,18,19,3,1,2,1,0,0,5,-1,1,-1
220,660,196,192,14,16,13,13,1,1,2,2,-440,464,4,-2,3,0
618,614,609,614,14,17,15,16,1,3,1,1,4,5,-5,-3,2,-1
993,993,984,984,17,16,18,16,2,3,1,3,0,9,0,1,-2,2
379,370,370,370,13,14,15,16,4,1,2,1,9,0,0,-1,-1,-1
379,379,384,384,20,19,20,21,1,3,1,1,0,-5,0,1,-1,-1
810,801,801,796,14,14,13,13,2,4,1,1,9,0,5,0,1,0
548,543,543,539,18,17,18,16,3,1,1,2,5,0,4,1,-1,2
234,220,220,220,14,17,15,16,3,3,2,1,14,0,0,-3,2,-1
998,993,993,993,13,14,12,13,5,1,1,2,5,0,0,-1,2,-1
646,637,646,637,13,16,15,16,2,1,6,3,9,-9,9,-3,1,-1
900,895,895,890,21,19,20,21,1,2,1,2,5,0,5,2,-1,-1
318,314,314,309,14,14,15,16,2,1,2,1,4,0,5,0,-1,-1
618,609,600,600,14,17,15,16,1,1,1,1,9,9,0,-3,2,-1
187,187,187,187,14,17,15,16,1,1,2,1,0,0,0,-3,2,-1
839,839,829,829,14,14,15,13,1,3,3,2,0,10,0,0,-1,2
609,595,595,595,21,19,20,19,1,1,1,1,14,0,0,2,-1,1
900,895,895,890,14,17,15,16,2,1,2,1,5,0,5,-3,2,-1
464,454,459,454,13,14,15,16,3,2,3,1,10,-5,5,-1,-1,-1
286,276,262,262,14,14,13,13,1,1,2,1,10,14,0,0,1,0
651,646,646,646,13,14,12,13,1,5,3,3,5,0,0,-1,2,-1
571,562,557,557,14,14,15,13,1,3,1,1,9,5,0,0,-1,2
543,539,543,539,18,19,18,18,1,2,2,1,4,-4,4,-1,1,0
323,318,314,309,14,17,15,16,1,1,2,2,5,4,5,-3,2,-1
510,510,515,515,18,17,18,19,1,4,2,1,0,-5,0,1,-1,-1
1045,1040,1040,1045,13,14,12,13,3,3,1,1,5,0,-5,-1,2,-1
1073,1073,1073,1068,13,14,12,13,1,1,4,1,0,0,5,-1,2,-1
665,656,665,660,13,14,12,13,2,2,2,1,9,-9,5,-1,2,-1
290,281,286,286,14,14,15,16,2,2,1,3,9,-5,0,0,-1,-1
529,520,524,520,14,14,15,13,1,2,2,2,9,-4,4,0,-1,2
365,360,360,360,20,19,18,18,4,3,3,1,5,0,0,1,1,0
871,862,867,857,14,14,15,13,2,1,1,1,9,-5,10,0,-1,2
693,693,693,689,20,19,20,18,1,3,1,2,0,0,4,1,-1,2
960,956,956,956,13,14,15,13,3,2,1,2,4,0,0,-1,-1,2
379,374,374,370,13,14,15,13,1,1,1,1,5,0,4,-1,-1,2
478,473,473,473,17,16,18,18,1,2,1,2,5,0,0,1,-2,0
618,614,614,609,14,17,15,16,2,2,2,1,4,0,5,-3,2,-1
1073,1073,1073,1073,17,19,18,18,2,2,1,3,0,0,0,-2,1,0
815,806,815,815,18,17,18,16,2,2,1,1,9,-9,0,1,-1,2
1050,1045,1045,1040,17,16,15,16,1,2,1,2,5,0,5,1,1,-1
651,651,646,656,20,19,20,21,1,1,3,1,0,5,-10,1,-1,-1
360,356,356,356,17,16,15,16,3,2,1,1,4,0,0,1,1,-1
951,942,946,951,20,19,20,18,3,2,1,2,9,-4,-5,1,-1,2
295,290,290,290,14,17,15,16,1,1,2,1,5,0,0,-3,2,-1
262,257,257,253,14,14,15,13,5,3,3,2,5,0,4,0,-1,2
436,436,440,440,20,19,20,21,1,2,2,1,0,-4,0,1,-1,-1
356,351,351,356,17,16,18,18,3,2,1,3,5,0,-5,1,-2,0
403,398,393,389,17,16,18,18,2,1,2,2,5,5,4,1,-2,0
684,674,679,679,20,19,20,21,4,2,1,1,10,-5,0,1,-1,-1
614,600,590,595,14,14,13,13,3,2,1,3,14,10,-5,0,1,0
487,473,473,473,18,19,18,18,1,2,1,2,14,0,0,-1,1,0
778,773,778,773,20,19,20,21,1,2,1,2,5,-5,5,1,-1,-1
520,510,506,506,14,14,15,13,2,2,3,2,10,4,0,0,-1,2
286,276,276,281,18,19,18,19,1,2,1,2,10,0,-5,-1,1,-1
1040,1045,1040,1040,20,19,20,21,1,3,1,1,-5,5,0,1,-1,-1
271,267,267,267,21,19,20,21,2,2,1,3,4,0,0,2,-1,-1
309,300,304,295,18,19,18,19,3,2,1,2,9,-4,9,-1,1,-1
937,932,928,923,13,14,13,13,3,2,1,2,5,4,5,-1,1,0
829,829,834,824,14,14,15,13,1,1,2,2,0,-5,10,0,-1,2
989,984,970,974,20,19,18,18,1,1,1,1,5,14,-4,1,1,0
571,562,562,562,14,17,15,16,1,3,2,2,9,0,0,-3,2,-1
281,276,346,389,14,17,15,16,3,1,1,2,5,-70,-43,-3,2,-1
970,960,965,956,13,16,15,16,2,1,4,1,10,-5,9,-3,1,-1
501,506,501,506,14,14,13,13,2,3,2,1,-5,5,-5,0,1,0
1050,1040,1054,1050,17,16,15,16,3,1,1,1,10,-14,4,1,1,-1
801,792,796,792,21,19,21,21,4,2,2,2,9,-4,4,2,-2,0
604,595,590,590,14,14,13,13,1,3,2,1,9,5,0,0,1,0
342,342,337,337,20,19,20,18,2,1,1,2,0,5,0,1,-1,2
937,937,932,932,20,19,20,21,3,1,1,1,0,5,0,1,-1,-1
824,820,824,820,14,14,13,13,2,3,4,1,4,-4,4,0,1,0
698,693,693,689,13,14,12,13,2,2,3,2,5,0,4,-1,2,-1
562,557,562,562,18,19,18,18,2,1,2,1,5,-5,0,-1,1,0
960,956,314,946,20,19,21,21,3,3,1,2,4,642,-632,1,-2,0
773,768,778,773,13,16,15,16,1,2,2,2,5,-10,5,-3,1,-1
989,989,989,989,20,19,20,21,1,4,1,1,0,0,0,1,-1,-1
295,286,286,656,18,17,18,13,3,1,2,1,9,0,-370,1,-1,5
196,196,201,192,18,17,18,19,2,3,2,1,0,-5,9,1,-1,-1
1073,1068,1068,1064,20,19,18,18,2,2,2,2,5,0,4,1,1,0
618,609,614,614,18,17,18,19,1,2,1,2,9,-5,0,1,-1,-1
712,712,707,707,13,16,15,16,3,3,3,1,0,5,0,-3,1,-1
989,984,984,984,17,16,18,18,2,1,6,1,5,0,0,1,-2,0
309,384,295,300,18,19,18,19,3,1,1,1,-75,89,-5,-1,1,-1
689,684,684,679,13,14,15,13,1,2,3,1,5,0,5,-1,-1,2
1036,1026,1026,1026,13,14,15,16,3,2,2,1,10,0,0,-1,-1,-1
867,862,867,867,14,14,15,13,2,2,1,2,5,-5,0,0,-1,2
942,937,937,932,13,14,15,13,3,2,2,1,5,0,5,-1,-1,2
923,909,909,904,14,14,15,13,2,1,1,2,14,0,5,0,-1,2
984,979,974,970,20,19,20,18,2,1,1,2,5,5,4,1,-1,2
337,323,323,323,13,14,13,13,2,2,2,1,14,0,0,-1,1,0
998,989,984,979,13,14,15,13,1,1,1,1,9,5,5,-1,-1,2
1003,998,998,1003,17,16,18,18,3,2,1,1,5,0,-5,1,-2,0
365,356,360,360,20,19,20,21,2,1,1,1,9,-4,0,1,-1,-1
365,356,356,351,13,14,12,13,2,1,2,2,9,0,5,-1,2,-1
740,740,745,740,13,14,15,13,1,1,2,1,0,-5,5,-1,-1,2
496,496,496,496,18,17,18,19,2,4,1,1,0,0,0,1,-1,-1
1050,1040,1040,1031,13,14,12,13,2,2,2,1,10,0,9,-1,2,-1
806,806,806,806,14,17,15,16,2,2,2,4,0,0,0,-3,2,-1
318,318,318,328,14,17,15,16,1,2,3,1,0,0,-10,-3,2,-1
1031,1021,1036,1012,13,14,10,13,2,3,1,2,10,-15,24,-1,4,-3
1040,1040,1036,1031,13,14,15,13,3,1,3,2,0,4,5,-1,-1,2
323,318,318,318,14,14,15,16,1,2,1,1,5,0,0,0,-1,-1
923,923,918,918,21,19,21,21,1,1,1,1,0,5,0,2,-2,0
290,281,271,267,14,14,13,13,1,2,1,2,9,10,4,0,1,0
332,328,318,323,17,17,18,19,1,1,3,1,4,10,-5,0,-1,-1
956,946,543,937,17,16,18,18,2,1,1,1,10,403,-394,1,-2,0
965,956,960,956,13,14,15,13,2,1,2,1,9,-4,4,-1,-1,2
201,196,192,192,21,19,21,21,1,1,3,1,5,4,0,2,-2,0
206,196,192,192,18,17,18,19,1,2,1,1,10,4,0,1,-1,-1
196,192,192,187,18,19,18,19,3,1,2,3,4,0,5,-1,1,-1
445,440,440,440,17,19,18,18,2,1,1,1,5,0,0,-2,1,0
515,515,520,515,14,14,15,13,2,1,3,1,0,-5,5,0,-1,2
918,918,918,918,14,17,15,16,2,1,1,1,0,0,0,-3,2,-1
229,224,224,220,14,14,13,13,2,1,1,2,5,0,4,0,1,0
196,182,192,201,18,19,18,19,3,2,1,2,14,-10,-9,-1,1,-1
862,857,857,853,18,17,18,18,3,1,4,1,5,0,4,1,-1,0
253,248,248,243,14,14,13,13,1,2,2,2,5,0,5,0,1,0
187,187,187,182,18,19,18,19,1,1,2,1,0,0,5,-1,1,-1
337,332,332,332,20,19,20,18,1,2,1,1,5,0,0,1,-1,2
356,351,356,351,20,19,18,18,1,2,2,1,5,-5,5,1,1,0
595,581,571,571,21,19,20,18,2,1,1,4,14,10,0,2,-1,2
309,304,309,304,18,17,18,19,1,2,1,2,5,-5,5,1,-1,-1
454,454,454,454,17,16,18,16,2,1,1,1,0,0,0,1,-2,2
876,876,871,871,14,14,13,13,2,2,2,3,0,5,0,0,1,0
914,909,909,909,18,19,18,19,3,1,1,1,5,0,0,-1,1,-1
956,956,951,951,17,19,18,18,3,1,2,3,0,5,0,-2,1,0
323,318,314,314,14,14,13,13,2,3,3,1,5,4,0,0,1,0
909,904,909,904,21,19,21,19,1,2,1,1,5,-5,5,2,-2,2
660,651,646,646,17,16,18,16,2,1,3,1,9,5,0,1,-2,2
473,464,468,464,20,19,18,18,1,2,2,1,9,-4,4,1,1,0
426,421,421,421,20,19,18,18,3,2,1,1,5,0,0,1,1,0
754,754,750,792,20,19,18,19,1,3,1,1,0,4,-42,1,1,-1
403,398,398,398,20,19,20,21,2,5,1,1,5,0,0,1,-1,-1
370,365,365,360,20,19,18,18,1,1,1,2,5,0,5,1,1,0
609,600,600,600,18,19,18,19,1,2,1,2,9,0,0,-1,1,-1
960,951,946,946,13,14,15,13,3,3,3,1,9,5,0,-1,-1,2
660,642,651,646,17,16,15,16,1,1,1,1,18,-9,5,1,1,-1
510,506,506,506,18,19,18,19,3,2,3,1,4,0,0,-1,1,-1
515,506,506,506,14,14,15,13,2,2,2,1,9,0,0,0,-1,2
871,857,857,857,14,17,15,16,3,3,1,1,14,0,0,-3,2,-1
253,248,248,243,14,14,13,13,1,3,3,3,5,0,5,0,1,0
970,965,965,965,20,19,20,18,1,2,1,1,5,0,0,1,-1,2
389,384,374,370,13,14,12,13,1,1,2,1,5,10,4,-1,2,-1
989,984,984,979,17,16,15,16,3,1,2,4,5,0,5,1,1,-1
229,220,220,210,21,19,20,19,3,2,2,3,9,0,10,2,-1,1
773,768,768,768,13,14,15,13,3,2,2,1,5,0,0,-1,-1,2
379,374,374,374,13,16,15,16,1,1,1,3,5,0,0,-3,1,-1
646,646,642,646,20,19,20,21,2,1,1,1,0,4,-4,1,-1,-1
473,468,468,473,20,19,20,18,1,2,1,1,5,0,-5,1,-1,2
806,792,796,801,14,17,15,16,4,3,1,1,14,-4,-5,-3,2,-1
848,848,843,839,14,14,15,13,3,2,1,3,0,5,4,0,-1,2
782,782,778,778,14,17,15,16,1,1,1,1,0,4,0,-3,2,-1
468,464,459,464,17,16,18,18,1,2,1,2,4,5,-5,1,-2,0
1031,1021,1026,1026,17,16,15,16,1,2,2,1,10,-5,0,1,1,-1
389,374,374,384,13,14,12,13,1,2,2,5,15,0,-10,-1,2,-1
970,965,960,960,13,14,15,13,1,1,3,3,5,5,0,-1,-1,2
553,557,553,553,14,17,15,16,2,3,3,1,-4,4,0,-3,2,-1
651,642,637,637,13,14,15,13,1,2,1,1,9,5,0,-1,-1,2
412,407,412,412,17,16,18,18,2,2,2,1,5,-5,0,1,-2,0
421,412,417,412,20,19,18,18,2,1,2,1,9,-5,5,1,1,0
464,459,464,468,20,19,20,18,3,2,2,1,5,-5,-4,1,-1,2
843,834,829,829,18,17,18,16,2,1,3,2,9,5,0,1,-1,2
815,815,806,806,14,17,15,16,1,3,2,1,0,9,0,-3,2,-1
182,1068,1064,1068,21,19,20,21,1,2,1,1,-886,4,-4,2,-1,-1
1007,998,998,998,20,19,20,21,2,4,1,1,9,0,0,1,-1,-1
323,318,323,323,14,14,15,13,2,2,1,1,5,-5,0,0,-1,2
440,314,436,431,20,17,20,18,1,1,1,1,126,-122,5,3,-3,2
510,496,492,487,14,14,15,16,3,3,2,1,14,4,5,0,-1,-1
974,965,965,965,20,19,20,21,2,2,1,3,9,0,0,1,-1,-1
581,436,440,440,14,14,15,16,1,2,2,2,145,-4,0,0,-1,-1
843,820,820,820,14,14,13,13,2,2,2,3,23,0,0,0,1,0
492,487,487,487,21,19,21,19,2,2,1,1,5,0,0,2,-2,2
824,824,824,820,18,17,18,19,3,1,2,1,0,0,4,1,-1,-1
492,496,487,487,18,17,18,16,2,3,3,2,-4,9,0,1,-1,2
464,459,459,464,17,19,18,18,1,2,1,2,5,0,-5,-2,1,0
389,389,389,389,20,19,18,18,5,2,1,2,0,0,0,1,1,0
351,342,346,346,20,19,20,18,2,1,3,2,9,-4,0,1,-1,2
824,815,810,806,14,17,15,16,2,3,2,1,9,5,4,-3,2,-1
618,614,618,628,21,19,21,19,3,1,1,1,4,-4,-10,2,-2,2
886,876,867,862,14,14,13,13,2,4,1,2,10,9,5,0,1,0
740,731,736,736,20,19,20,18,2,2,1,3,9,-5,0,1,-1,2
337,342,337,337,13,14,15,13,1,4,1,2,-5,5,0,-1,-1,2
712,707,698,698,17,16,18,18,3,1,1,1,5,9,0,1,-2,0
670,660,660,660,20,19,20,21,1,2,1,3,10,0,0,1,-1,-1
726,721,712,712,17,16,18,16,2,1,1,1,5,9,0,1,-2,2
468,464,468,468,17,16,18,18,1,2,1,1,4,-4,0,1,-2,0
314,309,309,309,21,19,21,21,1,1,1,1,5,0,0,2,-2,0
365,356,360,356,17,16,18,18,2,2,2,1,9,-4,4,1,-2,0
224,224,215,215,18,17,18,16,1,1,1,2,0,9,0,1,-1,2
998,993,993,993,13,14,12,13,1,2,1,3,5,0,0,-1,2,-1
590,586,590,586,14,14,13,13,1,2,2,1,4,-4,4,0,1,0
342,337,342,332,13,14,15,13,1,2,3,2,5,-5,10,-1,-1,2
862,853,853,848,18,19,18,18,2,1,4,1,9,0,5,-1,1,0
426,421,445,421,13,14,12,13,3,1,1,2,5,-24,24,-1,2,-1
651,651,651,646,20,19,20,21,1,1,1,1,0,0,5,1,-1,-1
918,914,914,914,21,19,21,21,4,1,2,2,4,0,0,2,-2,0
365,356,360,360,17,16,15,16,1,4,2,1,9,-4,0,1,1,-1
857,857,853,848,18,17,18,18,6,1,3,2,0,4,5,1,-1,0
206,201,201,196,14,14,15,13,1,3,2,1,5,0,5,0,-1,2
196,196,192,192,14,14,15,16,2,3,3,1,0,4,0,0,-1,-1
543,529,529,524,18,17,18,16,2,4,1,2,14,0,5,1,-1,2
229,229,248,224,18,19,18,19,2,2,1,1,0,-19,24,-1,1,-1
824,820,824,820,18,17,18,19,1,4,1,2,4,-4,4,1,-1,-1
698,693,693,693,20,19,20,21,1,2,1,1,5,0,0,1,-1,-1
515,520,515,515,14,17,15,16,2,3,1,2,-5,5,0,-3,2,-1
609,604,600,595,14,14,15,13,3,3,1,2,5,4,5,0,-1,2
562,567,567,567,14,14,13,13,2,3,3,3,-5,0,0,0,1,0
239,229,234,239,18,17,18,18,2,4,1,1,10,-5,-5,1,-1,0
637,628,628,628,20,19,18,19,2,1,1,1,9,0,0,1,1,-1
1040,1040,1036,1036,20,19,18,18,1,1,1,2,0,4,0,1,1,0
196,192,192,187,21,19,21,21,1,1,2,2,4,0,5,2,-2,0
342,337,332,337,17,16,18,18,1,1,1,1,5,5,-5,1,-2,0
248,234,234,234,14,14,15,16,1,4,1,1,14,0,0,0,-1,-1
876,867,871,871,21,19,20,18,1,2,2,1,9,-4,0,2,-1,2
271,257,257,257,18,17,18,18,1,1,1,1,14,0,0,1,-1,0
895,890,890,886,14,14,13,13,1,1,2,1,5,0,4,0,1,0
1078,1068,1064,1068,13,16,15,16,2,2,1,3,10,4,-4,-3,1,-1
267,257,257,257,21,19,20,18,1,2,1,1,10,0,0,2,-1,2
684,684,679,679,20,19,20,18,1,1,1,2,0,5,0,1,-1,2
712,703,698,698,13,16,15,16,2,1,1,1,9,5,0,-3,1,-1
487,473,468,464,18,19,18,18,3,3,2,1,14,5,4,-1,1,0
215,206,206,206,14,14,15,16,3,1,2,1,9,0,0,0,-1,-1
576,567,567,562,14,17,15,16,2,3,2,1,9,0,5,-3,2,-1
956,951,956,956,13,14,15,13,3,2,2,1,5,-5,0,-1,-1,2
754,745,754,750,13,14,15,13,3,1,2,2,9,-9,4,-1,-1,2
646,642,642,782,13,14,15,11,1,3,5,1,4,0,-140,-1,-1,4
450,445,450,445,20,19,20,21,1,2,1,1,5,-5,5,1,-1,-1
487,482,487,478,18,19,18,18,1,1,2,1,5,-5,9,-1,1,0
646,637,637,632,20,19,20,18,1,2,2,1,9,0,5,1,-1,2
224,229,224,224,21,19,20,21,4,1,1,1,-5,5,0,2,-1,-1
323,304,309,309,14,17,15,16,2,2,3,1,19,-5,0,-3,2,-1
965,960,960,956,13,14,12,13,2,3,1,2,5,0,4,-1,2,-1
464,459,459,459,20,19,18,18,2,1,1,1,5,0,0,1,1,0
1059,1059,1064,1059,17,16,18,16,3,1,2,1,0,-5,5,1,-2,2
1036,1031,1031,1031,13,16,15,16,1,2,2,1,5,0,0,-3,1,-1
768,759,764,764,20,19,20,18,2,1,1,1,9,-5,0,1,-1,2
501,496,492,492,14,14,13,13,2,1,1,1,5,4,0,0,1,0
576,576,571,571,14,17,15,16,1,5,2,3,0,5,0,-3,2,-1
426,421,421,421,17,19,18,18,3,2,1,2,5,0,0,-2,1,0
239,229,229,224,14,14,13,13,1,1,2,1,10,0,5,0,1,0
529,520,524,520,18,19,18,19,3,2,2,1,9,-4,4,-1,1,-1
389,389,384,389,20,19,20,18,1,1,1,1,0,5,-5,1,-1,2
900,890,886,890,18,19,18,19,1,3,1,1,10,4,-4,-1,1,-1
609,604,600,600,14,14,15,16,1,1,1,2,5,4,0,0,-1,-1
356,356,351,351,17,16,15,16,1,1,1,1,0,5,0,1,1,-1
374,374,370,365,13,14,12,13,2,1,1,2,0,4,5,-1,2,-1
1068,1068,1064,1064,13,14,12,13,2,1,3,1,0,4,0,-1,2,-1
487,487,482,482,21,19,21,21,1,2,1,1,0,5,0,2,-2,0
215,201,201,206,14,14,13,13,2,1,1,1,14,0,-5,0,1,0
229,229,229,229,14,14,15,13,1,2,1,2,0,0,0,0,-1,2
914,909,909,909,21,19,21,21,1,2,1,1,5,0,0,2,-2,0
337,337,332,337,20,19,20,18,2,1,1,1,0,5,-5,1,-1,2
689,679,679,679,17,19,18,18,1,1,1,1,10,0,0,-2,1,0
801,796,801,796,18,17,18,19,2,1,2,2,5,-5,5,1,-1,-1
220,201,192,192,14,14,13,13,1,2,1,4,19,9,0,0,1,0
234,229,229,229,18,17,18,16,2,2,1,2,5,0,0,1,-1,2
867,871,862,862,14,14,15,16,1,1,1,1,-4,9,0,0,-1,-1
928,923,942,918,14,14,12,13,1,1,3,2,5,-19,24,0,2,-1
773,768,773,773,17,16,18,16,1,2,1,1,5,-5,0,1,-2,2
881,881,881,876,18,17,18,16,3,1,2,2,0,0,5,1,-1,2
731,721,726,726,20,19,20,18,2,4,1,2,10,-5,0,1,-1,2
182,1073,182,187,18,19,18,19,2,2,1,1,-891,891,-5,-1,1,-1
1054,1050,1050,1050,13,14,15,13,2,1,1,1,4,0,0,-1,-1,2
778,768,759,759,17,16,18,18,2,3,1,1,10,9,0,1,-2,0
304,309,300,300,14,17,15,16,3,2,1,3,-5,9,0,-3,2,-1
337,332,323,323,20,19,18,19,1,1,1,1,5,9,0,1,1,-1
815,810,810,806,18,17,18,16,2,1,1,2,5,0,4,1,-1,2
187,1073,1073,1078,14,14,15,16,3,2,1,1,-886,0,-5,0,-1,-1
1007,1012,1003,1003,13,14,12,13,1,1,1,1,-5,9,0,-1,2,-1
1003,1003,1003,998,17,16,18,16,3,1,2,2,0,0,5,1,-2,2
1045,1036,1040,1040,13,14,15,13,1,2,2,1,9,-4,0,-1,-1,2
839,829,829,829,14,14,15,16,1,2,1,1,10,0,0,0,-1,-1
820,810,810,810,14,14,13,13,2,2,1,3,10,0,0,0,1,0
937,932,932,932,13,14,15,16,2,1,1,2,5,0,0,-1,-1,-1
253,248,248,253,21,19,20,21,1,1,3,1,5,0,-5,2,-1,-1
454,445,450,445,20,19,20,21,2,2,1,2,9,-5,5,1,-1,-1
778,768,768,773,17,16,15,16,2,2,1,3,10,0,-5,1,1,-1
187,182,454,1073,21,19,20,18,1,1,1,1,5,-272,-619,2,-1,2
646,637,646,646,20,19,20,21,2,2,1,2,9,-9,0,1,-1,-1
801,773,778,782,14,16,15,16,1,2,1,2,28,-5,-4,-2,1,-1
370,370,365,365,20,19,18,18,2,3,1,1,0,5,0,1,1,0
665,726,656,651,17,19,18,18,2,1,2,3,-61,70,5,-2,1,0
815,810,815,810,14,14,13,13,4,2,1,1,5,-5,5,0,1,0
571,557,548,553,14,14,15,13,1,2,3,1,14,9,-5,0,-1,2
900,900,900,900,18,19,18,19,2,2,1,1,0,0,0,-1,1,-1
974,970,970,970,17,16,18,18,1,2,1,1,4,0,0,1,-2,0
965,956,951,951,13,16,15,16,2,3,3,2,9,5,0,-3,1,-1
965,965,960,960,20,19,20,18,3,1,1,1,0,5,0,1,-1,2
365,356,356,356,13,14,15,13,2,4,1,2,9,0,0,-1,-1,2
337,332,337,332,13,14,15,13,1,1,2,1,5,-5,5,-1,-1,2
407,403,403,403,20,19,20,21,1,3,1,3,4,0,0,1,-1,-1
914,904,904,900,18,17,18,16,3,1,2,2,10,0,4,1,-1,2
853,843,839,843,14,14,15,13,3,3,1,3,10,4,-4,0,-1,2
318,318,328,337,21,19,21,18,2,2,1,1,0,-10,-9,2,-2,3
356,351,351,351,13,14,15,13,1,3,1,3,5,0,0,-1,-1,2
201,201,196,196,18,19,18,19,1,1,1,3,0,5,0,-1,1,-1
951,942,937,937,13,14,12,13,4,3,1,1,9,5,0,-1,2,-1
707,698,707,703,17,16,15,16,2,2,1,2,9,-9,4,1,1,-1
890,881,881,881,14,14,13,13,2,2,2,3,9,0,0,0,1,0
187,182,187,1073,18,19,18,18,1,1,2,2,5,-5,-886,-1,1,0
501,492,492,487,14,14,13,13,1,2,2,1,9,0,5,0,1,0
403,398,398,398,17,16,18,18,3,1,1,1,5,0,0,1,-2,0
857,853,857,857,14,14,13,13,2,6,2,1,4,-4,0,0,1,0
417,421,417,412,20,19,20,21,1,1,2,2,-4,4,5,1,-1,-1
974,974,970,965,20,19,18,18,1,3,1,2,0,4,5,1,1,0
239,229,224,224,14,14,13,13,2,1,1,3,10,5,0,0,1,0
196,196,192,196,18,19,18,19,3,1,1,1,0,4,-4,-1,1,-1
792,890,782,782,21,19,21,19,1,1,1,1,-98,108,0,2,-2,2
257,253,257,248,18,17,18,16,1,2,2,2,4,-4,9,1,-1,2
745,736,726,726,13,14,12,13,3,3,1,2,9,10,0,-1,2,-1
900,904,895,895,14,17,15,16,2,3,1,1,-4,9,0,-3,2,-1
600,600,595,590,14,17,15,16,3,3,3,2,0,5,5,-3,2,-1
871,867,867,862,14,14,13,13,1,1,2,2,4,0,5,0,1,0
393,389,379,374,13,14,15,13,2,1,1,3,4,10,5,-1,-1,2
1017,1007,1007,1007,17,16,15,16,2,2,2,1,10,0,0,1,1,-1
623,614,618,618,18,17,18,16,1,2,2,3,9,-4,0,1,-1,2
862,857,853,853,18,19,18,18,2,3,1,2,5,4,0,-1,1,0
328,323,323,318,18,17,18,19,1,1,2,1,5,0,5,1,-1,-1
257,253,262,262,18,17,18,16,2,2,2,1,4,-9,0,1,-1,2
351,342,342,342,13,14,12,13,2,2,1,2,9,0,0,-1,2,-1
1026,1021,1021,1017,13,14,12,13,2,1,2,2,5,0,4,-1,2,-1
736,736,740,736,13,14,12,13,2,3,2,1,0,-4,4,-1,2,-1
581,581,581,576,18,19,18,18,2,1,1,3,0,0,5,-1,1,0
365,356,356,356,17,16,15,16,1,4,1,1,9,0,0,1,1,-1
1064,1059,1054,1059,20,19,20,21,5,2,1,1,5,5,-5,1,-1,-1
1040,1036,1036,1036,17,16,18,16,2,1,1,1,4,0,0,1,-2,2
557,557,557,553,18,17,18,16,2,3,2,2,0,0,4,1,-1,2
510,506,510,510,21,19,20,19,1,4,2,3,4,-4,0,2,-1,1
745,731,726,721,13,14,12,13,1,5,1,1,14,5,5,-1,2,-1
468,464,464,468,17,19,18,18,1,1,1,1,4,0,-4,-2,1,0
1059,1054,1054,1050,13,14,12,13,3,3,2,2,5,0,4,-1,2,-1
281,286,281,276,21,19,20,21,2,3,2,2,-5,5,5,2,-1,-1
726,721,717,717,20,19,20,18,3,3,1,2,5,4,0,1,-1,2
323,318,323,318,18,17,18,16,1,1,1,1,5,-5,5,1,-1,2
660,646,642,646,13,14,15,13,1,2,3,1,14,4,-4,-1,-1,2
300,286,281,290,14,17,15,16,3,2,3,2,14,5,-9,-3,2,-1
417,393,393,389,17,16,18,16,1,3,2,2,24,0,4,1,-2,2
595,590,618,586,14,17,15,16,2,1,2,1,5,-28,32,-3,2,-1
989,984,984,979,13,14,12,13,2,2,2,1,5,0,5,-1,2,-1
726,721,721,717,13,14,15,13,1,2,1,3,5,0,4,-1,-1,2
679,679,670,670,13,14,12,13,1,3,3,2,0,9,0,-1,2,-1
960,960,1021,956,20,19,20,18,1,3,1,1,0,-61,65,1,-1,2
736,726,731,731,20,19,18,18,1,2,1,1,10,-5,0,1,1,0
581,567,571,567,21,19,20,21,1,6,2,1,14,-4,4,2,-1,-1
689,689,684,689,13,14,12,13,2,1,3,1,0,5,-5,-1,2,-1
234,220,234,243,21,19,20,21,1,2,1,3,14,-14,-9,2,-1,-1
651,651,656,656,17,16,18,16,1,2,2,1,0,-5,0,1,-2,2
295,300,295,295,18,19,18,19,2,1,1,6,-5,5,0,-1,1,-1
318,309,304,295,14,14,13,13,2,2,3,2,9,5,9,0,1,0
182,192,182,182,18,17,18,16,2,1,1,1,-10,10,0,1,-1,2
815,810,810,806,14,14,15,13,2,3,2,1,5,0,4,0,-1,2
928,914,914,914,14,14,15,13,1,2,1,3,14,0,0,0,-1,2
328,328,323,328,18,17,18,19,1,1,1,1,0,5,-5,1,-1,-1
356,356,346,346,13,14,15,13,1,3,3,2,0,10,0,-1,-1,2
609,600,600,604,14,14,15,16,1,2,1,1,9,0,-4,0,-1,-1
637,632,632,642,17,16,15,16,1,2,1,3,5,0,-10,1,1,-1
998,989,993,1003,13,14,15,13,2,2,3,2,9,-4,-10,-1,-1,2
646,642,642,642,20,19,18,18,2,2,1,4,4,0,0,1,1,0
539,534,529,524,21,19,20,21,2,3,1,2,5,5,5,2,-1,-1
304,295,295,295,14,17,15,16,2,2,1,1,9,0,0,-3,2,-1
342,337,332,332,13,16,15,16,2,3,1,2,5,5,0,-3,1,-1
206,201,201,201,18,19,18,19,2,1,3,1,5,0,0,-1,1,-1
843,1036,1031,1031,18,14,15,16,1,3,3,2,-193,5,0,4,-1,-1
384,379,374,379,17,16,15,16,4,3,2,1,5,5,-5,1,1,-1
642,637,637,637,13,14,12,13,1,2,3,1,5,0,0,-1,2,-1
426,417,417,412,13,14,12,13,1,3,1,2,9,0,5,-1,2,-1
318,309,309,309,18,19,18,19,3,2,1,1,9,0,0,-1,1,-1
360,356,356,351,13,14,15,13,1,1,1,2,4,0,5,-1,-1,2
562,562,557,557,14,17,15,16,1,1,1,1,0,5,0,-3,2,-1
210,206,206,206,21,19,20,21,1,2,1,2,4,0,0,2,-1,-1
1021,1012,1012,1017,17,16,15,16,1,2,1,1,9,0,-5,1,1,-1
815,810,810,810,14,14,15,13,1,1,2,1,5,0,0,0,-1,2
510,510,501,496,14,17,15,16,3,1,1,2,0,9,5,-3,2,-1
253,248,248,253,14,14,15,13,4,2,2,1,5,0,-5,0,-1,2
796,796,796,792,14,14,15,13,2,2,2,3,0,0,4,0,-1,2
951,942,942,932,13,14,15,13,2,3,3,2,9,0,10,-1,-1,2
1036,1031,1026,1026,13,14,12,13,3,3,3,2,5,5,0,-1,2,-1
229,220,210,206,14,14,13,13,2,3,1,2,9,10,4,0,1,0
257,248,253,248,14,14,13,13,1,2,2,1,9,-5,5,0,1,0
1050,1059,1050,1050,20,19,20,21,1,2,2,2,-9,9,0,1,-1,-1
510,506,506,510,14,17,15,16,1,2,2,1,4,0,-4,-3,2,-1
431,431,431,426,13,14,12,13,2,1,1,1,0,0,5,-1,2,-1
1026,1021,1012,1017,17,16,18,18,2,1,1,1,5,9,-5,1,-2,0
309,295,295,295,14,14,13,13,2,4,1,1,14,0,0,0,1,0
970,965,970,970,17,16,18,18,3,2,2,1,5,-5,0,1,-2,0
290,281,281,276,21,19,20,21,1,2,1,2,9,0,5,2,-1,-1
974,965,960,951,13,14,12,13,1,1,1,3,9,5,9,-1,2,-1
271,262,262,257,18,19,18,18,2,2,2,2,9,0,5,-1,1,0
370,365,370,370,17,16,18,18,1,2,2,1,5,-5,0,1,-2,0
684,703,703,703,17,16,15,16,1,2,3,1,-19,0,0,1,1,-1
304,300,300,300,18,17,18,19,3,2,3,1,4,0,0,1,-1,-1
417,421,417,417,13,14,12,13,1,1,1,1,-4,4,0,-1,2,-1
918,923,923,923,18,19,18,19,2,3,3,1,-5,0,0,-1,1,-1
445,440,445,440,17,16,18,16,3,1,2,2,5,-5,5,1,-2,2
464,464,464,459,13,14,12,13,2,2,3,2,0,0,5,-1,2,-1
290,290,290,290,18,19,18,19,1,1,2,1,0,0,0,-1,1,-1
689,684,679,674,20,19,20,18,1,1,2,1,5,5,5,1,-1,2
815,806,796,796,14,14,13,13,2,2,1,1,9,10,0,0,1,0
712,707,703,703,17,16,18,16,1,3,3,1,5,4,0,1,-2,2
745,736,740,736,20,19,18,18,3,2,1,2,9,-4,4,1,1,0
651,642,646,642,13,14,12,13,2,2,2,2,9,-4,4,-1,2,-1
1040,1036,1036,1031,17,16,18,18,2,3,2,1,4,0,5,1,-2,0
346,342,337,337,17,16,18,16,2,2,1,1,4,5,0,1,-2,2
1007,1012,1007,1003,13,14,12,13,1,1,1,1,-5,5,4,-1,2,-1
839,820,815,810,14,14,13,13,1,3,1,2,19,5,5,0,1,0
318,318,328,323,18,17,15,16,3,1,2,2,0,-10,5,1,2,-1
895,886,881,881,18,19,18,19,2,2,1,1,9,5,0,-1,1,-1
473,459,464,464,13,16,15,16,2,2,2,3,14,-5,0,-3,1,-1
909,895,886,890,14,17,15,16,3,1,1,1,14,9,-4,-3,2,-1
721,717,717,717,13,14,15,13,1,2,3,1,4,0,0,-1,-1,2
782,773,773,773,14,14,15,13,2,3,1,1,9,0,0,0,-1,2
1031,1036,1031,1031,20,19,20,21,1,2,1,2,-5,5,0,1,-1,-1
356,351,351,351,13,14,15,13,2,3,4,2,5,0,0,-1,-1,2
436,426,436,436,17,16,15,16,2,2,2,1,10,-10,0,1,1,-1
529,524,524,524,18,17,18,19,3,3,2,1,5,0,0,1,-1,-1
543,539,539,539,21,19,20,21,2,3,1,1,4,0,0,2,-1,-1
670,665,689,670,20,19,20,21,1,2,1,3,5,-24,19,1,-1,-1
524,520,524,520,21,19,20,19,1,1,1,2,4,-4,4,2,-1,1
342,337,337,328,17,19,18,19,1,3,2,1,5,0,9,-2,1,-1
192,187,192,182,18,19,18,19,2,1,2,1,5,-5,10,-1,1,-1
487,482,487,482,14,14,13,13,3,2,2,1,5,-5,5,0,1,0
801,796,796,796,14,14,15,13,2,2,1,3,5,0,0,0,-1,2
736,726,721,721,13,14,15,13,2,3,2,3,10,5,0,-1,-1,2
810,801,801,796,14,17,15,16,2,1,2,1,9,0,5,-3,2,-1
1040,1036,1031,1026,13,14,12,13,1,3,2,2,4,5,5,-1,2,-1
239,234,234,234,21,19,20,21,1,1,1,2,5,0,0,2,-1,-1
445,445,445,445,13,14,15,16,3,3,1,1,0,0,0,-1,-1,-1
206,206,201,201,21,19,21,19,1,1,1,2,0,5,0,2,-2,2
234,229,229,224,14,17,15,16,3,1,2,1,5,0,5,-3,2,-1
848,848,839,834,18,17,18,16,2,1,2,2,0,9,5,1,-1,2
220,215,215,215,14,17,15,16,2,2,1,2,5,0,0,-3,2,-1
595,590,581,586,18,19,18,19,1,1,1,3,5,9,-5,-1,1,-1
1064,1054,1045,1050,17,16,15,16,3,3,1,3,10,9,-5,1,1,-1
346,346,342,337,17,19,18,18,2,3,2,2,0,4,5,-2,1,0
215,210,210,206,14,17,15,16,3,2,2,2,5,0,4,-3,2,-1
937,923,928,923,13,14,15,13,2,2,1,2,14,-5,5,-1,-1,2
773,764,768,764,17,16,18,18,3,2,2,1,9,-4,4,1,-2,0
623,614,618,618,14,14,15,13,3,2,1,1,9,-4,0,0,-1,2
304,295,295,295,14,14,15,13,3,2,1,3,9,0,0,0,-1,2
796,787,787,787,14,14,13,13,1,2,2,1,9,0,0,0,1,0
440,421,417,417,13,16,15,16,3,2,1,1,19,4,0,-3,1,-1
534,515,510,515,18,19,18,19,1,1,1,3,19,5,-5,-1,1,-1
693,689,689,684,20,19,18,18,1,2,2,1,4,0,5,1,1,0
351,346,346,342,20,19,18,18,1,1,4,3,5,0,4,1,1,0
271,262,262,262,18,19,18,18,3,1,1,3,9,0,0,-1,1,0
196,196,998,187,18,17,15,16,1,1,1,2,0,-802,811,1,2,-1
970,960,965,960,13,14,12,13,2,2,2,1,10,-5,5,-1,2,-1
1054,1045,1040,1045,13,14,12,13,2,3,1,4,9,5,-5,-1,2,-1
712,712,712,703,13,14,12,13,1,1,2,2,0,0,9,-1,2,-1
937,932,923,928,13,16,15,16,1,1,1,1,5,9,-5,-3,1,-1
501,501,501,496,14,17,15,16,1,1,2,2,0,0,5,-3,2,-1
510,501,501,501,18,17,18,19,2,3,1,2,9,0,0,1,-1,-1
731,736,731,731,17,16,18,16,3,1,1,1,-5,5,0,1,-2,2
651,642,646,646,13,14,12,13,2,2,2,1,9,-4,0,-1,2,-1
824,801,801,801,18,17,18,16,1,1,2,1,23,0,0,1,-1,2
862,857,857,857,18,19,18,18,1,2,1,1,5,0,0,-1,1,0
984,979,974,979,13,14,15,13,3,3,1,1,5,5,-5,-1,-1,2
928,918,918,918,21,19,21,21,1,2,1,1,10,0,0,2,-2,0
567,562,562,562,21,19,20,21,1,2,2,1,5,0,0,2,-1,-1
374,365,365,365,13,14,12,13,3,2,1,1,9,0,0,-1,2,-1
1073,1068,1068,1064,13,14,12,13,3,2,2,1,5,0,4,-1,2,-1
674,670,670,670,17,16,15,16,2,3,1,1,4,0,0,1,1,-1
314,309,309,304,14,17,15,16,3,3,2,1,5,0,5,-3,2,-1
782,782,778,778,21,19,20,21,1,2,1,1,0,4,0,2,-1,-1
1045,1040,1036,1036,17,16,18,16,3,3,1,3,5,4,0,1,-2,2
243,239,243,239,18,17,18,18,3,2,3,2,4,-4,4,1,-1,0
276,276,271,267,14,14,15,13,2,1,1,1,0,5,4,0,-1,2
492,492,492,492,14,14,15,13,3,3,2,2,0,0,0,0,-1,2
853,848,848,843,18,17,18,18,2,2,4,1,5,0,5,1,-1,0
918,914,914,914,14,14,13,13,2,2,1,1,4,0,0,0,1,0
1021,1017,1012,1012,20,19,18,18,2,2,1,1,4,5,0,1,1,0
984,984,979,979,17,16,18,18,1,1,2,1,0,5,0,1,-2,0
1026,1026,1026,1017,17,16,15,16,3,3,2,2,0,0,9,1,1,-1
1021,1017,1017,1012,13,14,12,13,2,2,1,1,4,0,5,-1,2,-1
600,590,595,595,14,17,15,16,3,2,1,1,10,-5,0,-3,2,-1
974,970,970,965,17,19,18,18,2,1,2,2,4,0,5,-2,1,0
318,318,318,318,14,17,15,16,2,2,1,2,0,0,0,-3,2,-1
689,679,674,679,13,16,15,16,2,1,2,1,10,5,-5,-3,1,-1
267,262,262,257,14,14,13,13,2,3,4,1,5,0,5,0,1,0
473,468,464,464,13,14,12,13,2,2,1,2,5,4,0,-1,2,-1
951,942,942,942,13,14,15,13,1,2,1,2,9,0,0,-1,-1,2
478,468,468,464,13,14,15,13,2,2,2,2,10,0,4,-1,-1,2
243,239,239,239,21,19,20,18,1,1,1,1,4,0,0,2,-1,2
768,764,768,754,20,19,20,21,1,1,2,1,4,-4,14,1,-1,-1
824,820,820,820,18,19,18,19,1,2,2,1,4,0,0,-1,1,-1
956,956,956,956,17,16,18,18,1,1,1,2,0,0,0,1,-2,0
956,951,951,951,20,19,18,18,1,2,1,1,5,0,0,1,1,0
900,900,900,900,14,14,15,13,2,2,3,3,0,0,0,0,-1,2
909,909,904,904,18,19,18,19,2,1,2,1,0,5,0,-1,1,-1
309,304,304,295,18,17,18,19,1,3,2,1,5,0,9,1,-1,-1
243,243,243,239,14,14,13,13,3,1,1,2,0,0,4,0,1,0
853,848,848,848,14,14,15,13,3,3,1,3,5,0,0,0,-1,2
300,295,290,290,14,14,13,13,1,1,1,1,5,5,0,0,1,0
1003,998,998,998,20,19,20,18,1,1,1,1,5,0,0,1,-1,2
984,979,974,974,17,19,18,18,2,3,1,1,5,5,0,-2,1,0
581,571,571,571,14,14,13,13,2,2,1,2,10,0,0,0,1,0
745,740,740,740,17,16,18,18,3,1,3,1,5,0,0,1,-2,0
736,736,736,731,20,19,20,21,1,1,1,1,0,0,5,1,-1,-1
515,510,515,510,21,19,20,19,1,3,2,1,5,-5,5,2,-1,1
796,773,773,773,18,16,18,18,1,2,3,1,23,0,0,2,-2,0
365,365,356,356,13,14,12,13,1,5,1,1,0,9,0,-1,2,-1
257,253,257,253,14,14,13,13,3,2,2,2,4,-4,4,0,1,0
942,937,937,937,17,16,18,18,1,2,3,1,5,0,0,1,-2,0
614,604,600,600,14,14,13,13,3,1,4,2,10,4,0,0,1,0
1045,1031,1026,1017,13,14,15,13,1,3,2,2,14,5,9,-1,-1,2
529,529,529,534,14,14,13,13,2,2,1,1,0,0,-5,0,1,0
745,745,745,745,13,14,12,13,1,2,2,1,0,0,0,-1,2,-1
360,351,351,351,13,14,12,13,3,3,3,3,9,0,0,-1,2,-1
492,515,492,492,18,17,18,16,2,1,3,1,-23,23,0,1,-1,2
206,201,196,196,18,17,18,19,1,1,2,1,5,5,0,1,-1,-1
1064,1054,1050,1059,13,14,12,13,2,2,3,1,10,4,-9,-1,2,-1
679,674,674,674,13,14,15,16,2,3,3,1,5,0,0,-1,-1,-1
510,506,506,496,18,17,18,16,2,3,2,1,4,0,10,1,-1,2
937,923,928,928,20,19,21,21,3,2,1,1,14,-5,0,1,-2,0
843,815,815,824,14,14,15,13,2,6,3,1,28,0,-9,0,-1,2
318,314,309,309,18,19,18,19,3,1,3,1,4,5,0,-1,1,-1
806,806,796,792,21,19,21,21,2,3,1,1,0,10,4,2,-2,0
440,436,436,436,13,14,15,16,2,1,2,3,4,0,0,-1,-1,-1
534,524,524,520,21,19,20,21,1,1,1,2,10,0,4,2,-1,-1
726,721,721,717,17,16,18,18,3,4,2,1,5,0,4,1,-2,0
960,956,960,956,13,14,12,13,3,2,2,2,4,-4,4,-1,2,-1
529,524,529,524,14,14,15,16,1,2,4,2,5,-5,5,0,-1,-1
886,886,886,890,18,19,18,19,2,1,1,2,0,0,-4,-1,1,-1
736,731,731,731,20,19,20,18,1,2,2,2,5,0,0,1,-1,2
215,201,201,201,14,14,13,13,2,2,1,2,14,0,0,0,1,0
717,712,717,712,13,14,15,13,1,2,2,2,5,-5,5,-1,-1,2
534,529,534,529,14,14,13,13,2,2,2,1,5,-5,5,0,1,0
436,431,426,426,13,14,12,13,1,3,1,1,5,5,0,-1,2,-1
304,300,295,295,14,14,15,13,3,2,2,3,4,5,0,0,-1,2
576,571,571,562,14,14,15,16,1,2,2,2,5,0,9,0,-1,-1
342,356,337,337,13,16,15,16,1,1,1,3,-14,19,0,-3,1,-1
984,974,979,979,17,16,18,18,2,3,1,1,10,-5,0,1,-2,0
187,187,187,187,14,17,15,16,2,3,1,1,0,0,0,-3,2,-1
759,759,754,759,20,19,20,18,3,1,1,1,0,5,-5,1,-1,2
1078,1073,1073,1073,13,14,12,13,1,2,1,2,5,0,0,-1,2,-1
1073,1068,1068,1068,17,16,15,16,1,2,1,2,5,0,0,1,1,-1
210,210,215,210,21,19,20,21,1,5,2,1,0,-5,5,2,-1,-1
937,928,923,928,17,17,18,19,2,1,1,1,9,5,-5,0,-1,-1
464,459,454,454,13,14,15,13,3,3,1,2,5,5,0,-1,-1,2
431,417,421,417,13,14,15,13,1,2,2,2,14,-4,4,-1,-1,2
731,717,707,707,17,16,15,16,1,2,1,3,14,10,0,1,1,-1
314,300,300,300,14,14,15,13,1,2,1,1,14,0,0,0,-1,2
346,346,346,346,17,16,15,16,1,2,2,1,0,0,0,1,1,-1
960,956,960,956,20,19,18,18,2,1,1,1,4,-4,4,1,1,0
445,445,445,445,20,19,18,18,3,1,2,3,0,0,0,1,1,0
1064,1059,1064,1064,20,19,20,21,2,1,2,1,5,-5,0,1,-1,-1
1026,1021,1017,1021,20,19,18,18,2,1,2,1,5,4,-4,1,1,0
426,421,426,421,20,19,18,18,3,3,2,2,5,-5,5,1,1,0
970,1073,960,956,13,14,12,13,1,1,3,2,-103,113,4,-1,2,-1
703,707,703,698,13,14,15,16,1,3,1,2,-4,4,5,-1,-1,-1
974,970,970,970,20,19,18,18,2,2,1,1,4,0,0,1,1,0
806,806,801,801,14,14,15,16,2,1,3,1,0,5,0,0,-1,-1
567,562,562,557,21,19,20,21,1,1,1,3,5,0,5,2,-1,-1
773,764,768,764,13,14,15,16,2,2,3,1,9,-4,4,-1,-1,-1
248,239,239,239,21,19,20,21,1,3,3,1,9,0,0,2,-1,-1
286,286,281,281,18,19,18,19,2,2,3,1,0,5,0,-1,1,-1
403,403,398,398,20,19,20,21,1,2,1,2,0,5,0,1,-1,-1
815,806,810,806,21,19,20,21,1,2,1,2,9,-4,4,2,-1,-1
670,670,670,665,20,19,18,18,1,3,1,1,0,0,5,1,1,0
618,609,609,609,14,17,15,16,2,1,2,1,9,0,0,-3,2,-1
604,609,600,595,14,14,15,13,2,1,1,2,-5,9,5,0,-1,2
829,824,829,824,14,14,15,13,3,2,1,1,5,-5,5,0,-1,2
689,689,689,684,17,16,18,16,1,2,1,2,0,0,5,1,-2,2
421,417,417,421,20,19,20,18,1,3,1,1,4,0,-4,1,-1,2
286,281,281,286,18,17,18,19,3,1,1,4,5,0,-5,1,-1,-1
239,229,234,229,21,19,20,19,2,2,1,2,10,-5,5,2,-1,1
1078,1068,1064,1059,13,14,12,13,2,3,1,2,10,4,5,-1,2,-1
332,332,328,328,17,16,18,19,1,1,1,1,0,4,0,1,-2,-1
886,881,876,876,18,17,18,18,1,1,1,1,5,5,0,1,-1,0
721,717,707,707,17,16,18,18,1,3,1,1,4,10,0,1,-2,0
262,253,253,253,18,19,18,18,1,1,2,2,9,0,0,-1,1,0
1050,1040,1036,1036,13,14,12,13,2,1,2,1,10,4,0,-1,2,-1
501,871,492,487,18,17,18,19,3,1,1,1,-370,379,5,1,-1,-1
609,604,604,604,14,14,13,13,1,2,3,1,5,0,0,0,1,0
1054,1045,1045,1040,20,19,20,18,1,1,2,2,9,0,5,1,-1,2
309,300,300,295,14,14,15,13,3,3,1,2,9,0,5,0,-1,2
867,867,862,862,18,17,18,16,2,1,1,2,0,5,0,1,-1,2
904,895,904,900,14,14,15,13,2,2,2,1,9,-9,4,0,-1,2
206,201,201,201,18,17,18,16,1,2,1,2,5,0,0,1,-1,2
281,271,267,267,21,19,20,21,2,3,1,4,10,4,0,2,-1,-1
586,571,567,567,14,17,15,16,2,2,2,1,15,4,0,-3,2,-1
407,403,412,421,17,16,15,16,3,1,1,2,4,-9,-9,1,1,-1
750,698,703,703,13,14,15,13,6,2,1,3,52,-5,0,-1,-1,2
253,248,243,239,18,17,18,18,1,1,3,2,5,5,4,1,-1,0
637,637,637,637,20,19,20,18,1,2,2,1,0,0,0,1,-1,2
468,464,468,464,13,14,15,13,1,2,2,2,4,-4,4,-1,-1,2
459,450,450,450,13,16,15,16,2,2,1,1,9,0,0,-3,1,-1
862,857,848,848,14,17,15,16,1,2,1,2,5,9,0,-3,2,-1
403,393,398,393,20,19,20,21,1,2,2,3,10,-5,5,1,-1,-1
351,346,346,346,20,19,18,18,1,2,2,3,5,0,0,1,1,0
384,379,384,389,13,14,15,13,3,2,1,3,5,-5,-5,-1,-1,2
553,553,553,553,14,17,15,16,2,4,1,1,0,0,0,-3,2,-1
674,670,670,670,17,16,18,18,3,1,4,1,4,0,0,1,-2,0
843,848,843,843,14,17,15,16,1,1,3,3,-5,5,0,-3,2,-1
234,224,224,220,18,19,18,19,1,1,2,1,10,0,4,-1,1,-1
853,843,839,839,14,14,15,13,2,2,2,1,10,4,0,0,-1,2
262,257,262,267,21,19,20,21,2,1,2,1,5,-5,-5,2,-1,-1
1031,1021,1021,1021,17,19,18,18,3,1,1,1,10,0,0,-2,1,0
717,712,707,703,17,16,18,18,2,1,1,1,5,5,4,1,-2,0
342,332,328,328,13,14,13,13,3,1,1,1,10,4,0,-1,1,0
984,984,984,979,20,19,20,18,1,1,2,1,0,0,5,1,-1,2
389,379,374,379,17,16,18,18,2,1,1,1,10,5,-5,1,-2,0
890,886,886,886,21,19,20,21,1,2,1,1,4,0,0,2,-1,-1
215,210,215,206,14,17,15,16,3,1,2,2,5,-5,9,-3,2,-1
257,253,248,248,18,19,18,18,1,1,1,2,4,5,0,-1,1,0
412,407,403,403,17,16,18,18,2,2,3,1,5,4,0,1,-2,0
1054,1050,1045,1045,13,14,12,13,2,2,3,3,4,5,0,-1,2,-1
262,248,253,253,18,19,18,18,2,2,3,1,14,-5,0,-1,1,0
665,665,660,660,13,14,15,13,1,4,1,2,0,5,0,-1,-1,2
543,539,543,539,14,14,15,16,2,4,2,1,4,-4,4,0,-1,-1
674,679,679,679,20,19,20,21,1,3,1,1,-5,0,0,1,-1,-1
834,829,834,834,14,17,15,16,1,1,2,1,5,-5,0,-3,2,-1
1017,1007,1012,1012,17,16,18,18,2,2,2,1,10,-5,0,1,-2,0
787,782,792,782,14,14,13,13,1,2,2,2,5,-10,10,0,1,0
201,201,314,196,18,17,15,19,2,3,1,2,0,-113,118,1,2,-4
1045,1040,1031,1031,13,14,15,13,2,3,3,2,5,9,0,-1,-1,2
468,464,464,464,13,14,15,13,3,2,1,1,4,0,0,-1,-1,2
1012,1003,1007,1007,17,16,15,16,2,2,1,1,9,-4,0,1,1,-1
801,792,796,796,18,19,18,19,1,1,4,1,9,-4,0,-1,1,-1
281,276,276,276,18,17,18,18,1,2,1,2,5,0,0,1,-1,0
881,881,881,881,14,14,15,13,4,1,1,2,0,0,0,0,-1,2
764,759,764,759,13,16,15,16,2,2,1,1,5,-5,5,-3,1,-1
224,224,220,220,14,17,15,16,1,3,1,1,0,4,0,-3,2,-1
1040,1036,1036,1031,13,14,12,13,1,4,3,1,4,0,5,-1,2,-1
970,970,970,965,20,19,18,18,1,1,2,1,0,0,5,1,1,0
853,848,843,843,18,17,18,18,3,1,3,3,5,5,0,1,-1,0
374,365,365,356,20,19,18,18,1,1,3,2,9,0,9,1,1,0
937,923,923,923,13,14,13,13,2,2,1,2,14,0,0,-1,1,0
1007,1003,998,998,20,19,20,21,1,1,1,2,4,5,0,1,-1,-1
796,796,796,792,21,19,21,21,1,2,3,1,0,0,4,2,-2,0
721,717,721,717,20,19,20,21,3,2,2,2,4,-4,4,1,-1,-1
342,337,337,337,20,19,20,18,1,3,1,1,5,0,0,1,-1,2
1064,1054,1059,1054,13,14,12,13,3,6,2,1,10,-5,5,-1,2,-1
276,271,267,267,21,19,20,18,1,1,3,2,5,4,0,2,-1,2
201,201,196,196,14,17,15,16,1,2,1,1,0,5,0,-3,2,-1
787,782,782,782,21,19,21,19,1,1,1,2,5,0,0,2,-2,2
871,857,853,853,18,19,18,18,2,2,1,2,14,4,0,-1,1,0
651,646,646,646,20,19,20,18,2,1,1,4,5,0,0,1,-1,2
642,637,637,637,17,16,18,18,2,1,1,3,5,0,0,1,-2,0
224,224,224,224,21,19,20,21,1,3,2,1,0,0,0,2,-1,-1
979,979,979,979,13,14,15,13,1,2,3,1,0,0,0,-1,-1,2
342,337,337,337,20,19,20,21,2,2,1,1,5,0,0,1,-1,-1
843,782,787,782,18,17,18,16,1,2,2,1,61,-5,5,1,-1,2
384,379,374,374,13,16,15,16,3,3,1,1,5,5,0,-3,1,-1
787,787,787,787,14,17,15,16,1,3,1,1,0,0,0,-3,2,-1
543,534,539,534,14,14,15,16,3,2,1,1,9,-5,5,0,-1,-1
895,895,881,876,14,14,15,13,2,1,1,2,0,14,5,0,-1,2
754,750,750,745,17,16,15,16,2,3,1,2,4,0,5,1,1,-1
600,586,586,576,14,14,15,13,1,2,1,2,14,0,10,0,-1,2
524,510,515,510,14,17,15,16,3,3,2,1,14,-5,5,-3,2,-1
506,501,501,506,14,14,13,13,2,2,1,2,5,0,-5,0,1,0
890,886,890,890,14,14,13,13,2,2,3,3,4,-4,0,0,1,0
801,801,801,801,21,19,21,21,2,1,1,1,0,0,0,2,-2,0
459,454,454,450,20,19,20,18,2,1,1,2,5,0,4,1,-1,2
243,243,271,243,14,14,13,13,1,3,2,3,0,-28,28,0,1,0
890,876,881,876,14,17,15,16,1,1,2,3,14,-5,5,-3,2,-1
989,984,979,970,13,14,12,13,3,3,1,2,5,5,9,-1,2,-1
337,332,337,337,13,14,12,13,3,2,2,1,5,-5,0,-1,2,-1
759,754,754,754,20,19,18,18,1,1,1,1,5,0,0,1,1,0
1064,1050,1054,1050,17,19,18,18,2,1,1,2,14,-4,4,-2,1,0
459,445,450,445,17,16,18,18,2,3,2,2,14,-5,5,1,-2,0
1073,1068,1068,1064,20,19,20,21,2,1,2,2,5,0,4,1,-1,-1
993,984,984,979,17,16,15,16,3,1,1,1,9,0,5,1,1,-1
815,806,801,801,14,14,13,13,3,3,2,2,9,5,0,0,1,0
600,595,590,590,14,14,13,13,1,4,2,1,5,5,0,0,1,0
229,229,229,224,14,17,15,16,3,2,1,2,0,0,5,-3,2,-1
342,337,337,342,17,16,18,18,4,1,1,3,5,0,-5,1,-2,0
614,609,609,609,14,17,15,16,2,1,2,1,5,0,0,-3,2,-1
567,562,562,567,14,14,13,13,2,2,3,1,5,0,-5,0,1,0
182,182,187,182,18,19,18,19,2,1,2,1,0,-5,5,-1,1,-1
384,379,379,379,20,19,20,18,1,1,1,2,5,0,0,1,-1,2
895,890,890,890,18,17,18,16,3,2,1,1,5,0,0,1,-1,2
984,984,984,984,13,14,15,13,1,3,1,1,0,0,0,-1,-1,2
215,210,210,206,14,14,15,13,2,2,1,1,5,0,4,0,-1,2
496,496,496,492,21,19,21,21,2,3,2,1,0,0,4,2,-2,0
243,243,243,234,14,14,13,13,2,3,2,2,0,0,9,0,1,0
393,384,384,384,13,14,12,13,2,4,2,2,9,0,0,-1,2,-1
956,956,946,942,13,14,12,13,3,1,1,2,0,10,4,-1,2,-1
286,281,276,271,18,19,18,18,2,4,2,1,5,5,5,-1,1,0
960,951,951,951,20,19,18,18,2,2,2,1,9,0,0,1,1,0
974,970,970,965,13,14,15,13,1,3,2,2,4,0,5,-1,-1,2
417,417,421,412,20,19,20,21,1,1,4,1,0,-4,9,1,-1,-1
510,506,506,501,18,17,18,19,3,2,2,2,4,0,5,1,-1,-1
450,393,389,389,17,19,18,18,3,2,1,3,57,4,0,-2,1,0
548,539,539,534,18,17,18,16,3,2,2,2,9,0,5,1,-1,2
956,946,951,951,13,14,15,13,2,2,2,1,10,-5,0,-1,-1,2
651,646,646,646,13,16,15,16,3,1,2,1,5,0,0,-3,1,-1
257,253,257,257,18,19,18,18,2,1,1,1,4,-4,0,-1,1,0
201,192,196,196,14,14,15,13,1,2,1,2,9,-4,0,0,-1,2
286,281,286,281,14,17,15,16,1,5,2,2,5,-5,5,-3,2,-1
248,248,243,243,18,17,18,16,1,1,1,2,0,5,0,1,-1,2
993,989,989,989,13,14,15,13,2,3,2,3,4,0,0,-1,-1,2
524,524,520,520,18,19,18,19,2,1,4,2,0,4,0,-1,1,-1
942,937,928,928,17,16,18,16,2,1,1,1,5,9,0,1,-2,2
998,989,998,993,20,19,20,21,2,4,2,2,9,-9,5,1,-1,-1
956,946,946,946,13,16,15,16,1,1,2,1,10,0,0,-3,1,-1
871,862,867,862,14,14,15,16,1,3,2,2,9,-5,5,0,-1,-1
618,614,820,609,18,17,10,16,2,3,1,1,4,-206,211,1,7,-6
731,731,721,726,13,14,12,13,2,1,1,3,0,10,-5,-1,2,-1
674,670,670,670,13,14,15,16,2,1,1,1,4,0,0,-1,-1,-1
581,576,571,571,21,19,20,21,1,1,1,1,5,5,0,2,-1,-1
674,665,665,665,13,16,15,16,2,3,2,1,9,0,0,-3,1,-1
932,928,923,918,17,19,18,19,1,1,2,2,4,5,5,-2,1,-1
459,464,459,459,13,14,12,13,3,3,2,1,-5,5,0,-1,2,-1
674,670,670,660,17,19,18,18,2,3,1,2,4,0,10,-2,1,0
1017,1012,1012,1007,13,14,15,13,2,1,1,1,5,0,5,-1,-1,2
253,243,243,243,18,19,18,18,1,1,1,1,10,0,0,-1,1,0
956,951,956,956,20,19,20,21,1,1,1,1,5,-5,0,1,-1,-1
201,196,196,196,14,14,13,13,1,2,3,1,5,0,0,0,1,0
979,974,979,979,20,19,20,21,1,1,2,2,5,-5,0,1,-1,-1
646,642,637,637,13,14,12,13,2,3,1,1,4,5,0,-1,2,-1
937,942,937,937,13,14,12,13,3,3,3,1,-5,5,0,-1,2,-1
1012,1012,1007,1007,17,16,18,16,3,3,1,1,0,5,0,1,-2,2
590,590,595,590,14,14,15,13,2,1,2,2,0,-5,5,0,-1,2
553,543,534,534,18,17,18,16,2,1,1,2,10,9,0,1,-1,2
750,740,740,745,13,14,15,13,1,2,1,1,10,0,-5,-1,-1,2
379,379,384,384,13,16,15,16,2,2,2,1,0,-5,0,-3,1,-1
632,637,632,632,20,19,18,18,1,1,1,1,-5,5,0,1,1,0
871,857,853,853,18,19,20,18,3,1,3,2,14,4,0,-1,-1,2
881,867,862,857,14,14,13,13,3,2,1,2,14,5,5,0,1,0
393,393,393,389,20,19,20,18,2,2,2,2,0,0,4,1,-1,2
487,459,464,459,21,19,20,18,2,1,2,1,28,-5,5,2,-1,2
637,632,637,632,20,19,18,18,2,1,2,2,5,-5,5,1,1,0
628,623,618,618,21,19,21,21,1,1,1,1,5,5,0,2,-2,0
239,229,220,220,14,14,15,13,3,3,1,1,10,9,0,0,-1,2
796,796,792,792,14,14,13,13,1,1,2,1,0,4,0,0,1,0
674,674,679,679,13,16,15,16,1,2,2,1,0,-5,0,-3,1,-1
754,759,759,759,17,16,18,18,1,1,1,1,-5,0,0,1,-2,0
660,651,656,651,17,16,18,18,1,2,2,2,9,-5,5,1,-2,0
1012,1007,1007,1007,17,16,15,16,1,4,2,1,5,0,0,1,1,-1
426,426,421,440,20,19,20,18,1,2,1,1,0,5,-19,1,-1,2
581,571,567,567,18,19,18,18,1,1,2,1,10,4,0,-1,1,0
721,717,712,712,20,19,18,18,1,1,1,2,4,5,0,1,1,0
426,426,421,426,20,19,20,18,1,1,1,1,0,5,-5,1,-1,2
754,750,754,754,13,14,12,13,1,2,2,1,4,-4,0,-1,2,-1
393,379,374,374,13,14,15,13,1,1,3,2,14,5,0,-1,-1,2
323,314,309,304,14,17,15,16,2,2,2,2,9,5,5,-3,2,-1
374,370,379,379,20,19,20,21,1,3,1,1,4,-9,0,1,-1,-1
806,806,801,806,14,14,15,13,2,2,1,1,0,5,-5,0,-1,2
271,271,267,267,18,17,18,16,2,3,1,1,0,4,0,1,-1,2
867,857,853,848,14,14,13,13,2,1,2,2,10,4,5,0,1,0
501,487,487,487,18,19,18,19,1,1,1,1,14,0,0,-1,1,-1
712,703,693,693,20,19,20,18,2,1,1,3,9,10,0,1,-1,2
740,736,740,736,20,19,20,18,3,2,3,1,4,-4,4,1,-1,2
773,764,768,773,20,19,20,21,2,2,1,3,9,-4,-5,1,-1,-1
618,618,618,614,14,14,15,13,2,3,2,1,0,0,4,0,-1,2
323,314,314,309,14,14,15,16,3,2,1,1,9,0,5,0,-1,-1
1007,1003,1007,1007,13,14,12,13,1,3,2,1,4,-4,0,-1,2,-1
740,731,736,736,20,19,20,18,2,2,2,1,9,-5,0,1,-1,2
473,464,468,464,13,14,12,13,1,2,1,3,9,-4,4,-1,2,-1
787,773,768,768,14,14,12,13,2,2,3,3,14,5,0,0,2,-1
300,295,290,290,18,17,18,16,1,3,1,3,5,5,0,1,-1,2
215,206,201,286,21,19,21,16,1,2,1,1,9,5,-85,2,-2,5
670,665,665,670,13,14,12,13,3,3,1,3,5,0,-5,-1,2,-1
942,942,946,942,20,19,18,18,1,1,1,4,0,-4,4,1,1,0
1036,1031,1031,1026,20,19,20,18,1,3,1,2,5,0,5,1,-1,2
857,853,853,853,14,14,15,13,1,1,1,1,4,0,0,0,-1,2
792,782,782,782,14,17,15,16,1,2,1,2,10,0,0,-3,2,-1
581,576,571,571,14,17,15,16,2,2,1,1,5,5,0,-3,2,-1
393,389,389,389,17,19,18,18,2,1,2,1,4,0,0,-2,1,0
196,192,187,187,14,14,13,13,1,1,2,2,4,5,0,0,1,0
436,431,436,436,13,14,12,13,1,2,2,2,5,-5,0,-1,2,-1
328,323,323,318,14,14,13,13,1,3,2,2,5,0,5,0,1,0
665,665,656,660,17,16,15,16,1,1,1,2,0,9,-4,1,1,-1
614,609,609,604,14,14,13,13,1,2,3,2,5,0,5,0,1,0
206,192,196,201,14,17,15,16,4,2,3,1,14,-4,-5,-3,2,-1
464,454,454,459,17,16,15,16,1,1,1,1,10,0,-5,1,1,-1
379,370,370,374,13,14,15,13,2,2,1,1,9,0,-4,-1,-1,2
337,332,337,332,13,14,15,13,1,2,1,1,5,-5,5,-1,-1,2
187,182,1073,1078,14,14,12,13,3,2,3,1,5,-891,-5,0,2,-1
754,750,740,736,13,14,12,13,1,1,1,2,4,10,4,-1,2,-1
201,201,201,201,18,19,18,19,2,4,1,1,0,0,0,-1,1,-1
539,529,534,539,18,17,18,16,1,1,2,1,10,-5,-5,1,-1,2
801,801,796,796,14,14,15,13,2,3,2,1,0,5,0,0,-1,2
370,365,360,356,13,14,12,13,2,3,2,1,5,5,4,-1,2,-1
628,618,618,614,21,19,21,21,1,2,2,1,10,0,4,2,-2,0
224,224,224,220,18,17,18,19,2,1,2,1,0,0,4,1,-1,-1
881,871,871,871,18,19,18,18,3,2,1,1,10,0,0,-1,1,0
454,450,454,450,20,19,18,18,1,2,2,1,4,-4,4,1,1,0
557,557,553,553,14,14,15,13,3,3,2,1,0,4,0,0,-1,2
1031,1026,1021,1021,17,19,18,18,1,1,1,1,5,5,0,-2,1,0
1012,1003,1012,1003,13,14,12,13,3,3,2,1,9,-9,9,-1,2,-1
543,534,529,529,18,17,18,19,3,2,3,1,9,5,0,1,-1,-1
295,290,290,286,14,17,15,16,1,1,1,2,5,0,4,-3,2,-1
529,524,524,524,14,17,15,16,1,3,1,4,5,0,0,-3,2,-1
267,262,253,248,14,14,13,13,3,3,2,1,5,9,5,0,1,0
576,576,576,571,18,19,18,18,3,1,1,1,0,0,5,-1,1,0
1012,1003,1003,1003,13,14,15,13,1,2,3,2,9,0,0,-1,-1,2
642,642,642,637,13,14,12,13,3,2,1,1,0,0,5,-1,2,-1
876,871,871,871,14,14,15,13,1,2,1,1,5,0,0,0,-1,2
754,750,750,750,17,16,15,16,1,2,2,3,4,0,0,1,1,-1
857,853,848,848,14,17,15,16,2,3,2,1,4,5,0,-3,2,-1
674,670,698,674,13,14,12,13,3,1,2,1,4,-28,24,-1,2,-1
843,843,839,834,14,14,13,13,1,1,3,1,0,4,5,0,1,0
304,304,304,304,18,17,18,16,2,1,3,1,0,0,0,1,-1,2
398,393,398,393,17,16,15,16,3,1,4,2,5,-5,5,1,1,-1
243,243,248,248,14,14,15,13,1,2,2,3,0,-5,0,0,-1,2
286,281,271,271,18,17,18,16,1,3,1,1,5,10,0,1,-1,2
674,665,665,660,13,14,15,13,2,3,2,1,9,0,5,-1,-1,2
839,829,829,824,14,14,15,13,1,2,1,2,10,0,5,0,-1,2
946,942,942,937,17,16,18,16,2,3,1,2,4,0,5,1,-2,2
524,520,515,515,18,19,18,19,1,2,1,1,4,5,0,-1,1,-1
1026,1021,1021,1017,17,19,18,18,3,2,1,1,5,0,4,-2,1,0
436,431,436,431,13,14,12,13,1,2,1,1,5,-5,5,-1,2,-1
693,684,679,679,20,19,18,18,2,1,3,1,9,5,0,1,1,0
576,571,571,567,14,17,15,16,2,4,3,2,5,0,4,-3,2,-1
642,642,637,637,13,16,15,16,4,1,2,1,0,5,0,-3,1,-1
229,210,201,440,14,14,13,18,1,2,1,1,19,9,-239,0,1,-5
351,342,346,342,13,14,12,13,1,2,1,3,9,-4,4,-1,2,-1
1068,1064,1064,1059,13,14,12,13,2,1,1,2,4,0,5,-1,2,-1
529,515,529,562,14,14,15,13,2,3,1,1,14,-14,-33,0,-1,2
698,689,689,689,17,16,15,16,3,3,1,1,9,0,0,1,1,-1
806,792,792,787,14,14,13,13,1,3,1,1,14,0,5,0,1,0
398,393,398,393,13,16,15,16,3,1,1,2,5,-5,5,-3,1,-1
674,674,670,670,13,14,12,13,1,3,3,2,0,4,0,-1,2,-1
506,506,431,506,14,14,10,13,2,2,1,1,0,75,-75,0,4,-3
576,567,562,562,18,19,18,18,1,2,3,1,9,5,0,-1,1,0
689,684,679,679,20,19,20,18,2,1,1,1,5,5,0,1,-1,2
224,215,215,215,14,17,15,16,2,1,1,2,9,0,0,-3,2,-1
553,548,543,543,14,17,15,16,2,1,1,1,5,5,0,-3,2,-1
1078,1073,1073,1073,13,14,15,13,2,3,2,3,5,0,0,-1,-1,2
604,600,600,600,14,17,15,16,2,1,3,2,4,0,0,-3,2,-1
993,989,989,984,17,16,18,18,2,1,3,2,4,0,5,1,-2,0
1045,1026,1036,1036,17,16,18,16,2,1,1,2,19,-10,0,1,-2,2
271,253,257,271,14,14,13,13,2,2,1,1,18,-4,-14,0,1,0
684,684,703,684,17,16,18,16,1,3,1,1,0,-19,19,1,-2,2
417,412,412,412,20,19,20,18,1,1,1,1,5,0,0,1,-1,2
717,717,717,712,20,19,20,21,1,1,2,1,0,0,5,1,-1,-1
623,618,618,614,14,14,13,13,2,1,1,2,5,0,4,0,1,0
318,314,318,314,14,14,13,13,3,4,2,2,4,-4,4,0,1,0
389,389,389,384,13,14,12,13,1,4,3,2,0,0,5,-1,2,-1
820,815,810,810,14,14,15,13,1,1,3,1,5,5,0,0,-1,2
309,304,314,309,18,17,18,19,2,2,1,1,5,-10,5,1,-1,-1
496,473,468,468,14,16,15,16,1,2,2,1,23,5,0,-2,1,-1
187,1073,1073,1073,21,19,20,18,1,2,3,3,-886,0,0,2,-1,2
736,736,726,726,20,19,20,21,3,3,3,4,0,10,0,1,-1,-1
1059,1054,1054,1050,13,14,15,13,1,3,2,2,5,0,4,-1,-1,2
703,693,689,689,13,14,15,13,3,1,1,1,10,4,0,-1,-1,2
867,862,862,857,14,14,13,13,1,3,2,1,5,0,5,0,1,0
295,286,290,998,14,14,15,18,1,2,1,1,9,-4,-708,0,-1,-3
717,712,712,707,17,16,18,18,3,2,1,2,5,0,5,1,-2,0
843,839,839,839,18,17,18,16,1,3,1,1,4,0,0,1,-1,2
220,220,220,215,21,19,20,19,2,1,1,2,0,0,5,2,-1,1
524,520,520,524,18,19,18,19,3,2,1,3,4,0,-4,-1,1,-1
974,956,951,946,13,14,12,13,4,4,2,3,18,5,5,-1,2,-1
674,670,670,665,13,14,12,13,3,1,2,1,4,0,5,-1,2,-1
824,801,796,796,14,17,15,16,1,2,1,3,23,5,0,-3,2,-1
993,998,1059,993,13,14,15,13,1,1,3,3,-5,-61,66,-1,-1,2
773,768,792,796,20,19,21,21,4,1,2,3,5,-24,-4,1,-2,0
974,974,974,979,13,14,15,13,1,2,2,1,0,0,-5,-1,-1,2
965,970,965,965,20,19,20,21,2,1,1,3,-5,5,0,1,-1,-1
923,918,918,914,14,14,13,13,2,1,2,4,5,0,4,0,1,0
1068,1073,1073,1073,20,19,20,21,3,1,1,2,-5,0,0,1,-1,-1
674,665,670,665,13,14,15,13,2,2,2,1,9,-5,5,-1,-1,2
567,567,562,553,21,19,20,21,2,1,1,2,0,5,9,2,-1,-1
1026,1021,1026,1026,13,14,15,13,1,2,1,2,5,-5,0,-1,-1,2
670,670,674,670,13,14,15,16,2,3,2,2,0,-4,4,-1,-1,-1
778,764,759,764,13,14,15,13,1,1,1,3,14,5,-5,-1,-1,2
276,271,271,271,14,14,13,13,1,3,1,1,5,0,0,0,1,0
923,904,904,909,14,14,15,13,3,1,1,3,19,0,-5,0,-1,2
787,778,773,773,14,14,12,13,1,1,3,2,9,5,0,0,2,-1
342,332,328,328,13,16,15,16,1,1,1,1,10,4,0,-3,1,-1
253,243,243,239,14,14,15,13,1,2,1,2,10,0,4,0,-1,2
374,365,370,374,20,19,20,21,1,1,2,1,9,-5,-4,1,-1,-1
1068,1068,1064,1059,13,14,15,13,3,2,1,3,0,4,5,-1,-1,2
412,403,403,403,20,19,20,21,2,2,1,1,9,0,0,1,-1,-1
1003,993,989,984,13,14,15,13,2,1,1,2,10,4,5,-1,-1,2
496,492,492,492,14,14,15,13,1,3,2,1,4,0,0,0,-1,2
1012,1007,1012,1012,20,19,18,18,1,1,1,2,5,-5,0,1,1,0
304,300,300,295,21,19,20,19,3,2,1,2,4,0,5,2,-1,1
801,796,796,796,14,14,15,13,3,2,2,4,5,0,0,0,-1,2
492,468,468,464,14,14,12,13,2,4,1,3,24,0,4,0,2,-1
839,829,843,834,14,17,15,16,1,1,4,2,10,-14,9,-3,2,-1
623,623,628,623,14,14,13,13,2,1,1,2,0,-5,5,0,1,0
736,726,726,726,13,16,15,16,3,2,1,3,10,0,0,-3,1,-1
1003,998,1003,998,20,19,20,21,2,2,2,3,5,-5,5,1,-1,-1
496,496,487,492,14,14,13,13,1,1,1,1,0,9,-5,0,1,0
759,754,759,754,13,14,12,13,2,3,5,2,5,-5,5,-1,2,-1
656,656,651,646,20,19,20,21,2,3,3,2,0,5,5,1,-1,-1
618,614,618,614,21,19,21,19,2,1,1,2,4,-4,4,2,-2,2
665,651,642,637,13,14,12,13,2,1,3,1,14,9,5,-1,2,-1
712,707,703,707,13,14,15,13,1,2,1,3,5,4,-4,-1,-1,2
736,731,731,726,20,19,18,18,1,2,2,2,5,0,5,1,1,0
862,857,853,853,14,14,13,13,1,3,1,1,5,4,0,0,1,0
960,951,956,956,20,19,20,18,3,2,3,1,9,-5,0,1,-1,2
717,712,712,712,13,14,15,13,2,3,2,2,5,0,0,-1,-1,2
792,764,754,745,14,14,12,13,3,2,2,2,28,10,9,0,2,-1
731,721,717,712,20,19,20,18,2,1,1,2,10,4,5,1,-1,2
295,290,290,290,18,19,18,19,1,1,1,1,5,0,0,-1,1,-1
773,768,764,764,13,16,15,16,3,1,1,1,5,4,0,-3,1,-1
586,581,576,576,18,17,18,18,3,3,1,1,5,5,0,1,-1,0
1026,1017,1017,1012,13,14,12,13,1,2,1,1,9,0,5,-1,2,-1
876,876,871,871,14,14,13,13,2,1,1,3,0,5,0,0,1,0
459,459,454,454,17,16,18,18,1,1,1,1,0,5,0,1,-2,0
707,707,815,707,20,19,23,18,1,1,1,1,0,-108,108,1,-4,5
220,210,206,201,18,17,18,16,1,2,3,2,10,4,5,1,-1,2
473,473,473,468,13,16,15,16,2,1,2,2,0,0,5,-3,1,-1
815,806,806,806,14,14,13,13,2,2,2,1,9,0,0,0,1,0
562,562,557,553,14,14,15,13,1,3,1,2,0,5,4,0,-1,2
529,524,524,529,18,19,18,19,2,1,1,1,5,0,-5,-1,1,-1
731,726,721,717,17,16,15,16,3,1,1,1,5,5,4,1,1,-1
412,407,407,403,17,16,18,18,1,1,2,2,5,0,4,1,-2,0
689,684,684,684,17,16,18,18,2,2,2,1,5,0,0,1,-2,0
224,224,229,224,14,17,15,16,2,3,1,2,0,-5,5,-3,2,-1
323,323,328,323,21,19,21,21,2,2,2,2,0,-5,5,2,-2,0
346,342,342,342,20,19,20,21,1,2,1,2,4,0,0,1,-1,-1
567,557,557,557,14,17,15,16,1,1,1,1,10,0,0,-3,2,-1
895,890,895,890,21,19,20,19,1,3,1,2,5,-5,5,2,-1,1
1026,1017,1017,1012,13,14,15,13,3,3,1,2,9,0,5,-1,-1,2
351,346,346,346,13,14,15,13,1,2,2,1,5,0,0,-1,-1,2
286,281,281,276,18,17,18,18,3,1,1,1,5,0,5,1,-1,0
337,332,332,332,13,14,13,13,3,2,1,1,5,0,0,-1,1,0
351,351,346,346,17,16,15,16,3,2,2,3,0,5,0,1,1,-1
342,337,337,332,20,19,18,18,3,1,2,1,5,0,5,1,1,0
839,834,834,829,14,14,13,13,1,1,1,2,5,0,5,0,1,0
890,886,886,881,18,19,18,19,2,1,2,1,4,0,5,-1,1,-1
534,534,534,534,14,17,15,16,2,1,1,2,0,0,0,-3,2,-1
806,792,810,824,14,17,15,16,1,2,1,1,14,-18,-14,-3,2,-1
374,365,360,356,17,16,15,16,2,1,1,2,9,5,4,1,1,-1
389,384,384,379,17,16,18,16,2,1,3,3,5,0,5,1,-2,2
562,562,562,567,21,19,20,21,2,1,1,1,0,0,-5,2,-1,-1
623,618,623,623,21,19,21,21,2,1,2,1,5,-5,0,2,-2,0
262,257,262,262,21,19,20,18,3,2,2,3,5,-5,0,2,-1,2
1031,1021,1021,1021,13,14,12,13,2,2,1,1,10,0,0,-1,2,-1
539,534,529,534,18,19,18,18,3,1,1,2,5,5,-5,-1,1,0
248,229,224,224,14,17,15,16,3,2,1,2,19,5,0,-3,2,-1
243,248,239,234,18,19,18,18,3,1,2,1,-5,9,5,-1,1,0
965,951,946,946,13,14,12,13,2,2,2,2,14,5,0,-1,2,-1
867,862,867,867,18,17,18,18,3,1,2,1,5,-5,0,1,-1,0
1054,1059,360,1054,17,16,23,16,1,1,1,3,-5,699,-694,1,-7,7
820,806,810,806,14,17,15,16,1,2,2,1,14,-4,4,-3,2,-1
745,745,745,745,20,19,20,21,1,2,1,2,0,0,0,1,-1,-1
900,886,886,886,14,14,13,13,2,1,1,3,14,0,0,0,1,0
979,974,974,970,13,14,12,13,1,3,2,4,5,0,4,-1,2,-1
571,571,571,567,21,19,20,21,3,1,1,1,0,0,4,2,-1,-1
370,365,360,365,20,19,20,21,1,1,1,1,5,5,-5,1,-1,-1
590,586,586,586,18,17,18,16,1,4,1,1,4,0,0,1,-1,2
445,440,440,440,20,19,20,21,3,1,1,1,5,0,0,1,-1,-1
871,857,857,862,14,17,15,16,1,1,4,3,14,0,-5,-3,2,-1
300,295,295,290,14,14,13,13,1,2,1,1,5,0,5,0,1,0
914,900,909,904,18,17,18,19,3,2,2,2,14,-9,5,1,-1,-1
876,862,862,867,14,14,13,13,1,3,1,1,14,0,-5,0,1,0
904,895,900,900,18,17,18,19,1,2,1,1,9,-5,0,1,-1,-1
815,815,810,810,18,17,18,16,2,1,1,2,0,5,0,1,-1,2
300,290,286,286,14,14,13,13,1,3,2,1,10,4,0,0,1,0
768,764,768,764,13,14,12,13,3,4,2,1,4,-4,4,-1,2,-1
614,614,618,614,14,14,13,13,3,2,2,1,0,-4,4,0,1,0
524,524,515,520,18,19,18,19,2,1,1,3,0,9,-5,-1,1,-1
970,960,956,956,20,19,18,18,1,1,1,2,10,4,0,1,1,0
679,660,665,970,13,14,12,18,1,5,2,1,19,-5,-305,-1,2,-6
773,768,773,778,13,14,12,13,1,1,1,1,5,-5,-5,-1,2,-1
267,267,271,267,21,19,20,21,1,1,2,2,0,-4,4,2,-1,-1
459,459,459,454,13,14,12,13,1,3,2,3,0,0,5,-1,2,-1
660,656,660,656,13,14,15,13,3,2,2,1,4,-4,4,-1,-1,2
337,337,337,328,20,19,18,19,1,1,2,1,0,0,9,1,1,-1
914,909,909,904,14,14,15,13,1,3,1,2,5,0,5,0,-1,2
389,393,389,389,13,14,12,13,1,3,1,2,-4,4,0,-1,2,-1
881,867,867,867,14,14,13,13,1,2,2,3,14,0,0,0,1,0
979,970,974,974,20,19,20,21,2,3,2,1,9,-4,0,1,-1,-1
801,801,806,801,14,14,13,13,1,2,2,3,0,-5,5,0,1,0
524,515,506,510,14,17,15,16,1,3,2,3,9,9,-4,-3,2,-1
454,459,454,454,13,14,12,13,3,2,1,3,-5,5,0,-1,2,-1
665,651,656,642,13,14,12,13,2,3,2,2,14,-5,14,-1,2,-1
492,482,478,478,14,14,13,13,1,1,2,1,10,4,0,0,1,0
731,726,726,721,13,14,12,13,2,2,3,2,5,0,5,-1,2,-1
768,764,768,764,20,19,20,18,1,3,2,1,4,-4,4,1,-1,2
1050,1045,1045,1040,13,14,12,13,1,2,1,2,5,0,5,-1,2,-1
914,914,914,909,14,14,15,13,1,3,2,3,0,0,5,0,-1,2
895,890,895,886,14,14,15,13,1,2,2,2,5,-5,9,0,-1,2
909,895,895,890,14,17,15,16,1,2,2,2,14,0,5,-3,2,-1
609,600,604,651,18,19,18,18,3,2,2,1,9,-4,-47,-1,1,0
224,290,206,201,14,17,15,16,2,1,1,2,-66,84,5,-3,2,-1
431,426,426,421,17,16,18,16,1,3,2,1,5,0,5,1,-2,2
454,454,454,450,20,19,18,18,2,1,1,1,0,0,4,1,1,0
1073,1068,1064,1068,20,19,20,18,1,2,1,1,5,4,-4,1,-1,2
482,468,464,459,14,14,12,13,1,3,1,3,14,4,5,0,2,-1
618,618,618,623,14,17,15,16,2,1,1,1,0,0,-5,-3,2,-1
300,295,295,295,18,19,18,19,1,1,3,1,5,0,0,-1,1,-1
224,215,210,215,14,14,15,13,3,2,3,2,9,5,-5,0,-1,2
731,721,721,721,17,19,18,18,2,1,1,2,10,0,0,-2,1,0
862,853,853,848,18,19,18,18,1,1,2,2,9,0,5,-1,1,0
1012,1007,1007,1003,17,16,18,16,1,1,2,2,5,0,4,1,-2,2
979,970,965,965,13,14,12,13,2,2,2,2,9,5,0,-1,2,-1
745,740,740,740,13,14,15,13,3,3,2,2,5,0,0,-1,-1,2
515,506,510,506,21,19,20,21,3,3,1,2,9,-4,4,2,-1,-1
454,450,450,450,17,16,18,18,2,3,1,3,4,0,0,1,-2,0
431,421,421,417,13,14,12,13,2,3,1,1,10,0,4,-1,2,-1
918,918,914,918,14,14,15,13,2,2,1,1,0,4,-4,0,-1,2
276,271,271,271,18,19,20,18,3,1,1,1,5,0,0,-1,-1,2
979,974,970,970,20,19,20,21,2,2,1,3,5,4,0,1,-1,-1
332,323,323,323,13,14,13,13,1,2,1,2,9,0,0,-1,1,0
824,796,792,801,14,14,13,13,1,1,1,1,28,4,-9,0,1,0
843,834,834,834,14,14,15,13,1,3,1,1,9,0,0,0,-1,2
778,773,773,768,13,14,12,13,1,3,2,4,5,0,5,-1,2,-1
187,187,187,182,18,17,18,19,1,1,2,1,0,0,5,1,-1,-1
229,220,220,215,14,14,13,13,1,2,2,2,9,0,5,0,1,0
900,900,895,895,21,19,20,21,2,1,1,1,0,5,0,2,-1,-1
876,862,848,843,18,17,18,16,3,1,3,2,14,14,5,1,-1,2
567,557,562,557,18,17,18,16,3,2,2,2,10,-5,5,1,-1,2
576,571,576,571,14,14,15,13,1,1,2,1,5,-5,5,0,-1,2
440,440,431,431,13,16,15,16,3,3,1,1,0,9,0,-3,1,-1
267,262,262,267,21,19,20,18,3,1,1,1,5,0,-5,2,-1,2
721,707,717,712,13,14,12,13,1,1,2,1,14,-10,5,-1,2,-1
778,773,773,773,20,19,20,18,1,1,1,1,5,0,0,1,-1,2
1054,1045,1045,1045,13,14,15,16,2,4,3,1,9,0,0,-1,-1,-1
201,196,201,201,18,17,18,19,1,1,1,1,5,-5,0,1,-1,-1
839,834,829,829,18,19,18,19,3,1,1,2,5,5,0,-1,1,-1
468,473,473,468,13,16,15,16,3,3,2,1,-5,0,5,-3,1,-1
206,201,196,206,14,17,15,16,2,2,1,1,5,5,-10,-3,2,-1
196,192,187,196,18,17,18,16,1,1,1,5,4,5,-9,1,-1,2
998,993,1003,998,13,14,12,13,3,2,1,1,5,-10,5,-1,2,-1
614,614,609,609,14,14,15,13,2,3,2,1,0,5,0,0,-1,2
206,196,192,192,18,19,18,19,1,1,3,1,10,4,0,-1,1,-1
951,942,937,937,20,19,20,21,1,2,1,1,9,5,0,1,-1,-1
914,904,909,909,18,19,18,19,1,3,2,1,10,-5,0,-1,1,-1
276,262,267,262,14,14,15,16,1,2,1,2,14,-5,5,0,-1,-1
914,904,909,904,14,14,15,16,1,2,2,2,10,-5,5,0,-1,-1
923,923,923,923,18,17,18,19,1,1,1,3,0,0,0,1,-1,-1
895,876,881,989,14,14,13,11,2,2,2,1,19,-5,-108,0,1,2
857,848,843,843,14,14,15,13,5,2,3,3,9,5,0,0,-1,2
1073,1064,1068,1073,17,16,15,16,1,2,1,1,9,-4,-5,1,1,-1
1007,998,998,993,20,19,20,21,1,2,1,1,9,0,5,1,-1,-1
829,810,815,810,18,19,18,19,3,1,1,1,19,-5,5,-1,1,-1
468,464,628,468,17,16,18,16,1,2,1,2,4,-164,160,1,-2,2
328,318,318,318,21,19,21,21,1,2,1,1,10,0,0,2,-2,0
932,923,923,923,17,17,15,16,1,1,1,2,9,0,0,0,2,-1
407,403,403,398,20,19,20,18,2,1,2,1,4,0,5,1,-1,2
1040,1031,1045,1050,13,14,12,13,1,2,1,1,9,-14,-5,-1,2,-1
210,201,201,201,18,17,18,19,1,2,1,1,9,0,0,1,-1,-1
586,576,576,571,21,19,18,18,1,3,1,2,10,0,5,2,1,0
792,787,787,782,14,14,13,13,2,2,2,1,5,0,5,0,1,0
473,468,468,468,20,19,18,18,1,1,2,1,5,0,0,1,1,0
309,304,304,304,14,14,15,16,4,2,1,1,5,0,0,0,-1,-1
895,886,886,881,18,17,18,19,2,2,2,1,9,0,5,1,-1,-1
539,534,529,529,14,14,15,13,3,3,1,2,5,5,0,0,-1,2
267,262,262,262,21,19,20,21,1,2,1,1,5,0,0,2,-1,-1
656,651,651,646,13,14,12,13,2,1,1,1,5,0,5,-1,2,-1
543,539,543,539,21,19,20,21,3,2,1,2,4,-4,4,2,-1,-1
595,590,595,590,18,17,18,19,1,2,1,2,5,-5,5,1,-1,-1
876,871,876,867,18,19,18,18,1,2,1,2,5,-5,9,-1,1,0
581,576,581,581,21,19,20,21,2,2,2,2,5,-5,0,2,-1,-1
998,989,989,984,17,19,18,18,1,2,2,1,9,0,5,-2,1,0
604,590,590,586,14,14,13,13,3,2,2,3,14,0,4,0,1,0
290,290,286,286,18,19,18,19,2,3,3,1,0,4,0,-1,1,-1
843,843,839,839,14,14,15,13,2,3,1,1,0,4,0,0,-1,2
267,267,267,262,14,14,15,16,2,2,1,3,0,0,5,0,-1,-1
614,614,614,609,14,14,15,13,2,3,1,2,0,0,5,0,-1,2
1036,1031,1031,1036,17,19,18,18,3,1,1,1,5,0,-5,-2,1,0
740,731,731,726,13,14,12,13,1,2,1,2,9,0,5,-1,2,-1
548,539,543,543,21,19,20,18,3,2,1,1,9,-4,0,2,-1,2
196,201,196,201,18,17,18,19,1,2,1,1,-5,5,-5,1,-1,-1
721,717,717,712,13,14,15,13,2,3,2,1,4,0,5,-1,-1,2
834,834,834,829,18,17,18,16,2,2,2,1,0,0,5,1,-1,2
703,698,698,698,17,16,15,16,1,1,1,1,5,0,0,1,1,-1
407,403,393,389,13,14,12,13,1,3,3,1,4,10,4,-1,2,-1
824,815,810,810,18,17,18,16,1,1,1,1,9,5,0,1,-1,2
398,393,393,393,20,19,18,18,1,2,1,1,5,0,0,1,1,0
993,989,989,984,17,16,15,16,3,3,1,1,4,0,5,1,1,-1
960,951,956,951,20,19,18,18,2,2,4,2,9,-5,5,1,1,0
576,586,567,567,21,19,20,21,1,1,1,2,-10,19,0,2,-1,-1
1003,989,974,979,13,14,15,13,2,2,1,1,14,15,-5,-1,-1,2
773,773,773,768,17,16,15,16,1,1,2,2,0,0,5,1,1,-1
421,417,417,417,13,14,15,13,3,3,2,2,4,0,0,-1,-1,2
351,351,346,346,20,19,20,21,1,1,1,1,0,5,0,1,-1,-1
506,501,506,501,18,19,18,19,1,1,2,1,5,-5,5,-1,1,-1
834,834,834,829,21,19,20,21,1,2,3,3,0,0,5,2,-1,-1
539,529,524,520,21,19,18,19,4,2,1,1,10,5,4,2,1,-1
473,473,473,543,17,16,18,16,3,2,3,1,0,0,-70,1,-2,2
998,998,1007,993,17,16,18,18,3,1,2,2,0,-9,14,1,-2,0
454,459,454,454,20,19,20,21,3,3,1,1,-5,5,0,1,-1,-1
623,623,623,623,21,19,21,19,3,1,1,1,0,0,0,2,-2,2
314,300,300,295,14,14,13,13,1,4,2,2,14,0,5,0,1,0
257,253,257,257,14,17,15,16,2,3,3,3,4,-4,0,-3,2,-1
426,417,417,412,13,14,12,13,1,3,4,3,9,0,5,-1,2,-1
576,571,567,567,18,19,18,18,2,1,1,1,5,4,0,-1,1,0
370,370,360,356,20,19,20,18,2,1,1,1,0,10,4,1,-1,2
614,609,604,604,21,19,20,19,1,2,1,1,5,5,0,2,-1,1
1026,1012,1012,1017,17,16,18,16,3,2,1,1,14,0,-5,1,-2,2
257,257,253,253,14,14,15,13,2,3,3,2,0,4,0,0,-1,2
379,318,318,318,13,14,15,13,3,2,1,1,61,0,0,-1,-1,2
914,904,904,900,21,19,20,21,1,1,2,2,10,0,4,2,-1,-1
614,604,604,600,14,14,13,13,1,2,2,3,10,0,4,0,1,0
281,276,276,271,18,19,18,18,3,3,2,2,5,0,5,-1,1,0
346,346,342,346,13,14,15,13,3,1,3,1,0,4,-4,-1,-1,2
318,323,318,309,18,19,18,19,2,1,2,2,-5,5,9,-1,1,-1
1021,1021,1021,1021,17,16,15,16,2,2,2,1,0,0,0,1,1,-1
581,567,557,562,14,17,15,16,1,3,1,3,14,10,-5,-3,2,-1
421,421,417,417,20,19,20,18,1,1,3,1,0,4,0,1,-1,2
881,871,881,881,18,17,18,16,1,2,1,2,10,-10,0,1,-1,2
412,398,398,398,13,14,15,16,3,2,3,1,14,0,0,-1,-1,-1
403,393,398,393,17,16,18,16,2,2,2,1,10,-5,5,1,-2,2
750,750,750,750,20,19,20,21,1,1,1,1,0,0,0,1,-1,-1
286,281,281,281,18,19,18,19,1,2,1,1,5,0,0,-1,1,-1
768,731,740,736,13,14,15,13,3,1,1,3,37,-9,4,-1,-1,2
450,440,440,440,13,14,12,13,1,1,3,2,10,0,0,-1,2,-1
1026,1021,1021,1026,20,19,20,21,1,3,1,1,5,0,-5,1,-1,-1
951,946,942,937,20,19,20,21,1,2,2,1,5,4,5,1,-1,-1
712,698,693,689,13,14,12,13,3,1,1,2,14,5,4,-1,2,-1
637,628,623,623,17,19,18,19,3,1,3,1,9,5,0,-2,1,-1
187,187,192,187,18,17,18,19,2,1,2,2,0,-5,5,1,-1,-1
646,651,646,646,13,16,15,16,3,1,3,1,-5,5,0,-3,1,-1
595,586,590,586,14,14,13,13,1,2,3,1,9,-4,4,0,1,0
286,281,286,286,21,19,20,19,1,1,2,1,5,-5,0,2,-1,1
801,801,801,801,21,19,21,19,1,3,1,2,0,0,0,2,-2,2
407,403,412,407,17,16,18,18,1,2,3,1,4,-9,5,1,-2,0
487,487,487,482,14,14,13,13,1,3,2,2,0,0,5,0,1,0
421,412,407,403,20,19,18,18,1,1,2,1,9,5,4,1,1,0
524,520,524,520,21,19,20,19,2,2,2,2,4,-4,4,2,-1,1
201,192,192,196,18,17,18,19,2,5,3,2,9,0,-4,1,-1,-1
970,970,974,970,20,19,20,18,1,2,2,1,0,-4,4,1,-1,2
553,543,543,543,14,14,13,13,2,3,1,1,10,0,0,0,1,0
323,309,304,300,14,17,15,16,1,3,3,2,14,5,4,-3,2,-1
810,806,806,801,18,19,18,19,2,1,1,2,4,0,5,-1,1,-1
881,871,876,876,21,19,20,21,1,2,2,1,10,-5,0,2,-1,-1
286,286,286,286,14,17,15,16,2,3,1,1,0,0,0,-3,2,-1
520,515,520,515,18,19,18,19,3,2,2,1,5,-5,5,-1,1,-1
815,806,810,815,21,19,20,21,1,2,2,3,9,-4,-5,2,-1,-1
989,979,979,974,17,16,18,16,2,3,2,1,10,0,5,1,-2,2
567,562,562,562,14,17,15,16,2,2,1,1,5,0,0,-3,2,-1
806,806,801,801,21,19,21,21,3,3,2,1,0,5,0,2,-2,0
834,829,829,829,21,19,20,21,1,2,1,1,5,0,0,2,-1,-1
867,862,857,857,14,14,15,13,1,3,1,3,5,5,0,0,-1,2
417,412,417,412,17,16,18,16,2,1,2,1,5,-5,5,1,-2,2
421,417,417,417,17,16,15,16,1,1,1,1,4,0,0,1,1,-1
1040,1026,1031,1036,20,19,18,18,1,2,1,3,14,-5,-5,1,1,0
393,384,384,379,20,19,20,18,2,2,1,2,9,0,5,1,-1,2
1068,1064,1064,1059,13,14,12,13,2,3,2,3,4,0,5,-1,2,-1
290,290,290,286,14,17,15,16,3,3,2,1,0,0,4,-3,2,-1
909,909,918,914,14,14,13,13,2,2,2,1,0,-9,4,0,1,0
764,628,628,623,20,19,21,21,1,1,2,2,136,0,5,1,-2,0
1026,1026,1021,1017,20,19,20,21,3,1,1,2,0,5,4,1,-1,-1
323,318,318,318,14,14,13,13,2,2,1,1,5,0,0,0,1,0
248,243,243,234,14,17,15,16,2,1,2,2,5,0,9,-3,2,-1
764,759,754,759,20,19,20,18,2,1,1,1,5,5,-5,1,-1,2
796,792,787,792,18,17,18,16,2,2,1,2,4,5,-5,1,-1,2
843,843,848,839,18,17,18,16,2,2,2,2,0,-5,9,1,-1,2
740,736,736,740,20,19,20,18,1,1,1,1,4,0,-4,1,-1,2
1007,998,1003,998,17,16,18,18,2,2,1,1,9,-5,5,1,-2,0
871,867,862,862,14,14,13,13,2,3,1,1,4,5,0,0,1,0
1036,1036,1036,1036,17,16,18,16,3,2,3,3,0,0,0,1,-2,2
286,271,257,257,14,14,13,13,1,3,1,1,15,14,0,0,1,0
600,595,595,595,18,19,18,19,1,1,1,3,5,0,0,-1,1,-1
398,393,393,393,13,14,12,13,1,2,1,3,5,0,0,-1,2,-1
867,857,857,857,14,17,15,16,1,2,2,1,10,0,0,-3,2,-1
871,867,862,857,14,17,15,16,2,3,4,2,4,5,5,-3,2,-1
586,586,586,586,18,17,18,16,2,3,1,2,0,0,0,1,-1,2
1054,1050,1054,1050,20,19,18,18,1,2,3,1,4,-4,4,1,1,0
937,932,932,932,20,19,20,21,1,2,1,1,5,0,0,1,-1,-1
862,867,857,857,14,14,15,13,2,3,1,1,-5,10,0,0,-1,2
314,300,309,309,14,14,15,13,1,4,1,1,14,-9,0,0,-1,2
1017,1007,1007,1007,20,19,20,18,1,2,1,5,10,0,0,1,-1,2
609,604,609,609,14,17,15,16,1,2,2,3,5,-5,0,-3,2,-1
309,304,300,295,14,14,15,16,2,1,3,1,5,4,5,0,-1,-1
1059,1054,1054,1054,13,14,15,13,3,2,1,1,5,0,0,-1,-1,2
604,595,604,600,14,17,15,16,1,2,2,1,9,-9,4,-3,2,-1
853,843,843,843,18,17,18,18,1,4,3,1,10,0,0,1,-1,0
557,553,557,553,18,19,18,18,2,2,2,1,4,-4,4,-1,1,0
787,792,787,787,14,14,15,16,1,1,2,1,-5,5,0,0,-1,-1
360,356,351,356,13,14,15,13,2,2,1,1,4,5,-5,-1,-1,2
492,487,496,501,21,19,21,21,1,3,1,2,5,-9,-5,2,-2,0
210,206,201,206,14,17,15,16,2,2,3,2,4,5,-5,-3,2,-1
918,914,914,914,14,17,15,16,1,1,1,1,4,0,0,-3,2,-1
923,239,900,904,14,14,13,13,1,1,1,1,684,-661,-4,0,1,0
674,665,665,665,17,19,18,18,2,1,1,2,9,0,0,-2,1,0
323,318,323,318,18,17,18,19,3,1,2,1,5,-5,5,1,-1,-1
707,698,698,679,13,14,12,13,4,2,2,3,9,0,19,-1,2,-1
740,731,736,731,20,19,20,18,1,2,2,1,9,-5,5,1,-1,2
637,637,623,628,17,16,15,16,1,1,2,1,0,14,-5,1,1,-1
182,1073,1078,1078,14,14,13,13,2,3,1,1,-891,-5,0,0,1,0
970,965,970,960,17,16,18,18,1,1,2,2,5,-5,10,1,-2,0
721,712,712,712,13,14,15,16,1,3,1,1,9,0,0,-1,-1,-1
829,834,829,829,14,14,15,13,1,2,3,3,-5,5,0,0,-1,2
665,660,656,651,13,14,15,13,3,1,3,2,5,4,5,-1,-1,2
998,998,998,989,20,19,18,18,3,1,2,2,0,0,9,1,1,0
576,571,567,567,21,19,20,21,2,1,1,2,5,4,0,2,-1,-1
998,998,993,993,17,19,18,18,1,3,3,1,0,5,0,-2,1,0
224,224,224,220,14,17,15,16,2,3,3,1,0,0,4,-3,2,-1
848,839,839,839,14,14,15,13,1,2,1,1,9,0,0,0,-1,2
543,539,539,539,18,19,18,18,2,1,3,1,4,0,0,-1,1,0
524,520,520,515,18,19,18,19,1,1,2,2,4,0,5,-1,1,-1
848,839,839,829,21,19,20,21,3,1,1,2,9,0,10,2,-1,-1
210,206,210,206,18,17,18,16,2,3,1,1,4,-4,4,1,-1,2
956,956,951,951,13,14,12,13,3,1,1,4,0,5,0,-1,2,-1
1012,1012,1012,1012,13,14,15,13,1,2,1,2,0,0,0,-1,-1,2
773,768,773,773,17,16,18,18,3,2,2,1,5,-5,0,1,-2,0
300,300,295,295,14,14,15,13,2,2,1,3,0,5,0,0,-1,2
501,492,501,492,21,19,21,21,1,1,1,3,9,-9,9,2,-2,0
332,328,323,328,20,19,21,21,1,1,1,1,4,5,-5,1,-2,0
454,450,445,440,20,19,20,18,2,3,1,2,4,5,5,1,-1,2
309,309,300,300,21,19,20,19,1,4,1,1,0,9,0,2,-1,1
365,360,365,360,20,19,18,18,1,1,1,1,5,-5,5,1,1,0
778,768,764,764,13,14,12,13,2,2,2,1,10,4,0,-1,2,-1
496,487,492,487,21,19,21,21,1,2,2,1,9,-5,5,2,-2,0
351,346,346,346,20,19,18,18,2,2,1,1,5,0,0,1,1,0
529,520,510,510,14,17,15,16,1,3,1,3,9,10,0,-3,2,-1
984,979,979,970,17,16,18,18,3,2,2,4,5,0,9,1,-2,0
576,567,571,571,14,14,13,13,3,1,2,3,9,-4,0,0,1,0
1036,1036,1036,1036,17,16,18,18,1,2,1,1,0,0,0,1,-2,0
1017,1017,1012,1017,17,16,18,16,1,1,2,1,0,5,-5,1,-2,2
281,276,276,271,14,14,15,13,2,3,2,1,5,0,5,0,-1,2
820,820,815,810,21,19,20,21,3,1,1,2,0,5,5,2,-1,-1
867,576,576,576,18,19,20,18,1,1,1,2,291,0,0,-1,-1,2
693,684,684,684,13,16,15,13,2,1,3,1,9,0,0,-3,1,2
365,360,360,360,20,19,20,21,2,1,2,1,5,0,0,1,-1,-1
820,815,820,810,14,14,15,13,1,2,1,2,5,-5,10,0,-1,2
689,679,679,684,20,19,20,21,5,2,3,2,10,0,-5,1,-1,-1
946,942,937,942,13,14,12,13,1,2,1,1,4,5,-5,-1,2,-1
346,342,342,342,20,19,20,21,4,1,1,1,4,0,0,1,-1,-1
998,993,993,993,20,19,20,21,2,2,3,1,5,0,0,1,-1,-1
736,731,726,726,20,19,20,21,2,2,2,5,5,5,0,1,-1,-1
1054,1045,1045,1045,20,19,20,21,2,2,1,1,9,0,0,1,-1,-1
206,196,196,196,14,17,15,16,2,2,1,1,10,0,0,-3,2,-1
1054,1050,1054,1050,20,19,20,18,1,2,2,1,4,-4,4,1,-1,2
562,548,557,562,18,19,18,18,3,2,2,1,14,-9,-5,-1,1,0
745,740,740,740,17,16,18,18,2,2,1,1,5,0,0,1,-2,0
543,539,543,539,14,17,15,16,2,2,2,1,4,-4,4,-3,2,-1
510,501,496,496,14,17,15,16,2,1,3,1,9,5,0,-3,2,-1
459,459,459,454,20,19,20,18,1,2,2,3,0,0,5,1,-1,2
717,717,717,717,13,14,15,13,1,3,1,5,0,0,0,-1,-1,2
454,450,450,454,17,16,18,18,1,2,1,1,4,0,-4,1,-2,0
346,346,346,351,17,16,15,16,1,2,3,1,0,0,-5,1,1,-1
618,623,623,618,14,14,13,13,2,2,2,2,-5,0,5,0,1,0
820,815,820,810,18,19,18,19,3,2,2,2,5,-5,10,-1,1,-1
759,759,754,754,17,16,15,16,1,1,1,1,0,5,0,1,1,-1
196,192,192,192,21,19,21,19,1,3,1,1,4,0,0,2,-2,2
989,974,965,965,17,16,15,16,4,3,2,1,15,9,0,1,1,-1
642,637,637,637,13,14,15,13,2,1,1,1,5,0,0,-1,-1,2
281,271,271,276,18,17,18,18,1,2,1,3,10,0,-5,1,-1,0
281,276,276,276,18,17,18,16,2,2,3,1,5,0,0,1,-1,2
534,534,534,534,21,19,20,21,2,2,1,1,0,0,0,2,-1,-1
182,1073,1078,1073,14,14,13,13,2,2,1,1,-891,-5,5,0,1,0
876,867,871,871,14,14,15,13,1,1,2,3,9,-4,0,0,-1,2
553,548,548,543,21,19,20,18,2,1,2,2,5,0,5,2,-1,2
539,534,534,534,14,14,15,13,1,2,2,1,5,0,0,0,-1,2
492,482,482,482,18,19,18,19,1,1,1,1,10,0,0,-1,1,-1
993,989,984,984,20,19,18,18,1,1,1,1,4,5,0,1,1,0
782,773,773,773,21,19,20,18,1,2,1,2,9,0,0,2,-1,2
909,904,904,900,21,19,20,21,1,1,1,2,5,0,4,2,-1,-1
318,318,314,314,21,19,21,19,2,1,1,2,0,4,0,2,-2,2
951,951,946,942,20,19,18,18,1,3,1,2,0,5,4,1,1,0
1064,1059,1064,1064,17,19,18,18,1,2,2,1,5,-5,0,-2,1,0
290,281,267,271,14,17,15,16,3,1,1,3,9,14,-4,-3,2,-1
665,750,660,660,17,16,15,16,3,1,1,1,-85,90,0,1,1,-1
960,956,951,974,13,14,15,16,2,3,1,1,4,5,-23,-1,-1,-1
496,487,487,487,14,14,13,13,3,2,3,1,9,0,0,0,1,0
487,468,464,464,14,14,12,13,1,2,3,1,19,4,0,0,2,-1
239,234,234,234,14,17,15,16,2,3,1,1,5,0,0,-3,2,-1
965,960,960,960,20,19,20,18,3,4,1,2,5,0,0,1,-1,2
1017,1017,1012,1012,17,16,15,16,2,3,1,1,0,5,0,1,1,-1
543,534,534,534,14,14,15,16,1,5,1,2,9,0,0,0,-1,-1
918,914,904,904,21,19,20,19,1,1,1,1,4,10,0,2,-1,1
660,656,656,651,17,16,15,16,2,3,2,1,4,0,5,1,1,-1
839,834,839,829,21,19,20,21,2,3,2,2,5,-5,10,2,-1,-1
206,196,201,196,21,19,21,21,1,2,1,2,10,-5,5,2,-2,0
407,398,398,403,13,14,15,13,1,2,1,1,9,0,-5,-1,-1,2
740,736,731,768,20,19,18,18,1,3,3,1,4,5,-37,1,1,0
407,403,403,407,17,16,15,16,2,1,2,3,4,0,-4,1,1,-1
1078,1068,1073,1068,17,16,15,16,1,2,2,1,10,-5,5,1,1,-1
928,928,918,918,14,17,15,16,1,1,2,1,0,10,0,-3,2,-1
586,590,586,586,14,17,15,16,1,3,1,1,-4,4,0,-3,2,-1
717,712,703,703,13,14,12,13,2,6,3,3,5,9,0,-1,2,-1
717,703,707,707,17,16,18,18,1,2,1,1,14,-4,0,1,-2,0
539,529,529,529,21,19,20,21,3,3,1,1,10,0,0,2,-1,-1
337,323,328,328,20,19,18,19,2,2,1,1,14,-5,0,1,1,-1
1021,1017,1012,1012,13,14,12,13,2,3,2,2,4,5,0,-1,2,-1
234,224,224,224,14,14,15,13,2,2,1,1,10,0,0,0,-1,2
206,196,196,196,14,14,13,13,2,3,2,1,10,0,0,0,1,0
309,304,300,300,14,14,13,13,2,1,3,1,5,4,0,0,1,0
806,801,801,801,14,14,13,13,1,1,2,1,5,0,0,0,1,0
567,557,553,553,21,19,20,21,3,1,1,1,10,4,0,2,-1,-1
1007,1007,1007,1007,13,14,15,13,3,2,1,2,0,0,0,-1,-1,2
881,862,867,862,14,14,13,13,5,2,2,4,19,-5,5,0,1,0
1054,1050,1050,1050,17,16,18,18,3,2,2,1,4,0,0,1,-2,0
674,674,679,674,17,16,15,16,3,4,4,1,0,-5,5,1,1,-1
1059,1054,1054,1050,13,14,15,13,3,3,2,1,5,0,4,-1,-1,2
515,510,506,501,14,14,13,13,2,1,2,3,5,4,5,0,1,0
370,365,365,365,17,19,18,18,3,1,1,1,5,0,0,-2,1,0
356,351,351,346,13,14,12,13,2,2,2,3,5,0,5,-1,2,-1
196,192,192,192,18,19,18,19,3,1,2,1,4,0,0,-1,1,-1
1068,1064,1059,1059,13,14,12,13,3,2,1,5,4,5,0,-1,2,-1
412,417,412,407,13,16,15,16,2,2,1,2,-5,5,5,-3,1,-1
389,374,374,370,13,14,12,13,1,4,1,2,15,0,4,-1,2,-1
914,904,900,895,14,14,13,13,1,2,2,2,10,4,5,0,1,0
286,267,267,271,14,14,13,13,1,1,3,3,19,0,-4,0,1,0
342,337,332,337,17,16,15,16,3,1,1,1,5,5,-5,1,1,-1
440,440,436,436,17,16,18,18,3,3,1,1,0,4,0,1,-2,0
918,918,918,914,18,19,18,19,3,3,2,1,0,0,4,-1,1,-1
778,773,778,773,17,16,18,16,1,2,2,2,5,-5,5,1,-2,2
304,300,300,300,18,19,18,19,1,2,1,1,4,0,0,-1,1,-1
220,220,220,220,18,19,18,19,2,2,1,1,0,0,0,-1,1,-1
337,332,337,342,20,19,20,21,3,2,2,2,5,-5,-5,1,-1,-1
1078,1073,1073,1073,17,16,15,16,2,3,1,1,5,0,0,1,1,-1
721,712,712,712,17,16,15,16,1,1,2,1,9,0,0,1,1,-1
787,782,787,782,18,19,18,19,1,1,2,1,5,-5,5,-1,1,-1
993,993,993,993,13,14,12,13,1,2,2,1,0,0,0,-1,2,-1
942,942,937,937,17,16,15,16,1,2,3,2,0,5,0,1,1,-1
759,745,731,731,17,16,18,18,3,2,1,1,14,14,0,1,-2,0
496,492,492,487,14,14,15,13,2,2,2,1,4,0,5,0,-1,2
614,604,614,614,18,17,18,19,2,1,2,2,10,-10,0,1,-1,-1
595,586,590,586,18,17,18,16,3,2,1,2,9,-4,4,1,-1,2
412,412,407,407,20,19,20,18,2,1,3,1,0,5,0,1,-1,2
909,904,904,904,14,14,15,16,2,2,1,1,5,0,0,0,-1,-1
1045,1040,1040,1040,17,16,18,16,1,1,1,1,5,0,0,1,-2,2
1045,1036,1031,1031,17,19,18,18,1,1,1,1,9,5,0,-2,1,0
586,586,576,576,14,14,15,13,1,1,3,2,0,10,0,0,-1,2
421,417,417,421,13,14,12,13,3,1,1,3,4,0,-4,-1,2,-1
618,614,614,618,21,19,21,19,3,2,2,3,4,0,-4,2,-2,2
642,632,642,632,20,19,20,18,1,2,3,2,10,-10,10,1,-1,2
243,234,234,234,14,14,15,13,2,4,1,3,9,0,0,0,-1,2
820,810,810,806,14,14,13,13,3,2,3,4,10,0,4,0,1,0
459,450,454,450,20,19,20,18,3,2,1,1,9,-4,4,1,-1,2
745,736,740,740,13,14,12,13,1,2,4,1,9,-4,0,-1,2,-1
712,712,707,703,13,14,12,13,2,1,3,2,0,5,4,-1,2,-1
220,210,201,196,14,14,15,13,2,3,1,2,10,9,5,0,-1,2
951,942,946,937,17,16,15,16,1,2,2,2,9,-4,9,1,1,-1
337,337,337,332,17,16,15,16,2,3,2,1,0,0,5,1,1,-1
323,318,318,318,14,17,15,16,2,1,2,3,5,0,0,-3,2,-1
909,895,900,904,18,19,18,19,2,2,2,1,14,-5,-4,-1,1,-1
356,346,351,346,13,14,15,13,2,2,2,1,10,-5,5,-1,-1,2
993,989,989,989,13,14,15,16,1,2,2,1,4,0,0,-1,-1,-1
534,496,496,492,14,14,15,13,1,2,2,2,38,0,4,0,-1,2
754,740,745,750,13,14,12,13,1,2,1,1,14,-5,-5,-1,2,-1
871,867,867,862,14,14,15,13,3,3,3,1,4,0,5,0,-1,2
604,604,600,600,18,19,18,19,2,1,1,1,0,4,0,-1,1,-1
937,918,923,928,13,14,15,13,1,4,1,1,19,-5,-5,-1,-1,2
956,956,956,951,20,19,20,18,1,1,2,3,0,0,5,1,-1,2
726,726,731,731,20,19,20,18,1,1,1,1,0,-5,0,1,-1,2
421,412,417,412,13,14,15,13,3,2,2,2,9,-5,5,-1,-1,2
754,750,745,745,17,16,18,18,3,2,1,1,4,5,0,1,-2,0
524,529,529,529,21,19,20,21,2,3,1,1,-5,0,0,2,-1,-1
1054,1054,1050,1050,20,19,18,18,1,1,3,1,0,4,0,1,1,0
712,703,703,698,13,14,15,13,2,2,1,2,9,0,5,-1,-1,2
810,806,806,806,21,19,20,21,1,1,1,1,4,0,0,2,-1,-1
595,595,595,600,21,19,20,21,2,2,1,3,0,0,-5,2,-1,-1
1036,1031,1031,1031,17,16,18,16,3,1,2,1,5,0,0,1,-2,2
773,773,778,778,20,19,18,18,1,1,2,1,0,-5,0,1,1,0
576,562,557,553,18,17,18,18,1,1,1,2,14,5,4,1,-1,0
271,267,267,267,21,19,20,18,1,1,1,1,4,0,0,2,-1,2
487,487,482,482,18,17,18,19,3,2,1,1,0,5,0,1,-1,-1
590,590,595,590,14,14,15,13,3,2,2,1,0,-5,5,0,-1,2
717,707,707,703,20,19,20,21,2,3,2,1,10,0,4,1,-1,-1
501,496,496,492,18,19,18,19,2,1,1,1,5,0,4,-1,1,-1
590,586,581,581,18,19,20,19,3,1,1,1,4,5,0,-1,-1,1
243,243,243,243,18,19,18,18,2,1,1,1,0,0,0,-1,1,0
993,989,984,984,17,16,18,16,2,2,4,3,4,5,0,1,-2,2
281,276,276,276,14,14,13,13,3,2,1,1,5,0,0,0,1,0
806,806,806,904,21,19,20,16,2,2,2,1,0,0,-98,2,-1,4
450,440,445,440,20,19,20,21,2,1,2,1,10,-5,5,1,-1,-1
567,557,553,548,18,19,18,18,1,4,6,1,10,4,5,-1,1,0
510,510,501,492,14,14,13,13,2,3,1,4,0,9,9,0,1,0
998,993,993,989,17,19,18,18,2,1,2,2,5,0,4,-2,1,0
731,726,726,721,17,16,18,18,2,3,1,2,5,0,5,1,-2,0
389,384,374,379,13,14,12,13,1,3,3,1,5,10,-5,-1,2,-1
309,304,304,304,14,14,15,13,2,2,1,2,5,0,0,0,-1,2
510,510,510,515,14,14,13,13,2,3,1,4,0,0,-5,0,1,0
904,914,904,909,14,17,15,16,4,1,1,1,-10,10,-5,-3,2,-1
600,600,600,595,14,14,15,13,2,1,1,1,0,0,5,0,-1,2
215,210,215,220,21,19,20,19,3,1,2,1,5,-5,-5,2,-1,1
609,600,614,614,18,19,18,19,1,1,2,1,9,-14,0,-1,1,-1
548,539,534,534,18,19,18,18,1,1,3,3,9,5,0,-1,1,0
492,487,492,487,18,19,18,19,1,3,1,2,5,-5,5,-1,1,-1
586,571,576,571,14,14,13,13,2,1,1,5,15,-5,5,0,1,0
281,286,276,276,14,14,15,13,2,2,1,2,-5,10,0,0,-1,2
248,253,243,243,18,17,18,16,1,1,2,1,-5,10,0,1,-1,2
496,492,492,487,18,19,18,19,3,2,2,1,4,0,5,-1,1,-1
768,759,764,764,20,19,20,21,2,2,1,1,9,-5,0,1,-1,-1
754,750,745,745,13,14,12,13,1,2,1,1,4,5,0,-1,2,-1
768,764,768,768,20,19,20,18,2,1,1,2,4,-4,0,1,-1,2
965,956,960,970,13,14,12,13,3,1,3,2,9,-4,-10,-1,2,-1
810,796,787,792,14,17,15,16,3,1,1,1,14,9,-5,-3,2,-1
360,356,351,351,17,16,18,16,1,1,1,1,4,5,0,1,-2,2
820,815,815,815,14,17,15,16,1,2,1,2,5,0,0,-3,2,-1
1021,1017,1017,1017,17,16,18,16,1,1,1,1,4,0,0,1,-2,2
379,374,374,374,13,14,15,16,2,2,1,1,5,0,0,-1,-1,-1
796,796,792,792,14,14,13,13,2,2,2,2,0,4,0,0,1,0
436,431,431,431,17,16,18,16,1,3,2,1,5,0,0,1,-2,2
351,337,337,332,13,14,12,13,2,2,3,2,14,0,5,-1,2,-1
454,454,454,450,17,19,18,18,2,1,2,2,0,0,4,-2,1,0
890,886,886,890,18,17,18,19,2,2,1,3,4,0,-4,1,-1,-1
731,731,736,731,13,14,15,13,3,2,3,1,0,-5,5,-1,-1,2
726,721,717,712,20,19,20,18,1,3,1,1,5,4,5,1,-1,2
665,656,651,660,13,14,15,13,2,1,3,1,9,5,-9,-1,-1,2
520,510,510,506,18,17,18,16,1,2,1,1,10,0,4,1,-1,2
923,914,914,914,14,14,15,16,2,2,3,3,9,0,0,0,-1,-1
1054,1054,1045,1045,17,16,18,18,2,1,1,2,0,9,0,1,-2,0
398,393,393,389,13,14,15,13,4,2,2,2,5,0,4,-1,-1,2
824,820,815,810,14,14,13,13,2,2,2,1,4,5,5,0,1,0
745,740,740,736,13,14,15,13,1,2,3,2,5,0,4,-1,-1,2
304,304,304,304,18,19,18,19,1,1,2,1,0,0,0,-1,1,-1
942,937,937,937,13,14,12,13,2,3,2,1,5,0,0,-1,2,-1
379,370,379,374,13,14,15,13,1,2,2,1,9,-9,5,-1,-1,2
900,900,900,900,18,17,18,19,2,3,3,1,0,0,0,1,-1,-1
271,267,281,271,14,14,15,13,2,4,1,1,4,-14,10,0,-1,2
824,806,806,806,14,14,15,13,1,4,1,3,18,0,0,0,-1,2
848,839,824,829,18,17,18,19,1,3,1,3,9,15,-5,1,-1,-1
895,886,890,886,14,14,15,13,3,2,4,1,9,-4,4,0,-1,2
665,656,646,646,13,14,12,13,1,2,2,1,9,10,0,-1,2,-1
257,253,253,248,14,14,15,13,3,1,3,2,4,0,5,0,-1,2
1036,1031,1031,1031,20,19,20,21,2,1,1,1,5,0,0,1,-1,-1
904,895,890,890,14,14,13,13,1,1,2,2,9,5,0,0,1,0
539,534,539,534,18,17,18,18,2,3,2,2,5,-5,5,1,-1,0
1040,1036,1040,1050,13,14,12,13,3,3,1,1,4,-4,-10,-1,2,-1
829,820,815,815,14,14,13,13,1,2,1,3,9,5,0,0,1,0
829,824,820,824,14,17,15,16,1,2,3,1,5,4,-4,-3,2,-1
248,300,220,224,14,14,15,16,1,1,1,1,-52,80,-4,0,-1,-1
281,281,276,281,18,17,18,16,3,1,1,2,0,5,-5,1,-1,2
956,960,960,960,17,16,18,16,1,2,2,1,-4,0,0,1,-2,2
473,468,468,468,20,19,20,21,1,3,1,1,5,0,0,1,-1,-1
182,182,187,182,14,14,13,13,2,1,2,1,0,-5,5,0,1,0
942,937,942,932,17,16,18,18,3,2,2,2,5,-5,10,1,-2,0
965,960,960,960,20,19,18,18,3,2,1,1,5,0,0,1,1,0
768,764,773,768,17,16,18,18,1,2,2,1,4,-9,5,1,-2,0
487,478,478,482,21,19,20,19,1,1,1,1,9,0,-4,2,-1,1
1026,1021,1017,1017,13,14,15,13,1,2,1,1,5,4,0,-1,-1,2
862,862,857,857,18,19,18,18,3,1,1,1,0,5,0,-1,1,0
309,304,304,309,21,19,20,19,2,1,3,1,5,0,-5,2,-1,1
773,768,768,768,13,16,15,16,2,2,3,1,5,0,0,-3,1,-1
182,182,1078,182,14,14,13,13,1,1,1,1,0,-896,896,0,1,0
384,379,379,374,17,16,15,16,2,3,1,1,5,0,5,1,1,-1
300,295,300,304,14,17,15,16,3,2,2,3,5,-5,-4,-3,2,-1
403,398,403,398,17,16,18,18,3,1,3,1,5,-5,5,1,-2,0
839,829,829,829,14,17,15,16,1,2,1,1,10,0,0,-3,2,-1
520,496,492,492,14,17,15,16,1,1,1,1,24,4,0,-3,2,-1
412,412,412,412,17,16,15,16,1,3,2,1,0,0,0,1,1,-1
243,234,243,239,14,17,15,16,2,2,2,2,9,-9,4,-3,2,-1
993,989,989,989,13,14,12,13,1,2,1,3,4,0,0,-1,2,-1
309,304,304,304,21,19,20,21,1,1,2,3,5,0,0,2,-1,-1
745,745,745,745,17,16,15,16,1,1,2,1,0,0,0,1,1,-1
1078,707,707,707,13,14,15,13,1,2,2,1,371,0,0,-1,-1,2
431,421,426,426,20,19,20,21,2,2,1,2,10,-5,0,1,-1,-1
895,895,895,895,18,19,18,19,2,2,1,1,0,0,0,-1,1,-1
670,665,670,670,13,14,12,13,1,2,2,1,5,-5,0,-1,2,-1
360,356,346,351,13,16,15,16,1,4,1,1,4,10,-5,-3,1,-1
370,365,360,360,13,14,12,13,1,3,2,1,5,5,0,-1,2,-1
286,286,290,417,18,19,18,18,2,2,2,1,0,-4,-127,-1,1,0
937,932,932,932,20,19,20,18,2,1,1,1,5,0,0,1,-1,2
806,796,801,796,14,17,15,16,3,2,1,2,10,-5,5,-3,2,-1
904,900,895,890,18,17,18,16,1,2,1,1,4,5,5,1,-1,2
482,473,478,473,14,14,13,13,2,2,1,2,9,-5,5,0,1,0
468,459,454,454,13,14,12,13,3,2,1,1,9,5,0,-1,2,-1
445,440,459,468,13,14,12,13,1,1,3,1,5,-19,-9,-1,2,-1
679,670,670,670,13,14,15,16,2,1,1,1,9,0,0,-1,-1,-1
328,318,323,314,14,14,13,13,1,3,1,1,10,-5,9,0,1,0
412,398,403,403,17,19,18,18,3,1,1,1,14,-5,0,-2,1,0
187,1073,1073,1068,14,14,12,13,2,2,2,2,-886,0,5,0,2,-1
389,384,389,384,17,16,15,16,2,1,2,3,5,-5,5,1,1,-1
960,956,960,956,13,16,15,16,2,1,2,1,4,-4,4,-3,1,-1
857,853,853,848,14,14,15,16,1,1,2,1,4,0,5,0,-1,-1
923,923,923,923,14,14,13,13,1,2,2,1,0,0,0,0,1,0
534,520,520,515,14,14,15,13,2,2,1,1,14,0,5,0,-1,2
604,600,600,600,21,19,20,21,1,2,1,1,4,0,0,2,-1,-1
656,651,656,656,17,19,18,18,1,1,2,1,5,-5,0,-2,1,0
196,192,196,192,18,19,18,19,1,2,2,1,4,-4,4,-1,1,-1
524,520,515,520,14,14,15,13,3,1,1,3,4,5,-5,0,-1,2
740,745,745,740,13,14,15,16,2,1,4,2,-5,0,5,-1,-1,-1
1036,1031,1031,1040,20,19,20,18,2,1,1,1,5,0,-9,1,-1,2
778,768,773,768,13,14,15,16,2,1,2,3,10,-5,5,-1,-1,-1
267,262,262,262,14,14,13,13,1,1,2,1,5,0,0,0,1,0
323,309,314,318,18,17,18,19,1,2,3,2,14,-5,-4,1,-1,-1
220,215,215,215,21,19,20,19,1,2,1,1,5,0,0,2,-1,1
253,253,248,243,18,17,18,18,2,2,3,1,0,5,5,1,-1,0
600,595,595,590,14,14,13,13,3,2,2,3,5,0,5,0,1,0
674,665,660,660,17,19,18,18,2,1,1,1,9,5,0,-2,1,0
548,539,543,562,18,19,18,18,1,1,2,1,9,-4,-19,-1,1,0
360,356,360,360,13,14,12,13,1,2,2,1,4,-4,0,-1,2,-1
374,646,365,365,13,19,15,16,1,1,1,2,-272,281,0,-6,4,-1
253,243,253,243,14,14,13,13,2,2,1,2,10,-10,10,0,1,0
271,271,267,267,14,14,13,13,2,1,1,1,0,4,0,0,1,0
314,314,314,309,18,19,18,19,1,1,1,2,0,0,5,-1,1,-1
965,951,951,956,13,14,12,13,2,2,1,5,14,0,-5,-1,2,-1
586,576,576,571,18,17,18,18,2,2,2,1,10,0,5,1,-1,0
604,600,604,609,18,17,18,16,5,1,1,1,4,-4,-5,1,-1,2
637,623,628,623,20,19,21,19,2,2,1,3,14,-5,5,1,-2,2
942,937,937,937,13,14,12,13,3,3,2,1,5,0,0,-1,2,-1
1026,1017,1021,1021,20,19,20,21,1,2,1,2,9,-4,0,1,-1,-1
271,267,262,262,14,14,15,13,3,3,1,2,4,5,0,0,-1,2
529,524,520,515,18,19,18,19,3,5,3,2,5,4,5,-1,1,-1
510,506,501,501,14,17,15,16,2,1,2,1,4,5,0,-3,2,-1
351,342,346,351,13,14,15,13,3,2,3,3,9,-4,-5,-1,-1,2
993,993,993,993,17,16,15,16,1,2,2,1,0,0,0,1,1,-1
736,731,731,736,17,16,15,16,1,1,1,1,5,0,-5,1,1,-1
1068,1059,1059,1054,13,14,12,13,2,2,1,1,9,0,5,-1,2,-1
562,562,562,562,18,17,18,16,2,1,1,3,0,0,0,1,-1,2
642,637,642,637,13,14,15,13,1,2,2,1,5,-5,5,-1,-1,2
960,956,960,965,13,14,15,16,1,1,3,1,4,-4,-5,-1,-1,-1
810,810,810,806,14,14,15,13,4,2,3,2,0,0,4,0,-1,2
365,365,365,365,13,14,12,13,4,3,3,1,0,0,0,-1,2,-1
782,768,773,773,14,14,15,13,2,4,1,2,14,-5,0,0,-1,2
707,703,693,693,17,19,18,18,2,2,2,2,4,10,0,-2,1,0
689,684,679,684,13,14,12,13,1,2,1,1,5,5,-5,-1,2,-1
257,248,248,248,18,19,18,18,1,1,1,1,9,0,0,-1,1,0
923,918,914,904,14,14,13,13,3,1,2,2,5,4,10,0,1,0
515,506,501,496,18,17,18,16,3,2,1,1,9,5,5,1,-1,2
370,365,365,365,17,16,18,18,2,1,1,1,5,0,0,1,-2,0
450,445,440,445,17,16,18,16,2,3,3,1,5,5,-5,1,-2,2
1040,1031,1036,1036,20,19,20,21,2,2,1,1,9,-5,0,1,-1,-1
210,201,210,206,14,17,15,16,2,2,2,1,9,-9,4,-3,2,-1
829,824,824,834,18,17,15,16,2,3,2,1,5,0,-10,1,2,-1
843,834,829,834,14,14,15,13,1,2,1,1,9,5,-5,0,-1,2
332,332,328,332,17,16,18,16,1,2,1,2,0,4,-4,1,-2,2
796,792,787,787,21,19,21,21,3,2,2,1,4,5,0,2,-2,0
314,300,300,295,18,19,18,19,1,1,1,2,14,0,5,-1,1,-1
698,698,689,689,13,14,12,13,1,3,3,1,0,9,0,-1,2,-1
923,876,876,867,14,17,15,16,3,1,2,3,47,0,9,-3,2,-1
267,257,257,253,18,17,18,18,3,3,1,2,10,0,4,1,-1,0
937,937,937,932,13,14,12,13,3,2,3,1,0,0,5,-1,2,-1
206,201,201,196,18,17,18,16,3,2,1,2,5,0,5,1,-1,2
886,876,867,867,14,14,13,13,2,3,3,1,10,9,0,0,1,0
895,900,937,946,18,19,18,18,3,1,2,1,-5,-37,-9,-1,1,0
1054,1045,1050,1040,13,14,12,13,1,6,2,2,9,-5,10,-1,2,-1
778,773,768,773,20,19,20,18,2,2,1,1,5,5,-5,1,-1,2
304,295,290,290,14,14,13,13,3,1,3,1,9,5,0,0,1,0
276,262,257,257,18,17,18,16,1,3,1,1,14,5,0,1,-1,2
993,984,979,979,13,14,12,13,2,3,3,2,9,5,0,-1,2,-1
609,604,609,604,14,17,15,16,1,2,2,1,5,-5,5,-3,2,-1
196,192,192,187,14,14,13,13,1,2,2,3,4,0,5,0,1,0
904,900,904,900,18,19,18,19,1,2,2,1,4,-4,4,-1,1,-1
515,510,510,506,14,14,13,13,1,3,2,2,5,0,4,0,1,0
379,370,539,323,13,14,13,11,1,3,1,1,9,-169,216,-1,1,2
337,323,314,309,13,14,15,13,2,2,1,2,14,9,5,-1,-1,2
243,239,234,239,18,19,18,18,1,3,1,1,4,5,-5,-1,1,0
782,773,778,778,18,19,18,18,1,2,1,1,9,-5,0,-1,1,0
618,623,618,623,21,19,21,21,4,1,1,3,-5,5,-5,2,-2,0
286,276,276,276,21,19,20,18,2,1,1,1,10,0,0,2,-1,2
956,946,942,937,13,14,12,13,1,2,2,2,10,4,5,-1,2,-1
824,815,820,820,21,19,20,21,3,2,2,1,9,-5,0,2,-1,-1
750,740,736,736,20,19,18,18,1,1,1,1,10,4,0,1,1,0
1007,998,998,998,13,14,12,13,1,2,1,2,9,0,0,-1,2,-1
750,745,750,750,17,19,18,18,1,2,2,2,5,-5,0,-2,1,0
815,806,806,806,14,17,15,16,2,1,2,1,9,0,0,-3,2,-1
576,571,571,567,14,17,15,16,1,1,2,3,5,0,4,-3,2,-1
281,276,276,271,21,19,20,21,4,4,2,2,5,0,5,2,-1,-1
206,201,192,196,18,19,18,19,1,1,3,1,5,9,-4,-1,1,-1
1045,1040,1045,1040,17,16,18,18,1,1,2,1,5,-5,5,1,-2,0
810,801,801,806,14,17,15,16,2,2,1,2,9,0,-5,-3,2,-1
459,459,459,450,20,19,18,18,1,1,2,2,0,0,9,1,1,0
187,182,1078,1073,14,17,15,16,2,2,1,2,5,-896,5,-3,2,-1
1003,998,998,998,20,19,20,18,3,1,1,2,5,0,0,1,-1,2
660,651,660,660,13,14,12,13,3,4,1,1,9,-9,0,-1,2,-1
979,965,965,965,13,14,12,13,2,3,3,1,14,0,0,-1,2,-1
384,384,384,384,13,16,15,16,3,1,2,1,0,0,0,-3,1,-1
736,721,721,721,13,14,15,13,2,2,2,2,15,0,0,-1,-1,2
309,304,304,309,14,14,15,16,1,2,1,1,5,0,-5,0,-1,-1
412,403,417,421,20,19,18,18,3,2,1,1,9,-14,-4,1,1,0
300,300,300,304,18,19,18,19,2,1,1,2,0,0,-4,-1,1,-1
515,510,506,501,14,14,15,13,2,3,2,2,5,4,5,0,-1,2
759,754,750,750,20,19,18,18,2,1,1,1,5,4,0,1,1,0
398,398,393,389,13,14,12,13,3,3,2,2,0,5,4,-1,2,-1
581,567,576,576,14,14,13,13,2,4,1,2,14,-9,0,0,1,0
942,937,923,918,17,16,15,16,2,1,3,1,5,14,5,1,1,-1
309,300,304,295,14,17,15,16,2,1,2,2,9,-4,9,-3,2,-1
670,670,665,670,20,19,20,21,1,1,1,2,0,5,-5,1,-1,-1
881,871,867,871,18,19,18,18,1,3,1,1,10,4,-4,-1,1,0
323,300,300,300,14,14,15,16,3,2,1,1,23,0,0,0,-1,-1
665,665,665,660,20,19,18,18,1,2,1,2,0,0,5,1,1,0
539,539,529,529,14,17,15,16,1,3,1,2,0,10,0,-3,2,-1
192,187,187,187,14,17,15,16,1,3,3,3,5,0,0,-3,2,-1
300,295,300,295,14,14,15,16,3,2,1,1,5,-5,5,0,-1,-1
745,740,740,736,20,19,18,18,3,1,1,3,5,0,4,1,1,0
210,201,201,196,18,19,18,19,1,1,1,1,9,0,5,-1,1,-1
665,656,651,651,17,16,18,16,1,1,3,2,9,5,0,1,-2,2
182,1073,1078,1073,14,14,15,13,1,2,2,2,-891,-5,5,0,-1,2
956,951,951,946,13,14,12,13,1,3,3,2,5,0,5,-1,2,-1
248,239,468,243,18,19,20,18,2,1,1,1,9,-229,225,-1,-1,2
351,351,351,351,13,14,12,13,4,3,1,3,0,0,0,-1,2,-1
740,740,736,736,20,19,20,18,1,3,1,1,0,4,0,1,-1,2
609,604,600,604,18,17,18,19,1,3,1,1,5,4,-4,1,-1,-1
365,356,351,351,13,14,12,13,1,2,1,3,9,5,0,-1,2,-1
1045,1036,1036,1026,13,14,12,13,2,4,3,2,9,0,10,-1,2,-1
234,220,215,220,14,14,13,13,1,2,1,3,14,5,-5,0,1,0
412,407,398,398,20,19,20,18,1,1,1,3,5,9,0,1,-1,2
342,332,337,332,13,14,15,13,2,2,2,1,10,-5,5,-1,-1,2
642,637,637,642,17,16,15,16,1,2,3,1,5,0,-5,1,1,-1
379,365,356,351,13,14,12,13,2,3,2,2,14,9,5,-1,2,-1
515,510,515,510,14,17,15,16,3,2,4,1,5,-5,5,-3,2,-1
215,201,192,187,14,14,13,13,1,1,2,3,14,9,5,0,1,0
1050,1045,1045,1040,13,14,12,13,2,2,2,2,5,0,5,-1,2,-1
974,974,974,965,13,14,15,13,1,6,2,2,0,0,9,-1,-1,2
895,881,881,871,14,14,15,13,1,2,1,1,14,0,10,0,-1,2
379,374,374,374,13,14,12,13,3,2,2,2,5,0,0,-1,2,-1
754,740,782,740,17,16,18,16,2,2,1,1,14,-42,42,1,-2,2
801,796,796,792,14,17,15,16,2,3,1,3,5,0,4,-3,2,-1
337,337,337,332,17,16,15,16,3,1,2,1,0,0,5,1,1,-1
609,595,590,586,14,14,13,13,3,3,1,3,14,5,4,0,1,0
201,201,196,192,14,14,15,13,2,3,1,1,0,5,4,0,-1,2
1040,1036,1036,1026,13,14,15,13,3,2,2,2,4,0,10,-1,-1,2
192,182,182,182,18,17,18,19,2,2,1,1,10,0,0,1,-1,-1
342,337,337,337,13,16,15,16,1,1,3,1,5,0,0,-3,1,-1
1007,998,998,998,13,16,15,16,2,3,3,1,9,0,0,-3,1,-1
970,974,974,974,17,16,18,16,1,1,1,1,-4,0,0,1,-2,2
946,942,932,937,13,14,15,13,4,1,1,3,4,10,-5,-1,-1,2
684,674,674,674,17,16,15,16,1,1,1,2,10,0,0,1,1,-1
782,773,773,768,14,14,12,13,2,2,1,2,9,0,5,0,2,-1
824,810,829,843,18,17,18,18,2,2,1,1,14,-19,-14,1,-1,0
815,810,810,815,14,17,15,16,1,2,1,3,5,0,-5,-3,2,-1
642,637,642,642,13,14,12,13,4,1,1,1,5,-5,0,-1,2,-1
328,318,318,314,14,14,15,13,1,2,1,1,10,0,4,0,-1,2
196,187,1054,1073,18,19,18,18,3,1,1,1,9,-867,-19,-1,1,0
398,393,393,393,17,16,18,16,3,3,1,1,5,0,0,1,-2,2
267,257,253,248,18,19,18,18,1,2,2,2,10,4,5,-1,1,0
328,318,318,318,14,14,15,16,1,1,1,1,10,0,0,0,-1,-1
196,187,196,187,14,14,13,13,3,2,1,2,9,-9,9,0,1,0
567,557,557,562,21,19,20,21,1,1,3,3,10,0,-5,2,-1,-1
379,374,370,370,20,19,20,18,2,1,1,1,5,4,0,1,-1,2
506,501,506,506,18,17,18,16,2,4,1,3,5,-5,0,1,-1,2
928,918,928,923,21,19,21,21,1,2,1,2,10,-10,5,2,-2,0
956,951,942,942,13,14,15,16,3,3,1,1,5,9,0,-1,-1,-1
389,379,374,379,20,19,20,21,2,2,3,1,10,5,-5,1,-1,-1
937,932,937,932,13,14,15,13,1,2,2,1,5,-5,5,-1,-1,2
286,286,281,271,21,19,20,18,2,1,1,2,0,5,10,2,-1,2
1064,1054,1054,1054,17,16,18,18,2,2,1,1,10,0,0,1,-2,0
586,586,581,581,18,19,18,19,1,3,2,1,0,5,0,-1,1,-1
436,436,440,431,20,19,20,18,3,2,1,1,0,-4,9,1,-1,2
304,304,304,295,14,17,15,16,1,1,2,2,0,0,9,-3,2,-1
764,750,754,759,20,19,18,18,3,2,1,1,14,-4,-5,1,1,0
759,750,750,754,17,19,18,18,3,2,2,1,9,0,-4,-2,1,0
1017,1017,1012,1012,13,14,12,13,2,3,3,2,0,5,0,-1,2,-1
674,665,670,670,20,19,20,18,2,2,2,2,9,-5,0,1,-1,2
1021,1017,1017,1012,13,16,15,16,2,5,2,1,4,0,5,-3,1,-1
689,689,689,689,13,14,12,13,1,2,2,1,0,0,0,-1,2,-1
290,281,271,267,14,14,13,13,2,5,3,2,9,10,4,0,1,0
220,215,215,210,21,19,20,21,2,2,1,1,5,0,5,2,-1,-1
843,839,834,834,18,19,18,18,3,1,1,1,4,5,0,-1,1,0
468,459,459,459,20,19,20,21,2,1,3,1,9,0,0,1,-1,-1
374,365,360,365,13,14,15,13,3,1,1,1,9,5,-5,-1,-1,2
562,557,553,553,14,17,15,16,2,1,2,1,5,4,0,-3,2,-1
417,412,417,417,17,16,15,16,3,4,1,1,5,-5,0,1,1,-1
182,1078,1064,1059,18,16,15,16,1,1,1,3,-896,14,5,2,1,-1
717,712,717,712,13,14,15,13,1,2,2,2,5,-5,5,-1,-1,2
182,1073,1073,1068,14,14,12,13,1,2,2,2,-891,0,5,0,2,-1
693,693,698,703,13,14,12,13,1,1,2,1,0,-5,-5,-1,2,-1
1068,1059,1064,1064,17,16,15,16,2,1,2,1,9,-5,0,1,1,-1
379,370,374,374,17,16,18,16,2,1,2,1,9,-4,0,1,-2,2
487,482,482,482,14,17,15,16,1,1,1,1,5,0,0,-3,2,-1
506,412,412,412,21,19,20,18,2,1,1,1,94,0,0,2,-1,2
464,464,459,459,17,16,18,16,1,1,1,2,0,5,0,1,-2,2
206,201,196,196,18,17,18,19,3,2,2,1,5,5,0,1,-1,-1
473,473,478,468,13,14,13,13,1,3,2,1,0,-5,10,-1,1,0
426,417,421,421,13,14,12,13,2,2,4,1,9,-4,0,-1,2,-1
979,974,974,970,20,19,20,18,1,3,2,2,5,0,4,1,-1,2
271,267,262,262,21,19,20,21,2,2,1,1,4,5,0,2,-1,-1
820,801,801,792,14,14,15,16,1,3,4,1,19,0,9,0,-1,-1
239,239,234,234,21,19,20,18,2,2,1,1,0,5,0,2,-1,2
281,271,267,267,18,19,18,18,3,1,1,1,10,4,0,-1,1,0
215,206,196,192,14,14,13,13,1,1,3,1,9,10,4,0,1,0
506,492,403,482,14,14,12,13,1,1,1,2,14,89,-79,0,2,-1
356,351,356,351,13,14,15,13,2,2,2,2,5,-5,5,-1,-1,2
571,567,567,567,14,14,15,13,1,1,2,3,4,0,0,0,-1,2
867,857,857,862,14,14,15,13,1,1,1,1,10,0,-5,0,-1,2
398,393,393,393,13,14,15,13,2,3,2,3,5,0,0,-1,-1,2
759,754,759,759,13,14,12,13,2,2,1,1,5,-5,0,-1,2,-1
646,646,651,642,17,16,18,18,1,2,2,3,0,-5,9,1,-2,0
674,670,665,665,13,14,12,13,1,1,1,1,4,5,0,-1,2,-1
890,886,881,881,18,17,18,16,2,1,1,2,4,5,0,1,-1,2
529,529,529,524,18,19,18,19,1,1,3,2,0,0,5,-1,1,-1
365,360,365,360,20,19,20,21,1,4,2,2,5,-5,5,1,-1,-1
253,234,234,234,21,19,20,18,1,2,1,1,19,0,0,2,-1,2
970,974,974,970,13,16,15,16,1,3,2,1,-4,0,4,-3,1,-1
201,196,196,192,14,17,15,16,2,1,2,2,5,0,4,-3,2,-1
421,417,417,417,17,16,18,18,3,2,1,2,4,0,0,1,-2,0
529,515,506,506,14,14,15,13,1,2,1,2,14,9,0,0,-1,2
229,220,210,210,14,14,15,13,2,1,1,1,9,10,0,0,-1,2
660,651,656,651,13,14,12,13,2,2,2,2,9,-5,5,-1,2,-1
989,989,993,989,13,14,12,13,1,2,2,1,0,-4,4,-1,2,-1
618,618,614,614,21,19,21,21,1,1,3,3,0,4,0,2,-2,0
267,262,257,257,14,14,15,13,1,3,2,2,5,5,0,0,-1,2
881,886,881,881,14,17,15,16,3,1,2,1,-5,5,0,-3,2,-1
628,623,623,623,21,19,21,19,1,2,1,1,5,0,0,2,-2,2
801,796,796,792,14,14,15,13,1,2,2,2,5,0,4,0,-1,2
736,740,736,736,13,14,15,13,2,1,1,2,-4,4,0,-1,-1,2
351,351,351,351,20,19,20,18,2,1,1,1,0,0,0,1,-1,2
684,674,670,670,20,19,20,21,2,1,1,1,10,4,0,1,-1,-1
604,600,600,595,14,14,15,13,4,2,6,2,4,0,5,0,-1,2
792,792,792,787,18,19,18,19,3,1,1,2,0,0,5,-1,1,-1
651,646,646,642,20,19,20,21,2,2,1,1,5,0,4,1,-1,-1
745,745,745,745,13,14,15,13,2,2,1,1,0,0,0,-1,-1,2
393,389,389,384,13,14,12,13,1,3,2,1,4,0,5,-1,2,-1
487,482,478,478,21,19,20,18,2,1,1,1,5,4,0,2,-1,2
740,740,736,736,13,16,15,16,2,2,1,1,0,4,0,-3,1,-1
862,848,848,843,14,17,15,16,3,1,2,1,14,0,5,-3,2,-1
586,581,576,576,14,14,13,13,2,2,1,2,5,5,0,0,1,0
309,304,304,304,14,17,15,16,3,2,1,2,5,0,0,-3,2,-1
665,665,665,665,20,19,20,18,1,2,2,1,0,0,0,1,-1,2
1012,1003,993,993,17,16,15,16,2,4,1,2,9,10,0,1,1,-1
764,759,754,754,17,16,18,18,2,2,1,1,5,5,0,1,-2,0
623,614,609,609,18,19,18,19,1,2,2,1,9,5,0,-1,1,-1
239,229,224,224,21,19,20,21,3,3,5,2,10,5,0,2,-1,-1
918,914,914,914,14,14,15,13,1,2,1,1,4,0,0,0,-1,2
290,281,290,286,21,19,20,21,1,1,2,1,9,-9,4,2,-1,-1
890,881,886,876,21,19,20,21,1,1,2,2,9,-5,10,2,-1,-1
210,201,201,201,18,17,18,16,2,2,3,1,9,0,0,1,-1,2
857,848,848,848,18,17,18,18,3,2,2,1,9,0,0,1,-1,0
300,300,300,290,14,14,13,13,4,3,1,2,0,0,10,0,1,0
923,909,918,923,18,17,18,19,2,2,2,2,14,-9,-5,1,-1,-1
346,337,337,337,13,14,15,13,1,2,2,2,9,0,0,-1,-1,2
450,450,450,450,13,14,15,16,1,2,1,1,0,0,0,-1,-1,-1
436,426,431,431,20,19,20,21,1,4,1,1,10,-5,0,1,-1,-1
257,257,262,253,14,14,15,13,2,1,2,2,0,-5,9,0,-1,2
192,1073,1073,1078,14,14,12,13,1,3,1,1,-881,0,-5,0,2,-1
698,689,693,689,20,19,18,18,2,2,2,2,9,-4,4,1,1,0
276,267,271,271,21,19,20,21,1,1,2,1,9,-4,0,2,-1,-1
524,524,524,520,18,17,18,16,2,2,1,1,0,0,4,1,-1,2
224,220,224,220,14,14,13,13,1,3,2,1,4,-4,4,0,1,0
1073,1064,1064,1064,13,14,12,13,1,2,2,1,9,0,0,-1,2,-1
553,534,534,529,14,14,13,13,1,2,2,2,19,0,5,0,1,0
1073,1064,1068,1068,13,14,15,13,1,2,1,1,9,-4,0,-1,-1,2
539,534,534,539,21,19,20,18,1,3,1,1,5,0,-5,2,-1,2
393,389,398,389,13,16,15,16,3,1,1,2,4,-9,9,-3,1,-1
445,436,431,431,13,14,15,13,1,1,2,3,9,5,0,-1,-1,2
501,492,492,487,18,17,18,19,1,2,1,2,9,0,5,1,-1,-1
815,815,815,815,18,19,18,19,2,1,2,1,0,0,0,-1,1,-1
576,571,576,576,18,19,18,18,2,2,5,2,5,-5,0,-1,1,0
1054,1050,1050,1050,17,16,18,18,2,2,1,1,4,0,0,1,-2,0
271,262,267,262,18,19,18,18,3,2,1,2,9,-5,5,-1,1,0
496,492,492,492,14,14,13,13,2,2,1,1,4,0,0,0,1,0
346,337,318,323,20,19,18,19,2,3,1,1,9,19,-5,1,1,-1
374,365,356,356,17,16,18,16,2,1,1,1,9,9,0,1,-2,2
600,586,576,576,14,14,15,13,1,3,2,2,14,10,0,0,-1,2
524,520,524,520,18,19,20,19,2,3,2,2,4,-4,4,-1,-1,1
670,665,670,670,13,14,12,13,1,2,3,1,5,-5,0,-1,2,-1
229,220,220,220,18,17,18,16,3,1,3,1,9,0,0,1,-1,2
764,754,750,750,13,16,15,16,1,2,3,2,10,4,0,-3,1,-1
1054,1050,1054,1050,13,14,12,13,1,2,2,3,4,-4,4,-1,2,-1
773,773,773,773,17,16,15,16,1,2,1,1,0,0,0,1,1,-1
323,323,323,318,18,17,18,19,2,2,1,2,0,0,5,1,-1,-1
187,182,1078,1073,14,17,15,16,1,1,2,2,5,-896,5,-3,2,-1
623,618,618,614,14,17,15,16,1,1,2,2,5,0,4,-3,2,-1
520,510,515,515,18,19,18,19,2,2,3,1,10,-5,0,-1,1,-1
623,609,609,614,14,17,15,16,1,2,3,1,14,0,-5,-3,2,-1
651,646,646,646,20,19,20,18,3,1,3,1,5,0,0,1,-1,2
421,407,576,412,13,16,18,16,3,2,1,1,14,-169,164,-3,-2,2
815,810,806,801,14,14,13,13,1,2,1,2,5,4,5,0,1,0
271,271,271,271,18,19,18,18,2,2,1,1,0,0,0,-1,1,0
295,295,295,300,14,14,15,13,4,2,2,5,0,0,-5,0,-1,2
937,937,937,932,17,16,18,18,2,1,2,1,0,0,5,1,-2,0
243,239,239,239,14,17,15,16,3,1,1,2,4,0,0,-3,2,-1
412,482,403,403,17,19,18,16,4,2,2,1,-70,79,0,-2,1,2
253,253,248,243,14,17,15,16,2,2,1,2,0,5,5,-3,2,-1
609,604,600,590,14,14,13,13,2,3,1,2,5,4,10,0,1,0
829,824,820,820,14,17,15,16,4,1,3,2,5,4,0,-3,2,-1
1073,1068,1068,1064,20,19,20,21,2,1,2,2,5,0,4,1,-1,-1
796,787,787,787,18,19,18,19,1,1,1,2,9,0,0,-1,1,-1
253,253,248,248,21,19,20,18,1,3,1,1,0,5,0,2,-1,2
229,220,215,220,14,14,15,13,1,2,3,1,9,5,-5,0,-1,2
407,393,398,403,17,16,18,18,4,2,3,2,14,-5,-5,1,-2,0
787,581,581,571,14,17,15,16,1,1,2,4,206,0,10,-3,2,-1
506,501,506,510,18,19,18,19,2,1,1,2,5,-5,-4,-1,1,-1
567,562,557,557,14,14,13,13,2,3,1,2,5,5,0,0,1,0
848,839,839,829,14,17,15,16,3,2,1,2,9,0,10,-3,2,-1
215,210,210,210,21,19,20,21,2,1,1,1,5,0,0,2,-1,-1
407,407,403,403,17,16,18,16,2,3,1,2,0,4,0,1,-2,2
937,923,914,914,13,14,13,13,2,2,1,2,14,9,0,-1,1,0
956,951,951,937,17,16,15,16,2,1,2,1,5,0,14,1,1,-1
984,979,989,989,13,14,12,13,2,2,2,1,5,-10,0,-1,2,-1
1017,1007,998,998,17,16,18,18,2,1,1,1,10,9,0,1,-2,0
871,867,871,857,14,14,13,13,3,2,2,4,4,-4,14,0,1,0
257,253,257,253,18,19,18,18,2,5,2,1,4,-4,4,-1,1,0
421,421,412,412,20,19,18,18,1,3,1,1,0,9,0,1,1,0
445,440,440,440,17,16,15,16,1,2,1,1,5,0,0,1,1,-1
834,820,829,824,14,17,15,16,1,2,2,3,14,-9,5,-3,2,-1
196,187,192,187,14,14,15,13,2,2,2,2,9,-5,5,0,-1,2
215,206,206,201,14,14,15,13,1,1,2,3,9,0,5,0,-1,2
642,637,637,637,13,14,15,13,2,1,2,1,5,0,0,-1,-1,2
515,506,506,506,21,19,20,19,1,1,1,1,9,0,0,2,-1,1
642,632,628,623,17,16,15,16,2,2,1,2,10,4,5,1,1,-1
548,543,539,543,18,17,18,18,1,3,1,1,5,4,-4,1,-1,0
506,496,506,501,14,14,13,13,2,2,2,2,10,-10,5,0,1,0
628,623,623,618,18,19,18,19,1,3,2,1,5,0,5,-1,1,-1
745,740,740,740,17,16,18,18,1,2,1,1,5,0,0,1,-2,0
768,759,764,764,17,16,18,18,1,2,2,1,9,-5,0,1,-2,0
1040,1040,1040,1040,13,16,15,16,2,3,4,1,0,0,0,-3,1,-1
796,792,796,796,18,19,21,19,1,2,1,1,4,-4,0,-1,-2,2
674,670,670,670,20,19,20,18,3,1,1,1,4,0,0,1,-1,2
543,539,539,543,18,17,18,18,1,2,1,3,4,0,-4,1,-1,0
623,614,609,604,18,19,21,19,1,3,1,1,9,5,5,-1,-2,2
206,196,201,192,14,17,15,16,2,3,2,2,10,-5,9,-3,2,-1
703,693,693,693,13,16,15,16,1,2,1,1,10,0,0,-3,1,-1
482,637,637,632,18,19,20,18,1,1,1,1,-155,0,5,-1,-1,2
810,810,806,806,18,17,18,16,2,1,1,1,0,4,0,1,-1,2
534,524,520,515,18,19,18,19,1,2,2,1,10,4,5,-1,1,-1
670,670,665,665,20,19,20,21,2,1,1,3,0,5,0,1,-1,-1
820,824,824,815,18,17,18,16,2,1,2,2,-4,0,9,1,-1,2
342,337,337,332,13,14,12,13,5,2,2,1,5,0,5,-1,2,-1
670,665,665,665,17,16,15,16,2,1,2,1,5,0,0,1,1,-1
918,918,918,918,14,17,15,16,2,2,1,1,0,0,0,-3,2,-1
295,290,286,290,14,14,15,13,3,3,3,1,5,4,-4,0,-1,2
886,881,886,881,21,19,20,21,3,2,1,2,5,-5,5,2,-1,-1
1068,1064,1064,1059,13,14,15,13,2,2,1,2,4,0,5,-1,-1,2
970,965,960,970,13,14,12,13,1,3,5,1,5,5,-10,-1,2,-1
281,276,281,276,14,17,15,16,1,1,3,1,5,-5,5,-3,2,-1
557,553,553,553,18,17,18,16,1,2,2,2,4,0,0,1,-1,2
918,895,890,890,14,17,15,16,3,2,4,1,23,5,0,-3,2,-1
515,506,576,510,14,14,15,13,3,2,2,4,9,-70,66,0,-1,2
698,684,689,684,17,16,18,16,2,2,2,2,14,-5,5,1,-2,2
712,703,707,698,13,16,15,16,2,2,1,1,9,-4,9,-3,1,-1
815,806,810,806,14,14,15,16,2,4,2,1,9,-4,4,0,-1,-1
698,698,689,703,13,14,15,16,2,4,5,1,0,9,-14,-1,-1,-1
440,436,436,431,13,14,15,13,1,2,2,2,4,0,5,-1,-1,2
843,829,824,824,14,14,15,13,3,2,2,1,14,5,0,0,-1,2
314,304,309,309,14,14,13,13,1,2,5,1,10,-5,0,0,1,0
290,286,276,276,14,14,13,13,1,4,1,2,4,10,0,0,1,0
300,295,295,295,14,17,15,16,3,1,2,3,5,0,0,-3,2,-1
351,342,346,346,13,14,15,13,3,2,1,1,9,-4,0,-1,-1,2
445,445,450,445,13,14,12,13,1,2,3,1,0,-5,5,-1,2,-1
914,909,909,909,18,19,18,19,2,1,1,1,5,0,0,-1,1,-1
445,440,445,440,13,14,12,13,1,2,3,2,5,-5,5,-1,2,-1
300,290,290,286,21,19,20,19,2,2,1,1,10,0,4,2,-1,1
604,595,600,600,18,19,18,19,1,2,2,1,9,-5,0,-1,1,-1
492,492,487,482,14,14,15,13,3,1,1,1,0,5,5,0,-1,2
853,843,848,853,18,19,18,18,1,3,1,1,10,-5,-5,-1,1,0
665,660,660,660,13,14,15,13,1,2,1,2,5,0,0,-1,-1,2
886,895,886,881,18,19,18,19,3,3,3,2,-9,9,5,-1,1,-1
998,993,993,989,20,19,20,18,1,2,1,3,5,0,4,1,-1,2
539,539,534,529,14,17,15,16,3,1,1,1,0,5,5,-3,2,-1
754,750,754,750,20,19,18,18,3,1,1,2,4,-4,4,1,1,0
192,187,187,182,18,19,18,19,1,2,2,1,5,0,5,-1,1,-1
1050,1050,1054,1045,13,14,15,16,1,2,2,1,0,-4,9,-1,-1,-1
595,586,586,586,14,14,15,16,1,3,2,3,9,0,0,0,-1,-1
529,524,524,524,14,17,15,16,3,1,1,1,5,0,0,-3,2,-1
403,393,393,389,13,14,12,13,2,2,3,3,10,0,4,-1,2,-1
848,843,853,848,18,17,18,18,2,2,2,6,5,-10,5,1,-1,0
970,965,960,960,20,19,18,18,3,3,1,1,5,5,0,1,1,0
848,843,839,839,18,17,18,16,3,4,2,3,5,4,0,1,-1,2
234,229,229,234,18,17,18,16,3,2,3,1,5,0,-5,1,-1,2
1078,1073,1068,1064,20,19,20,21,2,2,2,1,5,5,4,1,-1,-1
314,314,314,314,14,14,13,13,1,1,2,1,0,0,0,0,1,0
609,600,595,595,14,14,15,16,1,2,1,1,9,5,0,0,-1,-1
726,721,721,721,17,19,18,18,3,3,1,2,5,0,0,-2,1,0
276,267,281,271,14,17,15,16,1,2,4,2,9,-14,10,-3,2,-1
304,295,295,290,14,14,15,13,1,2,1,1,9,0,5,0,-1,2
782,815,792,796,14,17,15,16,2,1,2,3,-33,23,-4,-3,2,-1
1078,1073,1078,1073,20,19,20,21,1,1,2,1,5,-5,5,1,-1,-1
187,1073,1078,1073,14,14,13,13,1,2,2,2,-886,-5,5,0,1,0
496,487,487,487,18,19,18,19,2,2,1,2,9,0,0,-1,1,-1
628,609,604,604,14,14,13,13,1,2,2,3,19,5,0,0,1,0
454,445,436,431,20,19,20,21,2,3,1,3,9,9,5,1,-1,-1
937,932,932,932,17,16,18,16,2,2,1,1,5,0,0,1,-2,2
1012,1007,1007,1007,17,16,18,18,3,2,4,1,5,0,0,1,-2,0
215,210,210,210,18,17,18,19,2,1,1,1,5,0,0,1,-1,-1
623,628,628,628,14,17,15,16,2,1,1,1,-5,0,0,-3,2,-1
407,403,248,398,17,16,13,16,1,1,1,1,4,155,-150,1,3,-3
389,384,384,379,17,16,18,16,3,1,1,2,5,0,5,1,-2,2
314,309,314,304,18,17,18,16,3,2,2,3,5,-5,10,1,-1,2
436,431,436,431,20,19,20,21,1,3,2,2,5,-5,5,1,-1,-1
857,853,848,848,18,19,18,18,1,1,1,3,4,5,0,-1,1,0
618,618,623,618,14,17,15,16,2,4,2,1,0,-5,5,-3,2,-1
960,951,956,951,13,14,15,13,3,3,2,1,9,-5,5,-1,-1,2
736,731,731,731,20,19,18,18,1,2,1,1,5,0,0,1,1,0
853,843,843,839,18,17,15,16,1,1,1,2,10,0,4,1,2,-1
276,276,276,276,14,17,15,16,2,3,1,2,0,0,0,-3,2,-1
496,487,487,487,14,14,13,13,2,2,1,1,9,0,0,0,1,0
365,360,356,356,17,16,18,18,3,3,1,1,5,4,0,1,-2,0
867,857,857,862,18,17,18,16,3,2,1,3,10,0,-5,1,-1,2
857,848,839,839,21,19,20,18,1,1,1,2,9,9,0,2,-1,2
379,374,384,379,20,19,20,18,3,2,2,1,5,-10,5,1,-1,2
792,787,782,782,18,19,18,19,6,1,1,1,5,5,0,-1,1,-1
839,834,843,839,18,17,18,18,2,2,5,1,5,-9,4,1,-1,0
778,773,778,778,20,19,18,18,2,2,1,1,5,-5,0,1,1,0
918,914,914,918,21,19,21,21,3,1,1,1,4,0,-4,2,-2,0
867,843,848,843,14,14,15,13,3,6,3,2,24,-5,5,0,-1,2
365,360,360,360,17,19,18,18,3,2,3,1,5,0,0,-2,1,0
750,740,736,736,20,19,18,18,1,3,1,1,10,4,0,1,1,0
192,182,1073,1078,14,14,12,13,2,2,1,1,10,-891,-5,0,2,-1
984,979,979,974,13,16,15,16,3,1,1,2,5,0,5,-3,1,-1
379,370,370,370,13,14,12,13,2,2,1,2,9,0,0,-1,2,-1
398,384,379,374,20,19,20,18,1,1,3,1,14,5,5,1,-1,2
529,524,515,510,18,17,18,16,3,1,3,2,5,9,5,1,-1,2
524,524,520,520,14,14,15,13,2,3,3,1,0,4,0,0,-1,2
736,731,721,726,13,14,15,13,3,3,1,3,5,10,-5,-1,-1,2
290,290,290,286,14,17,15,16,1,1,2,2,0,0,4,-3,2,-1
806,792,778,871,14,14,15,13,1,3,1,1,14,14,-93,0,-1,2
942,937,937,932,13,14,15,13,3,2,2,1,5,0,5,-1,-1,2
914,900,900,900,14,14,13,13,1,3,3,1,14,0,0,0,1,0
337,337,337,328,17,19,18,19,1,1,2,1,0,0,9,-2,1,-1
937,937,937,937,13,14,12,13,1,1,2,3,0,0,0,-1,2,-1
473,464,459,459,17,16,15,16,1,4,3,1,9,5,0,1,1,-1
956,956,951,946,17,16,15,16,3,2,2,1,0,5,5,1,1,-1
351,351,346,342,20,19,20,21,2,1,1,1,0,5,4,1,-1,-1
646,637,646,646,13,14,12,13,3,2,1,3,9,-9,0,-1,2,-1
937,923,928,923,17,17,18,16,2,2,1,2,14,-5,5,0,-1,2
276,281,271,276,14,14,13,13,2,3,1,1,-5,10,-5,0,1,0
417,417,412,417,13,14,15,13,2,1,1,3,0,5,-5,-1,-1,2
1031,1021,1017,1017,17,16,15,16,3,2,3,1,10,4,0,1,1,-1
224,220,215,215,14,14,15,16,3,2,2,1,4,5,0,0,-1,-1
342,337,337,337,13,16,15,16,1,3,1,2,5,0,0,-3,1,-1
604,600,604,600,21,19,20,19,1,3,2,1,4,-4,4,2,-1,1
651,646,637,642,17,16,18,16,2,1,1,1,5,9,-5,1,-2,2
548,539,539,539,14,14,13,13,1,1,1,1,9,0,0,0,1,0
295,286,286,286,18,17,18,16,2,1,2,1,9,0,0,1,-1,2
295,286,286,281,18,19,18,19,1,2,2,1,9,0,5,-1,1,-1
482,482,478,478,18,17,18,18,1,2,1,1,0,4,0,1,-1,0
468,464,464,464,17,16,18,18,1,2,1,2,4,0,0,1,-2,0
1059,1050,1045,1045,17,16,18,18,2,2,1,1,9,5,0,1,-2,0
440,436,436,436,13,14,12,13,3,1,3,1,4,0,0,-1,2,-1
1045,1036,1026,1036,13,14,12,13,1,1,2,1,9,10,-10,-1,2,-1
365,360,356,356,13,16,15,16,2,2,3,1,5,4,0,-3,1,-1
754,759,750,750,20,19,20,21,3,1,1,2,-5,9,0,1,-1,-1
515,510,496,496,14,17,15,16,2,3,3,1,5,14,0,-3,2,-1
928,918,923,923,14,14,15,13,1,4,1,1,10,-5,0,0,-1,2
267,267,262,262,14,14,13,13,1,3,2,1,0,5,0,0,1,0
534,524,520,515,14,14,15,13,2,3,1,3,10,4,5,0,-1,2
192,187,187,182,18,17,18,19,2,1,1,1,5,0,5,1,-1,-1
918,923,923,918,21,19,21,21,2,1,1,2,-5,0,5,2,-2,0
871,862,862,862,18,19,18,18,3,2,1,2,9,0,0,-1,1,0
984,979,974,974,17,16,18,18,1,3,1,1,5,5,0,1,-2,0
904,900,895,895,14,14,15,13,2,3,2,1,4,5,0,0,-1,2
782,782,787,782,14,14,15,13,1,2,2,2,0,-5,5,0,-1,2
750,740,745,740,20,19,20,18,1,2,1,1,10,-5,5,1,-1,2
196,192,192,187,14,17,15,16,2,1,2,2,4,0,5,-3,2,-1
314,300,286,286,18,19,18,19,3,1,1,2,14,14,0,-1,1,-1
426,417,417,417,17,16,15,16,2,3,2,1,9,0,0,1,1,-1
824,815,810,810,14,14,13,13,1,2,3,1,9,5,0,0,1,0
862,853,853,848,14,17,15,16,3,1,2,1,9,0,5,-3,2,-1
253,243,248,248,14,14,13,13,2,2,2,3,10,-5,0,0,1,0
928,918,928,918,14,14,13,13,1,4,2,2,10,-10,10,0,1,0
618,609,604,614,18,19,18,19,1,2,1,1,9,5,-10,-1,1,-1
445,440,445,436,13,14,12,13,2,2,5,1,5,-5,9,-1,2,-1
679,660,646,646,13,14,12,13,1,2,1,3,19,14,0,-1,2,-1
862,862,857,853,18,19,18,18,2,3,1,2,0,5,4,-1,1,0
1054,1045,1045,1045,13,14,12,13,2,2,1,1,9,0,0,-1,2,-1
946,946,946,946,17,19,18,18,1,1,1,1,0,0,0,-2,1,0
407,398,398,398,13,14,15,13,2,2,1,2,9,0,0,-1,-1,2
436,436,431,431,13,14,12,13,1,3,1,2,0,5,0,-1,2,-1
1040,1031,1031,1031,13,14,12,13,2,2,2,1,9,0,0,-1,2,-1
496,496,496,501,14,14,15,13,1,1,1,1,0,0,-5,0,-1,2
895,895,890,890,21,19,20,21,2,1,1,2,0,5,0,2,-1,-1
248,239,248,239,14,14,15,13,2,2,2,1,9,-9,9,0,-1,2
623,623,623,623,14,14,15,13,2,1,1,2,0,0,0,0,-1,2
586,581,576,571,18,17,18,16,1,3,2,1,5,5,5,1,-1,2
346,342,342,337,13,14,15,13,2,1,4,2,4,0,5,-1,-1,2
403,403,398,393,17,16,15,16,1,1,1,2,0,5,5,1,1,-1
487,468,464,459,14,16,15,16,2,2,2,3,19,4,5,-2,1,-1
960,956,956,956,13,16,15,16,1,1,1,1,4,0,0,-3,1,-1
365,360,360,360,17,16,18,16,1,2,1,1,5,0,0,1,-2,2
229,224,229,224,18,19,18,19,1,2,2,1,5,-5,5,-1,1,-1
262,257,262,262,14,17,15,16,4,3,1,1,5,-5,0,-3,2,-1
750,740,740,736,20,19,20,18,2,2,2,1,10,0,4,1,-1,2
281,271,271,267,14,17,15,16,3,1,2,1,10,0,4,-3,2,-1
660,651,651,651,20,19,20,21,2,1,2,1,9,0,0,1,-1,-1
436,426,431,426,20,19,20,18,1,2,3,1,10,-5,5,1,-1,2
403,398,403,398,17,16,18,18,1,2,2,2,5,-5,5,1,-2,0
656,646,651,656,17,16,15,16,3,2,5,1,10,-5,-5,1,1,-1
726,721,717,717,20,19,18,18,3,2,3,2,5,4,0,1,1,0
286,281,281,281,18,19,18,19,1,1,3,1,5,0,0,-1,1,-1
234,220,220,220,18,17,18,19,3,2,1,2,14,0,0,1,-1,-1
810,806,806,801,14,14,15,13,1,3,2,2,4,0,5,0,-1,2
281,271,271,262,21,19,20,18,1,1,2,2,10,0,9,2,-1,2
942,942,942,942,17,16,15,16,1,3,2,1,0,0,0,1,1,-1
895,890,890,895,21,19,20,21,1,1,1,2,5,0,-5,2,-1,-1
323,328,323,323,18,17,18,19,2,1,2,1,-5,5,0,1,-1,-1
984,974,970,970,13,14,15,16,1,2,1,1,10,4,0,-1,-1,-1
651,642,646,646,20,19,20,21,1,2,1,1,9,-4,0,1,-1,-1
501,501,501,496,14,14,13,13,2,2,2,2,0,0,5,0,1,0
267,262,257,253,18,19,18,18,2,1,1,2,5,5,4,-1,1,0
679,679,674,670,13,16,15,16,1,1,1,2,0,5,4,-3,1,-1
332,323,323,323,13,14,13,13,1,2,1,2,9,0,0,-1,1,0
670,660,660,660,17,16,18,18,3,2,1,1,10,0,0,1,-2,0
342,337,342,342,13,14,12,13,2,2,2,1,5,-5,0,-1,2,-1
234,220,215,215,21,19,20,21,3,1,2,2,14,5,0,2,-1,-1
309,309,309,309,18,17,18,16,2,1,3,1,0,0,0,1,-1,2
1064,1059,229,1059,13,14,15,13,1,2,1,2,5,830,-830,-1,-1,2
1040,1036,1031,1026,13,14,15,13,1,2,1,1,4,5,5,-1,-1,2
665,660,656,660,20,19,20,21,1,1,1,3,5,4,-4,1,-1,-1
843,843,848,839,18,17,18,16,2,1,2,2,0,-5,9,1,-1,2
1050,1050,1045,1040,20,19,20,21,2,1,2,1,0,5,5,1,-1,-1
689,679,684,684,13,14,12,13,1,2,2,2,10,-5,0,-1,2,-1
436,431,440,436,20,19,20,18,2,1,2,2,5,-9,4,1,-1,2
1045,1040,1036,1036,13,14,12,13,2,3,1,3,5,4,0,-1,2,-1
909,881,871,862,14,14,15,13,2,2,1,4,28,10,9,0,-1,2
581,576,571,571,21,19,20,18,1,1,1,1,5,5,0,2,-1,2
262,257,257,257,21,19,20,18,3,1,1,1,5,0,0,2,-1,2
1003,1003,1003,998,13,14,12,13,1,1,1,3,0,0,5,-1,2,-1
309,300,300,295,14,17,15,16,3,1,2,1,9,0,5,-3,2,-1
553,553,548,548,21,19,20,21,2,3,1,2,0,5,0,2,-1,-1
482,482,478,473,14,17,15,16,1,1,2,2,0,4,5,-3,2,-1
346,337,342,342,13,16,15,16,3,2,2,3,9,-5,0,-3,1,-1
698,698,698,698,13,14,15,13,1,3,2,3,0,0,0,-1,-1,2
314,309,304,309,14,14,13,13,2,2,1,1,5,5,-5,0,1,0
820,810,806,801,14,14,13,13,2,4,2,1,10,4,5,0,1,0
271,262,257,257,14,14,15,16,1,2,1,2,9,5,0,0,-1,-1
529,529,534,524,14,14,15,16,1,2,4,2,0,-5,10,0,-1,-1
393,393,407,389,17,16,15,16,1,1,3,1,0,-14,18,1,1,-1
782,782,773,778,14,17,15,16,2,2,1,1,0,9,-5,-3,2,-1
412,403,398,403,20,19,18,18,2,1,1,1,9,5,-5,1,1,0
707,698,703,698,20,19,20,21,2,2,3,2,9,-5,5,1,-1,-1
548,520,520,520,14,17,15,16,1,2,1,1,28,0,0,-3,2,-1
946,942,946,942,17,16,18,18,2,1,1,1,4,-4,4,1,-2,0
257,248,248,243,14,14,13,13,3,1,2,2,9,0,5,0,1,0
431,426,426,421,13,16,15,16,2,2,2,1,5,0,5,-3,1,-1
960,956,960,956,13,14,15,16,3,1,1,1,4,-4,4,-1,-1,-1
787,782,778,778,14,14,13,13,1,1,2,1,5,4,0,0,1,0
1036,1036,1031,1031,17,16,18,16,1,1,1,1,0,5,0,1,-2,2
421,412,412,412,13,14,15,13,2,1,1,2,9,0,0,-1,-1,2
970,974,965,965,17,16,15,16,3,1,1,1,-4,9,0,1,1,-1
876,876,871,876,14,17,15,16,3,1,1,1,0,5,-5,-3,2,-1
787,787,787,787,14,14,15,16,2,1,2,1,0,0,0,0,-1,-1
318,300,295,300,14,14,15,13,1,2,3,3,18,5,-5,0,-1,2
304,304,304,300,14,14,15,13,1,3,2,3,0,0,4,0,-1,2
1050,1054,1050,1054,20,19,20,21,2,1,3,3,-4,4,-4,1,-1,-1
571,567,571,571,21,19,20,21,2,1,1,1,4,-4,0,2,-1,-1
904,904,904,900,21,19,20,21,1,1,1,1,0,0,4,2,-1,-1
300,300,304,300,14,14,13,13,2,3,2,2,0,-4,4,0,1,0
759,764,764,764,13,14,12,13,3,1,1,1,-5,0,0,-1,2,-1
300,295,300,295,14,14,13,13,3,3,2,1,5,-5,5,0,1,0
417,412,407,407,13,14,15,16,2,3,1,2,5,5,0,-1,-1,-1
529,524,529,524,18,19,18,19,4,2,2,3,5,-5,5,-1,1,-1
1040,1040,1040,1040,17,16,15,16,1,3,1,2,0,0,0,1,1,-1
834,829,824,824,14,17,15,16,3,2,2,2,5,5,0,-3,2,-1
848,839,839,848,18,19,18,18,1,2,1,2,9,0,-9,-1,1,0
314,309,304,304,18,17,18,16,1,3,1,1,5,5,0,1,-1,2
815,806,806,801,14,14,15,13,2,5,3,1,9,0,5,0,-1,2
215,215,215,210,21,19,20,21,1,3,2,4,0,0,5,2,-1,-1
586,576,576,581,21,19,20,21,1,2,1,1,10,0,-5,2,-1,-1
965,960,956,951,13,14,12,13,2,3,3,1,5,4,5,-1,2,-1
956,942,942,946,13,14,12,13,2,1,1,1,14,0,-4,-1,2,-1
942,937,932,932,20,19,20,21,4,1,1,1,5,5,0,1,-1,-1
309,300,304,300,18,17,18,19,2,2,2,1,9,-4,4,1,-1,-1
290,281,281,281,21,19,20,21,1,1,2,2,9,0,0,2,-1,-1
843,834,829,829,14,17,15,16,1,1,3,1,9,5,0,-3,2,-1
286,290,286,286,21,19,20,21,2,3,3,1,-4,4,0,2,-1,-1
1064,1059,1059,1054,20,19,20,18,3,1,1,1,5,0,5,1,-1,2
196,1073,1078,1073,14,14,13,13,4,2,2,1,-877,-5,5,0,1,0
1064,1059,1054,1059,13,14,12,13,2,1,1,1,5,5,-5,-1,2,-1
510,506,501,501,14,17,15,16,3,2,2,1,4,5,0,-3,2,-1
201,196,192,196,14,14,15,13,1,1,1,1,5,4,-4,0,-1,2
871,867,867,867,18,19,18,18,1,2,1,2,4,0,0,-1,1,0
923,923,923,937,21,19,21,21,2,2,1,2,0,0,-14,2,-2,0
492,468,478,473,18,19,18,18,1,2,1,2,24,-10,5,-1,1,0
543,534,543,539,21,19,20,18,1,2,2,1,9,-9,4,2,-1,2
900,895,895,895,21,19,20,19,2,2,2,1,5,0,0,2,-1,1
454,492,450,445,17,17,18,18,3,1,1,2,-38,42,5,0,-1,0
459,450,450,454,20,19,20,21,2,3,1,1,9,0,-4,1,-1,-1
871,867,867,862,14,17,15,16,1,3,2,2,4,0,5,-3,2,-1
993,989,989,984,20,19,20,21,2,3,2,3,4,0,5,1,-1,-1
857,853,853,857,14,17,15,16,1,1,1,1,4,0,-4,-3,2,-1
464,459,459,459,20,19,18,18,2,1,2,1,5,0,0,1,1,0
993,984,984,984,13,14,12,13,2,1,4,2,9,0,0,-1,2,-1
286,276,271,271,14,17,15,16,1,3,1,1,10,5,0,-3,2,-1
857,848,848,848,14,14,13,13,1,3,2,3,9,0,0,0,1,0
286,276,276,276,14,14,13,13,3,3,2,3,10,0,0,0,1,0
271,276,276,271,14,14,15,13,4,2,2,2,-5,0,5,0,-1,2
440,440,436,440,13,14,15,13,3,2,1,3,0,4,-4,-1,-1,2
824,820,815,815,14,14,13,13,1,3,1,1,4,5,0,0,1,0
853,843,843,839,14,14,15,13,3,1,1,2,10,0,4,0,-1,2
698,693,689,684,13,14,15,13,1,6,3,1,5,4,5,-1,-1,2
853,853,853,857,18,17,18,18,1,2,1,1,0,0,-4,1,-1,0
951,942,942,942,13,16,15,16,2,2,2,1,9,0,0,-3,1,-1
956,946,946,946,13,16,15,16,1,2,2,2,10,0,0,-3,1,-1
623,618,623,618,18,17,18,19,2,1,2,1,5,-5,5,1,-1,-1
679,679,674,674,13,14,12,13,1,1,1,2,0,5,0,-1,2,-1
529,520,524,520,18,19,18,19,1,2,3,2,9,-4,4,-1,1,-1
454,450,445,445,13,14,15,13,4,3,1,3,4,5,0,-1,-1,2
224,229,229,224,18,17,18,19,1,3,2,2,-5,0,5,1,-1,-1
1045,1031,1021,1021,17,16,15,16,4,2,1,3,14,10,0,1,1,-1
267,257,262,262,18,19,18,18,1,1,2,3,10,-5,0,-1,1,0
346,342,337,337,13,14,15,13,3,3,1,3,4,5,0,-1,-1,2
234,224,210,215,21,19,20,19,2,1,1,1,10,14,-5,2,-1,1
196,187,192,192,18,17,18,19,1,2,2,1,9,-5,0,1,-1,-1
201,192,192,187,21,19,21,19,1,2,1,2,9,0,5,2,-2,2
257,253,257,253,14,14,15,16,2,2,2,2,4,-4,4,0,-1,-1
604,600,600,600,21,19,20,21,1,1,1,2,4,0,0,2,-1,-1
815,815,815,815,14,17,15,16,2,2,1,1,0,0,0,-3,2,-1
210,196,192,187,21,19,21,21,3,3,1,2,14,4,5,2,-2,0
276,267,262,257,14,14,13,13,1,3,2,2,9,5,5,0,1,0
501,496,501,496,18,19,18,19,1,3,2,1,5,-5,5,-1,1,-1
276,267,271,271,18,17,18,18,1,2,1,1,9,-4,0,1,-1,0
1050,1040,1045,1040,20,19,18,18,2,2,1,1,10,-5,5,1,1,0
586,576,571,571,18,17,18,18,3,1,2,5,10,5,0,1,-1,0
810,801,801,796,14,14,15,16,3,2,1,1,9,0,5,0,-1,-1
736,726,721,726,13,14,15,16,3,2,1,1,10,5,-5,-1,-1,-1
834,829,824,824,14,14,15,13,1,2,1,2,5,5,0,0,-1,2
764,764,768,764,20,19,20,21,1,1,2,1,0,-4,4,1,-1,-1
853,853,853,853,21,19,20,21,2,3,1,1,0,0,0,2,-1,-1
304,295,290,286,18,17,18,19,3,1,3,2,9,5,4,1,-1,-1
923,923,928,923,14,17,15,16,1,2,2,2,0,-5,5,-3,2,-1
407,403,398,403,17,16,18,16,3,1,4,1,4,5,-5,1,-2,2
618,604,595,590,18,17,18,16,1,3,1,2,14,9,5,1,-1,2
1017,1003,998,993,17,19,18,18,2,2,2,1,14,5,5,-2,1,0
454,454,454,450,17,19,18,18,1,1,2,1,0,0,4,-2,1,0
276,271,267,267,14,14,15,13,3,3,1,4,5,4,0,0,-1,2
867,853,857,853,18,19,18,18,2,2,2,3,14,-4,4,-1,1,0
965,965,960,956,17,16,15,16,1,3,1,2,0,5,4,1,1,-1
801,796,796,801,21,19,21,19,1,1,2,3,5,0,-5,2,-2,2
623,618,614,614,14,17,15,16,2,2,3,1,5,4,0,-3,2,-1
745,726,717,721,13,14,15,13,2,3,1,3,19,9,-4,-1,-1,2
248,243,243,248,18,17,18,18,3,2,1,1,5,0,-5,1,-1,0
670,665,670,665,13,14,15,16,1,3,2,2,5,-5,5,-1,-1,-1
745,740,745,740,17,16,15,16,1,1,2,2,5,-5,5,1,1,-1
445,445,445,440,17,16,15,16,2,3,2,1,0,0,5,1,1,-1
431,421,426,431,13,14,12,13,1,1,2,3,10,-5,-5,-1,2,-1
914,918,914,914,14,14,13,13,2,1,3,2,-4,4,0,0,1,0
351,342,342,342,20,19,20,18,2,1,3,2,9,0,0,1,-1,2
782,773,773,773,14,14,12,13,1,3,1,2,9,0,0,0,2,-1
201,206,206,206,14,14,13,13,2,1,3,2,-5,0,0,0,1,0
224,220,215,215,18,19,18,19,1,1,2,1,4,5,0,-1,1,-1
243,234,239,239,18,19,18,18,3,2,1,2,9,-5,0,-1,1,0
501,496,501,492,18,17,18,16,2,2,3,2,5,-5,9,1,-1,2
946,942,942,942,17,16,18,18,1,2,1,1,4,0,0,1,-2,0
590,581,581,581,18,19,18,19,1,1,1,1,9,0,0,-1,1,-1
271,267,267,267,14,14,15,13,3,1,2,3,4,0,0,0,-1,2
224,206,201,201,14,14,15,16,3,3,1,3,18,5,0,0,-1,-1
515,515,515,515,14,14,15,13,2,3,1,1,0,0,0,0,-1,2
248,229,224,220,14,14,15,13,1,2,1,1,19,5,4,0,-1,2
224,224,524,215,18,17,15,16,3,1,1,1,0,-300,309,1,2,-1
904,900,895,895,18,19,20,19,2,1,3,3,4,5,0,-1,-1,1
773,768,773,773,17,16,18,18,1,4,1,1,5,-5,0,1,-2,0
914,904,890,886,18,17,18,19,1,3,1,3,10,14,4,1,-1,-1
450,450,450,445,13,14,15,13,2,5,2,2,0,0,5,-1,-1,2
562,557,553,553,21,19,20,21,1,3,1,1,5,4,0,2,-1,-1
609,609,604,604,21,19,20,21,1,1,3,2,0,5,0,2,-1,-1
337,323,328,323,13,14,13,13,3,2,2,2,14,-5,5,-1,1,0
754,764,750,750,13,14,15,13,3,1,3,2,-10,14,0,-1,-1,2
974,965,965,965,17,16,18,16,1,2,1,4,9,0,0,1,-2,2
900,736,895,895,14,14,15,16,2,1,1,4,164,-159,0,0,-1,-1
974,965,965,970,20,19,18,18,1,2,1,3,9,0,-5,1,1,0
398,393,436,389,13,14,15,13,1,3,2,2,5,-43,47,-1,-1,2
679,670,665,665,17,16,15,16,2,1,4,2,9,5,0,1,1,-1
379,374,370,365,20,19,20,21,3,1,1,2,5,4,5,1,-1,-1
862,853,853,848,18,19,18,18,2,2,1,2,9,0,5,-1,1,0
384,379,379,379,13,14,12,13,1,2,2,1,5,0,0,-1,2,-1
412,412,412,412,13,14,15,13,1,4,4,1,0,0,0,-1,-1,2
346,342,342,337,20,19,20,18,2,1,1,3,4,0,5,1,-1,2
989,984,979,979,13,14,15,13,2,3,2,1,5,5,0,-1,-1,2
1021,1021,1021,1017,20,19,20,18,3,1,1,2,0,0,4,1,-1,2
656,656,656,656,20,19,20,18,1,2,1,1,0,0,0,1,-1,2
707,703,707,703,17,16,18,18,2,2,2,1,4,-4,4,1,-2,0
857,853,848,853,18,19,18,18,1,2,1,3,4,5,-5,-1,1,0
510,496,487,487,14,14,13,13,2,1,2,2,14,9,0,0,1,0
904,895,900,895,14,14,13,13,1,2,2,2,9,-5,5,0,1,0
721,717,717,717,17,16,18,16,3,2,1,2,4,0,0,1,-2,2
318,314,314,314,18,17,18,16,3,2,3,3,4,0,0,1,-1,2
993,993,1003,989,13,14,12,13,3,2,2,2,0,-10,14,-1,2,-1
886,876,871,871,14,17,15,16,3,2,1,2,10,5,0,-3,2,-1
192,192,192,182,18,17,18,16,3,3,1,2,0,0,10,1,-1,2
468,459,464,464,17,16,18,18,2,2,1,1,9,-5,0,1,-2,0
918,914,914,914,18,17,18,19,1,2,1,1,4,0,0,1,-1,-1
276,271,267,271,18,19,18,18,3,1,1,1,5,4,-4,-1,1,0
993,989,989,989,17,16,18,18,1,2,2,1,4,0,0,1,-2,0
1036,1036,1026,1031,20,19,20,21,2,1,1,1,0,10,-5,1,-1,-1
623,698,614,614,18,19,18,19,1,1,1,1,-75,84,0,-1,1,-1
370,370,370,370,17,16,15,16,1,1,1,1,0,0,0,1,1,-1
182,1073,1078,1078,18,19,18,18,1,2,1,1,-891,-5,0,-1,1,0
337,332,332,332,20,19,18,18,3,1,1,2,5,0,0,1,1,0
660,656,656,651,13,14,15,16,2,3,1,3,4,0,5,-1,-1,-1
262,257,257,257,18,17,18,16,2,2,1,1,5,0,0,1,-1,2
557,557,562,557,18,17,18,18,2,1,2,2,0,-5,5,1,-1,0
1073,1068,1068,1064,13,14,12,13,2,1,2,2,5,0,4,-1,2,-1
187,187,1078,182,21,19,20,19,1,1,1,2,0,-891,896,2,-1,1
506,496,501,496,21,19,21,21,1,2,1,1,10,-5,5,2,-2,0
754,750,750,754,20,19,20,21,1,2,1,1,4,0,-4,1,-1,-1
487,482,487,487,14,14,15,13,2,2,2,2,5,-5,0,0,-1,2
1068,1059,1059,1054,20,19,20,18,1,1,1,1,9,0,5,1,-1,2
843,843,839,839,18,19,18,18,2,1,1,1,0,4,0,-1,1,0
590,684,684,684,18,16,18,18,1,3,1,1,-94,0,0,2,-2,0
890,881,886,886,21,19,20,21,3,2,1,3,9,-5,0,2,-1,-1
1017,1017,1007,1012,20,19,20,18,1,1,5,1,0,10,-5,1,-1,2
384,374,374,370,13,14,15,13,2,3,1,2,10,0,4,-1,-1,2
1012,1007,1007,1003,20,19,18,18,1,3,2,1,5,0,4,1,1,0
539,524,520,520,14,14,13,13,1,2,1,3,15,4,0,0,1,0
698,693,684,689,20,19,20,18,2,1,5,1,5,9,-5,1,-1,2
979,984,979,974,20,19,18,18,1,1,4,2,-5,5,5,1,1,0
923,918,909,914,18,19,18,19,1,3,1,1,5,9,-5,-1,1,-1
192,187,1078,1073,21,19,20,21,1,1,1,2,5,-891,5,2,-1,-1
543,543,539,534,21,19,20,18,2,3,1,2,0,4,5,2,-1,2
839,834,834,829,14,14,15,13,2,3,2,1,5,0,5,0,-1,2
356,356,356,356,13,14,12,13,1,3,1,2,0,0,0,-1,2,-1
1026,1031,1021,1026,17,16,18,16,1,1,1,1,-5,10,-5,1,-2,2
482,473,478,482,14,14,13,13,1,2,2,1,9,-5,-4,0,1,0
614,609,604,609,14,17,15,16,1,1,1,3,5,5,-5,-3,2,-1
459,454,454,450,13,14,15,16,1,3,2,1,5,0,4,-1,-1,-1
239,234,239,239,14,14,15,13,3,1,1,2,5,-5,0,0,-1,2
412,403,393,393,13,14,15,16,1,1,1,1,9,10,0,-1,-1,-1
1064,1059,1054,1054,17,16,18,16,1,1,1,2,5,5,0,1,-2,2
824,820,820,820,14,14,15,13,1,2,1,2,4,0,0,0,-1,2
206,201,206,206,14,17,15,16,1,3,2,1,5,-5,0,-3,2,-1
290,290,290,290,21,19,20,19,3,1,2,3,0,0,0,2,-1,1
736,736,731,731,13,16,15,16,3,3,1,2,0,5,0,-3,1,-1
637,632,637,637,20,19,18,18,2,1,3,1,5,-5,0,1,1,0
586,576,571,562,14,14,13,13,1,1,1,2,10,5,9,0,1,0
867,857,862,857,14,14,13,13,3,1,2,2,10,-5,5,0,1,0
843,843,843,843,21,19,20,21,3,1,1,1,0,0,0,2,-1,-1
759,754,759,754,17,16,18,16,1,2,2,3,5,-5,5,1,-2,2
717,707,703,703,13,14,15,13,1,4,1,3,10,4,0,-1,-1,2
1045,1045,1040,1040,17,16,15,16,4,1,1,1,0,5,0,1,1,-1
843,839,839,839,14,17,15,16,2,1,2,1,4,0,0,-3,2,-1
524,520,515,515,18,17,18,19,3,1,1,1,4,5,0,1,-1,-1
839,834,829,820,14,14,15,13,2,1,2,2,5,5,9,0,-1,2
979,974,974,970,17,16,18,18,1,1,3,1,5,0,4,1,-2,0
318,309,314,314,14,17,15,16,2,2,2,1,9,-5,0,-3,2,-1
839,834,839,839,21,19,20,18,2,2,1,1,5,-5,0,2,-1,2
660,656,656,651,20,19,20,21,1,1,2,1,4,0,5,1,-1,-1
1026,1017,1017,1007,17,16,18,16,2,2,2,2,9,0,10,1,-2,2
665,656,656,656,13,16,15,16,2,2,1,1,9,0,0,-3,1,-1
557,557,557,553,21,19,20,18,4,2,1,2,0,0,4,2,-1,2
937,932,928,923,13,14,15,13,2,2,1,2,5,4,5,-1,-1,2
224,210,210,215,18,19,18,19,1,1,1,1,14,0,-5,-1,1,-1
1026,1021,1026,1021,13,14,15,13,1,2,2,1,5,-5,5,-1,-1,2
571,567,567,567,18,17,18,16,3,2,3,2,4,0,0,1,-1,2
215,201,192,196,21,19,21,21,3,2,3,2,14,9,-4,2,-2,0
501,496,496,496,18,17,18,19,3,2,3,1,5,0,0,1,-1,-1
726,726,736,731,13,16,15,16,1,1,2,1,0,-10,5,-3,1,-1
646,646,642,642,13,14,12,13,1,1,2,2,0,4,0,-1,2,-1
642,637,642,632,13,14,15,13,2,2,2,1,5,-5,10,-1,-1,2
618,618,614,614,14,14,15,13,2,3,1,3,0,4,0,0,-1,2
1050,1040,1050,1050,17,16,15,16,1,1,2,3,10,-10,0,1,1,-1
895,890,895,890,18,19,18,19,2,1,1,2,5,-5,5,-1,1,-1
768,768,759,764,13,14,12,13,2,1,1,1,0,9,-5,-1,2,-1
553,548,539,539,14,17,15,16,3,3,2,2,5,9,0,-3,2,-1
412,412,412,407,17,19,18,18,1,2,3,2,0,0,5,-2,1,0
693,984,689,679,17,16,18,18,2,1,2,2,-291,295,10,1,-2,0
581,571,576,571,21,19,20,21,1,2,2,1,10,-5,5,2,-1,-1
932,928,928,923,20,19,21,19,1,1,1,1,4,0,5,1,-2,2
210,206,206,201,21,19,20,19,2,2,1,2,4,0,5,2,-1,1
674,670,670,665,17,16,18,16,3,2,2,1,4,0,5,1,-2,2
1017,1017,1012,1012,20,19,20,21,3,1,1,3,0,5,0,1,-1,-1
182,1073,1078,1073,14,14,15,13,1,2,2,1,-891,-5,5,0,-1,2
1017,1007,1007,1007,17,19,18,18,2,2,1,1,10,0,0,-2,1,0
810,792,773,773,14,14,12,13,2,4,1,2,18,19,0,0,2,-1
660,660,660,656,20,19,20,21,1,1,1,2,0,0,4,1,-1,-1
1059,1059,1059,1054,13,14,12,13,2,1,2,2,0,0,5,-1,2,-1
806,806,806,801,21,19,20,21,1,1,1,1,0,0,5,2,-1,-1
239,215,215,210,14,17,15,16,2,1,2,1,24,0,5,-3,2,-1
651,642,646,637,13,14,12,13,2,2,3,2,9,-4,9,-1,2,-1
909,909,904,904,18,19,18,19,2,1,1,1,0,5,0,-1,1,-1
370,360,365,365,20,19,20,18,1,2,1,1,10,-5,0,1,-1,2
492,492,492,492,18,19,18,19,2,1,1,1,0,0,0,-1,1,-1
642,637,632,637,20,19,20,18,1,3,1,1,5,5,-5,1,-1,2
496,496,773,496,18,17,18,16,2,2,1,1,0,-277,277,1,-1,2
946,942,937,932,13,14,12,13,2,3,3,2,4,5,5,-1,2,-1
942,937,923,923,13,14,13,13,4,1,2,3,5,14,0,-1,1,0
440,323,323,323,13,19,21,21,1,1,1,1,117,0,0,-6,-2,0
534,534,534,529,14,17,15,16,2,3,1,1,0,0,5,-3,2,-1
543,539,539,539,21,19,20,21,3,1,1,1,4,0,0,2,-1,-1
900,904,900,900,18,19,18,19,2,1,1,1,-4,4,0,-1,1,-1
524,529,529,524,14,14,13,13,2,3,2,4,-5,0,5,0,1,0
412,403,407,407,17,16,15,16,3,2,1,4,9,-4,0,1,1,-1
581,576,576,576,21,19,20,21,1,2,1,2,5,0,0,2,-1,-1
220,220,220,215,21,19,20,21,3,1,2,4,0,0,5,2,-1,-1
379,379,374,374,13,14,15,13,2,3,1,1,0,5,0,-1,-1,2
1021,1017,1017,1012,13,16,15,16,2,1,2,3,4,0,5,-3,1,-1
1073,1068,1068,1073,17,16,18,16,3,2,3,1,5,0,-5,1,-2,2
318,314,314,314,18,17,18,19,3,2,2,1,4,0,0,1,-1,-1
529,529,529,524,14,14,15,13,1,3,2,1,0,0,5,0,-1,2
454,459,454,450,13,16,15,16,1,3,1,1,-5,5,4,-3,1,-1
956,946,946,946,17,16,15,16,3,2,1,1,10,0,0,1,1,-1
609,604,604,604,14,14,13,13,4,2,3,1,5,0,0,0,1,0
520,515,520,515,18,17,18,19,1,1,2,1,5,-5,5,1,-1,-1
346,337,323,318,20,19,18,19,2,1,1,2,9,14,5,1,1,-1
337,586,328,328,20,19,21,21,2,1,1,1,-249,258,0,1,-2,0
192,182,1078,1078,14,14,15,16,1,1,2,1,10,-896,0,0,-1,-1
450,450,450,450,20,19,18,18,1,3,2,1,0,0,0,1,1,0
656,651,651,651,13,14,15,13,1,4,2,1,5,0,0,-1,-1,2
862,862,862,857,18,17,18,18,1,3,2,1,0,0,5,1,-1,0
571,562,557,557,14,17,15,16,2,1,2,2,9,5,0,-3,2,-1
750,740,740,740,20,19,20,18,3,2,1,1,10,0,0,1,-1,2
520,510,510,510,18,17,18,19,3,1,1,2,10,0,0,1,-1,-1
839,834,834,834,14,14,15,13,2,3,2,2,5,0,0,0,-1,2
942,937,937,937,20,19,18,18,2,2,1,1,5,0,0,1,1,0
979,979,979,979,20,19,20,18,1,2,1,1,0,0,0,1,-1,2
257,253,253,248,18,17,18,18,1,2,1,1,4,0,5,1,-1,0
824,820,820,815,21,19,20,19,1,4,2,1,4,0,5,2,-1,1
853,848,843,843,21,19,20,18,1,1,3,1,5,5,0,2,-1,2
674,674,670,674,17,16,15,16,1,2,3,2,0,4,-4,1,1,-1
374,365,360,356,17,19,18,18,4,1,2,1,9,5,4,-2,1,0
262,253,253,257,14,14,15,13,2,2,3,1,9,0,-4,0,-1,2
243,229,224,229,14,17,15,16,1,2,1,1,14,5,-5,-3,2,-1
867,862,867,857,14,14,15,13,2,1,3,3,5,-5,10,0,-1,2
750,750,750,754,20,19,18,18,3,3,3,1,0,0,-4,1,1,0
909,900,900,895,18,17,18,19,1,1,2,1,9,0,5,1,-1,-1
665,656,651,646,13,14,15,13,1,3,2,1,9,5,5,-1,-1,2
365,365,365,360,13,14,15,13,2,2,2,2,0,0,5,-1,-1,2
970,965,960,960,13,14,15,13,3,1,1,3,5,5,0,-1,-1,2
937,923,923,923,13,14,15,16,2,2,1,2,14,0,0,-1,-1,-1
824,820,820,815,21,19,20,19,1,1,2,1,4,0,5,2,-1,1
201,196,192,192,14,14,13,13,1,3,1,1,5,4,0,0,1,0
951,942,928,951,20,19,18,18,2,2,2,3,9,14,-23,1,1,0
984,974,979,979,13,14,12,13,2,1,3,3,10,-5,0,-1,2,-1
960,951,956,951,20,19,20,21,1,2,2,1,9,-5,5,1,-1,-1
295,290,290,290,14,14,15,16,3,1,1,1,5,0,0,0,-1,-1
895,886,890,886,18,19,18,19,1,2,1,2,9,-4,4,-1,1,-1
510,506,506,501,18,19,18,19,1,1,2,2,4,0,5,-1,1,-1
257,257,262,281,14,14,15,16,2,2,1,2,0,-5,-19,0,-1,-1
1017,1012,1007,1003,20,19,20,21,2,1,1,5,5,5,4,1,-1,-1
782,773,773,778,21,19,20,21,2,2,1,1,9,0,-5,2,-1,-1
946,942,942,937,20,19,18,18,1,3,2,1,4,0,5,1,1,0
379,379,374,374,13,16,15,16,3,1,2,4,0,5,0,-3,1,-1
286,276,276,276,18,17,18,18,3,1,1,1,10,0,0,1,-1,0
1059,1064,1068,1064,20,19,20,18,4,1,2,1,-5,-4,4,1,-1,2
445,440,440,440,17,16,18,18,3,2,2,1,5,0,0,1,-2,0
796,796,773,773,14,17,15,16,1,3,1,2,0,23,0,-3,2,-1
824,820,820,820,18,17,18,16,1,1,1,1,4,0,0,1,-1,2
731,726,726,726,17,16,18,16,2,4,2,1,5,0,0,1,-2,2
689,689,689,684,13,14,15,13,3,3,1,3,0,0,5,-1,-1,2
459,450,450,450,17,16,18,16,1,2,1,1,9,0,0,1,-2,2
257,253,248,253,14,14,13,13,1,1,1,1,4,5,-5,0,1,0
614,609,609,604,14,14,15,13,1,2,2,2,5,0,5,0,-1,2
834,824,824,824,14,17,15,16,1,2,1,1,10,0,0,-3,2,-1
421,412,412,412,20,19,18,18,2,2,2,1,9,0,0,1,1,0
318,318,318,323,21,19,21,21,2,1,1,1,0,0,-5,2,-2,0
553,553,548,548,14,14,13,13,1,1,3,3,0,5,0,0,1,0
487,478,468,464,14,14,12,13,3,1,2,1,9,10,4,0,2,-1
557,553,553,557,14,14,15,13,3,4,1,1,4,0,-4,0,-1,2
693,689,693,689,13,14,15,13,3,2,1,2,4,-4,4,-1,-1,2
576,576,567,567,21,19,20,18,1,1,1,1,0,9,0,2,-1,2
562,557,557,553,18,17,18,18,3,3,2,2,5,0,4,1,-1,0
1012,1012,1012,1007,20,19,20,18,2,1,3,2,0,0,5,1,-1,2
300,290,286,286,14,14,13,13,2,2,5,1,10,4,0,0,1,0
928,914,914,909,21,19,21,21,1,2,1,1,14,0,5,2,-2,0
970,965,965,960,20,19,20,21,3,2,2,2,5,0,5,1,-1,-1
234,224,224,224,14,17,15,16,2,3,1,1,10,0,0,-3,2,-1
1073,1064,1059,1059,13,14,15,13,2,3,1,3,9,5,0,-1,-1,2
632,623,628,623,13,14,15,13,1,2,1,2,9,-5,5,-1,-1,2
871,871,871,871,21,19,20,21,1,3,1,1,0,0,0,2,-1,-1
234,224,229,224,14,14,13,13,2,4,2,1,10,-5,5,0,1,0
1007,993,989,989,13,14,12,13,3,2,3,1,14,4,0,-1,2,-1
300,300,295,295,18,17,18,16,2,3,1,4,0,5,0,1,-1,2
1068,1064,1064,1064,13,14,15,13,1,1,1,1,4,0,0,-1,-1,2
1036,759,745,745,13,14,15,16,1,3,1,1,277,14,0,-1,-1,-1
206,192,196,192,18,19,21,19,2,2,2,1,14,-4,4,-1,-2,2
220,215,210,210,14,14,15,13,2,3,2,2,5,5,0,0,-1,2
1054,1050,1050,1045,17,16,15,16,3,3,1,1,4,0,5,1,1,-1
857,848,848,843,14,17,15,16,1,4,2,1,9,0,5,-3,2,-1
1026,1021,1021,1021,17,19,18,18,2,2,1,1,5,0,0,-2,1,0
853,848,839,834,18,19,18,18,3,1,3,2,5,9,5,-1,1,0
417,407,403,403,20,19,18,18,2,1,1,2,10,4,0,1,1,0
974,965,970,965,17,16,18,18,3,2,1,2,9,-5,5,1,-2,0
703,703,703,698,17,16,15,16,1,3,1,2,0,0,5,1,1,-1
782,768,759,759,18,16,18,18,1,3,2,1,14,9,0,2,-2,0
871,867,871,867,14,14,15,13,2,4,1,1,4,-4,4,0,-1,2
309,295,300,295,14,17,15,16,4,2,2,2,14,-5,5,-3,2,-1
262,262,262,262,18,19,18,18,2,1,1,1,0,0,0,-1,1,0
876,876,876,876,18,19,18,18,2,1,2,1,0,0,0,-1,1,0
539,529,524,750,14,17,15,21,2,1,2,1,10,5,-226,-3,2,-6
262,262,257,253,14,17,15,16,3,3,2,1,0,5,4,-3,2,-1
398,393,389,393,20,19,20,21,2,1,1,2,5,4,-4,1,-1,-1
637,632,628,623,13,14,13,13,2,2,1,2,5,4,5,-1,1,0
689,684,684,684,20,19,20,18,2,3,1,1,5,0,0,1,-1,2
1068,1068,1068,1064,17,16,18,16,1,1,2,2,0,0,4,1,-2,2
862,857,862,853,14,14,13,13,2,2,3,1,5,-5,9,0,1,0
1021,1017,1017,1007,13,16,15,16,3,1,2,2,4,0,10,-3,1,-1
642,632,637,637,13,14,15,13,2,2,2,1,10,-5,0,-1,-1,2
731,721,731,736,13,14,15,13,1,2,1,3,10,-10,-5,-1,-1,2
871,871,867,867,18,17,18,16,2,2,1,1,0,4,0,1,-1,2
342,342,346,346,13,14,15,13,1,2,2,1,0,-4,0,-1,-1,2
618,614,614,609,18,17,18,16,2,1,3,2,4,0,5,1,-1,2
257,248,253,253,18,17,18,18,2,2,2,1,9,-5,0,1,-1,0
431,426,426,426,20,19,18,18,1,3,1,2,5,0,0,1,1,0
346,342,337,337,13,14,12,13,4,2,1,1,4,5,0,-1,2,-1
262,257,262,262,14,17,15,16,1,2,2,1,5,-5,0,-3,2,-1
412,407,412,407,20,19,20,18,1,1,1,1,5,-5,5,1,-1,2
642,642,637,637,13,16,15,16,3,2,1,2,0,5,0,-3,1,-1
487,482,482,482,14,17,15,16,3,2,1,1,5,0,0,-3,2,-1
600,586,590,595,18,17,18,19,1,2,2,1,14,-4,-5,1,-1,-1
736,731,721,721,17,16,18,16,3,3,1,2,5,10,0,1,-2,2
215,210,210,206,14,17,15,16,2,2,3,2,5,0,4,-3,2,-1
646,637,637,637,13,14,15,13,2,1,2,1,9,0,0,-1,-1,2
510,496,492,496,18,17,15,16,1,2,1,1,14,4,-4,1,2,-1
787,773,778,778,14,14,13,13,1,2,1,1,14,-5,0,0,1,0
651,646,646,646,20,19,20,18,1,2,1,1,5,0,0,1,-1,2
581,576,571,581,18,17,18,19,2,2,3,1,5,5,-10,1,-1,-1
243,224,224,234,18,19,18,18,3,4,1,1,19,0,-10,-1,1,0
192,1073,1073,182,14,16,15,16,2,2,1,1,-881,0,891,-2,1,-1
1021,1017,1017,1017,17,19,18,18,1,1,2,1,4,0,0,-2,1,0
909,914,904,909,18,19,18,19,2,1,1,3,-5,10,-5,-1,1,-1
660,656,656,651,17,16,15,16,1,1,1,2,4,0,5,1,1,-1
862,853,848,843,18,17,18,18,1,1,2,1,9,5,5,1,-1,0
417,412,412,407,20,19,20,18,2,1,1,1,5,0,5,1,-1,2
562,557,562,562,18,19,18,18,2,1,1,2,5,-5,0,-1,1,0
829,824,824,820,14,17,15,16,1,1,2,1,5,0,4,-3,2,-1
323,323,323,323,14,14,13,13,2,3,2,2,0,0,0,0,1,0
768,764,768,764,20,19,18,18,1,2,2,2,4,-4,4,1,1,0
862,853,857,848,21,19,20,18,2,4,1,2,9,-4,9,2,-1,2
417,412,407,403,17,16,15,16,3,1,3,2,5,5,4,1,1,-1
698,693,689,689,20,19,18,18,2,2,1,1,5,4,0,1,1,0
1059,1059,1054,1054,20,19,18,18,1,1,1,1,0,5,0,1,1,0
665,665,660,656,17,16,15,16,3,1,1,1,0,5,4,1,1,-1
839,839,839,834,18,17,18,16,2,2,2,2,0,0,5,1,-1,2
257,253,253,253,18,19,18,18,2,2,3,2,4,0,0,-1,1,0
918,918,914,914,14,14,15,16,1,1,3,3,0,4,0,0,-1,-1
529,520,520,515,14,14,15,13,2,4,1,2,9,0,5,0,-1,2
595,534,529,534,14,17,15,16,1,1,3,1,61,5,-5,-3,2,-1
520,520,515,515,18,19,18,19,2,1,3,1,0,5,0,-1,1,-1
609,604,609,609,18,17,18,16,1,2,3,1,5,-5,0,1,-1,2
253,243,248,248,18,19,18,18,3,1,2,1,10,-5,0,-1,1,0
965,956,960,956,20,19,20,18,4,2,1,2,9,-4,4,1,-1,2
773,764,759,764,13,14,15,13,2,3,1,1,9,5,-5,-1,-1,2
1050,1031,1040,1040,17,16,15,16,2,2,2,3,19,-9,0,1,1,-1
220,215,215,215,14,17,15,16,2,2,1,1,5,0,0,-3,2,-1
778,773,778,778,13,14,13,13,1,2,1,1,5,-5,0,-1,1,0
721,721,712,712,13,14,15,16,4,1,1,1,0,9,0,-1,-1,-1
782,792,778,773,14,14,15,16,2,1,1,2,-10,14,5,0,-1,-1
946,942,946,937,17,16,15,16,1,1,2,2,4,-4,9,1,1,-1
618,609,604,604,14,14,13,13,3,3,1,1,9,5,0,0,1,0
374,365,365,365,17,16,15,16,2,4,1,2,9,0,0,1,1,-1
557,553,553,548,18,19,18,18,1,1,2,2,4,0,5,-1,1,0
1059,1050,1045,1045,13,16,15,16,2,2,1,1,9,5,0,-3,1,-1
754,750,750,750,17,16,18,18,3,1,2,1,4,0,0,1,-2,0
736,726,726,721,13,14,15,13,2,4,1,3,10,0,5,-1,-1,2
586,586,586,586,14,17,15,16,3,2,1,1,0,0,0,-3,2,-1
234,224,224,224,21,19,20,19,2,3,1,1,10,0,0,2,-1,1
731,726,726,726,17,19,18,18,3,2,3,1,5,0,0,-2,1,0
764,764,759,759,20,19,20,21,1,3,2,2,0,5,0,1,-1,-1
295,290,281,286,14,17,15,16,1,3,1,2,5,9,-5,-3,2,-1
904,904,900,904,18,19,18,19,1,1,2,1,0,4,-4,-1,1,-1
496,487,473,468,18,17,18,18,1,1,1,1,9,14,5,1,-1,0
684,684,689,679,13,14,12,13,1,1,1,2,0,-5,10,-1,2,-1
379,374,370,370,20,19,20,18,1,2,1,3,5,4,0,1,-1,2
201,192,196,192,18,17,18,19,1,2,2,1,9,-4,4,1,-1,-1
524,520,520,520,14,14,13,13,1,1,3,1,4,0,0,0,1,0
229,220,220,220,21,19,20,21,2,2,3,2,9,0,0,2,-1,-1
206,192,187,182,18,19,18,19,1,3,2,1,14,5,5,-1,1,-1
923,914,918,918,14,14,13,13,2,4,3,3,9,-4,0,0,1,0
1012,1012,1007,1007,13,14,12,13,1,3,2,1,0,5,0,-1,2,-1
407,403,398,764,13,14,15,16,1,3,3,1,4,5,-366,-1,-1,-1
482,473,468,468,18,16,18,16,2,2,2,2,9,5,0,2,-2,2
520,510,515,515,18,19,18,19,1,2,2,1,10,-5,0,-1,1,-1
590,581,576,576,14,17,15,16,2,2,2,1,9,5,0,-3,2,-1
717,712,712,712,13,14,12,13,3,1,1,1,5,0,0,-1,2,-1
862,862,862,862,21,19,20,21,1,2,1,3,0,0,0,2,-1,-1
360,356,351,356,17,19,18,18,1,3,1,1,4,5,-5,-2,1,0
909,839,998,253,14,14,15,16,6,1,1,1,70,-159,745,0,-1,-1
974,974,974,970,13,14,15,13,1,1,1,3,0,0,4,-1,-1,2
1031,1021,1021,1021,13,14,12,13,3,2,1,2,10,0,0,-1,2,-1
1045,1045,1040,1040,20,19,20,18,2,2,2,2,0,5,0,1,-1,2
684,670,674,674,17,16,18,18,2,2,1,3,14,-4,0,1,-2,0
248,248,239,239,18,19,18,18,1,1,3,2,0,9,0,-1,1,0
253,243,239,234,14,14,13,13,2,2,2,2,10,4,5,0,1,0
1036,1036,1031,1031,13,14,12,13,1,1,1,1,0,5,0,-1,2,-1
993,989,984,984,20,19,18,18,1,3,1,1,4,5,0,1,1,0
379,384,384,379,13,14,15,13,3,3,2,2,-5,0,5,-1,-1,2
206,206,196,201,14,14,13,13,3,1,1,1,0,10,-5,0,1,0
468,459,459,464,17,16,15,16,2,2,2,1,9,0,-5,1,1,-1
998,989,984,989,13,14,12,13,1,3,3,1,9,5,-5,-1,2,-1
820,815,815,810,14,14,15,13,2,3,2,3,5,0,5,0,-1,2
965,965,970,965,13,14,12,13,3,1,2,2,0,-5,5,-1,2,-1
215,210,210,206,14,14,13,13,3,1,3,2,5,0,4,0,1,0
520,520,520,520,18,17,18,16,2,2,1,2,0,0,0,1,-1,2
543,539,543,543,14,14,15,13,1,2,1,3,4,-4,0,0,-1,2
886,881,876,871,14,17,15,16,1,1,2,2,5,5,5,-3,2,-1
1064,1054,1045,1036,13,14,12,13,2,3,2,2,10,9,9,-1,2,-1
670,670,670,665,17,16,18,16,2,3,6,1,0,0,5,1,-2,2
304,295,300,300,18,17,18,19,1,1,1,1,9,-5,0,1,-1,-1
196,187,182,182,14,17,15,16,1,3,1,1,9,5,0,-3,2,-1
300,300,300,300,18,19,18,19,2,2,1,1,0,0,0,-1,1,-1
998,993,984,979,13,14,12,13,1,2,3,2,5,9,5,-1,2,-1
623,614,614,614,14,14,13,13,2,5,3,2,9,0,0,0,1,0
900,886,886,890,18,19,18,19,3,2,1,1,14,0,-4,-1,1,-1
492,487,487,496,14,17,15,16,4,1,1,1,5,0,-9,-3,2,-1
524,510,510,506,14,17,15,16,2,2,2,1,14,0,4,-3,2,-1
820,810,815,820,14,17,15,16,2,2,1,2,10,-5,-5,-3,2,-1
1003,1003,998,1003,20,19,20,21,1,1,1,1,0,5,-5,1,-1,-1
318,318,318,314,14,14,15,13,3,3,2,3,0,0,4,0,-1,2
974,970,965,965,20,19,18,18,2,1,1,1,4,5,0,1,1,0
346,337,337,337,13,14,12,13,1,2,1,1,9,0,0,-1,2,-1
571,562,557,562,14,14,15,13,5,1,1,1,9,5,-5,0,-1,2
286,257,234,229,14,14,15,13,4,3,1,2,29,23,5,0,-1,2
684,679,684,674,13,14,12,13,1,2,5,1,5,-5,10,-1,2,-1
1059,1054,1054,1050,20,19,20,21,1,1,1,1,5,0,4,1,-1,-1
318,314,318,318,18,19,18,19,2,2,3,1,4,-4,0,-1,1,-1
928,923,923,923,14,14,15,13,1,3,1,1,5,0,0,0,-1,2
904,909,909,904,14,14,15,13,2,3,2,2,-5,0,5,0,-1,2
492,487,487,482,14,14,13,13,4,2,2,2,5,0,5,0,1,0
224,215,215,215,14,14,13,13,2,2,2,2,9,0,0,0,1,0
895,886,890,881,14,17,15,16,3,3,3,2,9,-4,9,-3,2,-1
417,417,417,412,13,14,15,13,1,3,1,1,0,0,5,-1,-1,2
623,618,614,614,18,17,18,19,3,2,1,1,5,4,0,1,-1,-1
900,895,895,895,14,14,15,13,1,2,1,2,5,0,0,0,-1,2
820,820,820,815,14,14,15,13,2,1,1,1,0,0,5,0,-1,2
1017,989,989,989,17,19,18,18,1,3,1,1,28,0,0,-2,1,0
1036,1031,1026,1026,20,19,18,18,3,1,1,1,5,5,0,1,1,0
323,309,318,318,21,19,21,21,3,2,2,1,14,-9,0,2,-2,0
295,290,290,290,18,17,18,19,3,2,1,1,5,0,0,1,-1,-1
318,314,314,309,14,14,15,13,2,3,2,1,4,0,5,0,-1,2
286,276,281,276,18,19,18,18,2,2,2,1,10,-5,5,-1,1,0
792,773,773,773,14,14,12,13,2,2,2,2,19,0,0,0,2,-1
309,304,304,300,14,17,15,16,3,1,2,1,5,0,4,-3,2,-1
998,998,989,993,20,19,18,18,1,3,1,1,0,9,-4,1,1,0
192,1073,1073,1073,21,19,20,21,1,2,1,2,-881,0,0,2,-1,-1
937,918,914,909,13,14,15,13,1,1,3,1,19,4,5,-1,-1,2
928,918,914,918,21,19,21,19,1,2,1,1,10,4,-4,2,-2,2
1007,998,993,993,13,16,15,16,2,1,2,1,9,5,0,-3,1,-1
379,379,379,384,20,19,18,18,1,2,3,1,0,0,-5,1,1,0
328,323,323,318,21,19,21,21,1,2,1,1,5,0,5,2,-2,0
539,524,520,515,14,14,15,16,2,2,3,1,15,4,5,0,-1,-1
796,792,787,787,21,19,21,19,2,1,1,1,4,5,0,2,-2,2
590,581,586,586,18,17,18,16,2,2,2,1,9,-5,0,1,-1,2
482,464,459,459,14,14,12,13,2,4,1,3,18,5,0,0,2,-1
665,651,651,651,13,14,15,13,3,4,2,1,14,0,0,-1,-1,2
993,989,984,984,20,19,20,18,2,1,1,1,4,5,0,1,-1,2
267,262,267,267,18,17,18,16,1,2,2,1,5,-5,0,1,-1,2
1007,1007,1007,1003,17,16,18,16,1,1,2,1,0,0,4,1,-2,2
276,276,271,271,14,17,15,16,1,3,1,1,0,5,0,-3,2,-1
665,651,642,642,13,14,15,13,1,3,3,2,14,9,0,-1,-1,2
210,201,201,201,21,19,21,21,2,1,2,2,9,0,0,2,-2,0
1031,1021,1021,1021,17,19,18,18,4,1,1,3,10,0,0,-2,1,0
393,379,403,417,13,14,12,13,2,2,1,2,14,-24,-14,-1,2,-1
510,496,496,496,14,14,15,13,1,2,1,1,14,0,0,0,-1,2
839,839,839,834,14,14,13,13,1,3,4,1,0,0,5,0,1,0
515,515,510,501,21,19,20,19,2,1,1,4,0,5,9,2,-1,1
365,346,356,360,13,14,12,13,3,1,1,1,19,-10,-4,-1,2,-1
796,792,792,787,14,17,15,16,3,2,2,3,4,0,5,-3,2,-1
445,450,445,445,17,16,18,16,3,2,1,2,-5,5,0,1,-2,2
801,792,787,787,21,19,21,21,3,3,1,2,9,5,0,2,-2,0
764,764,759,764,20,19,20,21,2,6,1,1,0,5,-5,1,-1,-1
904,900,895,904,14,14,15,13,2,3,1,3,4,5,-9,0,-1,2
220,215,210,210,14,17,15,16,1,1,2,1,5,5,0,-3,2,-1
436,426,431,421,13,14,12,13,1,6,2,2,10,-5,10,-1,2,-1
300,300,295,295,14,14,13,13,2,3,1,4,0,5,0,0,1,0
473,468,464,464,17,16,15,16,1,1,1,2,5,4,0,1,1,-1
271,262,257,257,18,17,18,16,1,2,1,1,9,5,0,1,-1,2
454,445,440,440,17,16,15,16,2,6,1,1,9,5,0,1,1,-1
740,736,736,731,20,19,18,18,1,1,2,3,4,0,5,1,1,0
412,403,398,403,13,14,12,13,2,3,1,1,9,5,-5,-1,2,-1
323,323,323,318,18,19,18,19,2,3,2,2,0,0,5,-1,1,-1
473,464,468,464,17,16,18,18,2,2,1,2,9,-4,4,1,-2,0
496,398,398,398,14,14,15,13,3,1,1,3,98,0,0,0,-1,2
923,918,923,918,18,17,18,19,1,1,2,1,5,-5,5,1,-1,-1
951,942,946,946,13,14,12,13,2,3,3,3,9,-4,0,-1,2,-1
370,365,360,360,20,19,18,18,1,1,3,1,5,5,0,1,1,0
979,970,970,974,17,16,18,18,2,1,1,1,9,0,-4,1,-2,0
389,384,379,384,20,19,18,18,1,1,1,1,5,5,-5,1,1,0
623,623,623,623,18,17,18,19,2,2,2,1,0,0,0,1,-1,-1
731,726,726,726,20,19,20,21,2,1,4,1,5,0,0,1,-1,-1
548,548,543,543,14,14,15,13,3,3,1,1,0,5,0,0,-1,2
529,515,515,520,14,14,15,16,1,4,3,1,14,0,-5,0,-1,-1
1078,1073,1073,1068,13,14,12,13,1,2,2,3,5,0,5,-1,2,-1
431,421,417,412,17,16,15,16,2,2,3,2,10,4,5,1,1,-1
1045,1045,1050,1050,20,19,20,21,3,1,2,1,0,-5,0,1,-1,-1
857,848,857,853,14,14,13,13,1,2,2,2,9,-9,4,0,1,0
374,370,365,365,13,14,12,13,2,2,1,2,4,5,0,-1,2,-1
553,553,543,543,14,17,15,16,2,1,1,1,0,10,0,-3,2,-1
637,637,628,628,13,14,13,13,3,1,1,1,0,9,0,-1,1,0
810,806,801,801,18,17,18,16,1,3,1,1,4,5,0,1,-1,2
665,656,656,646,20,19,20,21,2,2,1,2,9,0,10,1,-1,-1
267,262,257,257,14,14,15,16,2,2,1,3,5,5,0,0,-1,-1
965,960,960,951,13,14,15,13,3,1,2,2,5,0,9,-1,-1,2
623,618,614,614,14,17,15,16,2,1,1,4,5,4,0,-3,2,-1
801,796,796,792,18,17,18,16,1,2,2,2,5,0,4,1,-1,2
281,281,276,271,18,17,18,18,3,3,1,1,0,5,5,1,-1,0
201,192,192,192,18,19,18,19,1,2,1,2,9,0,0,-1,1,-1
473,468,468,464,17,16,15,16,3,1,2,1,5,0,4,1,1,-1
229,224,224,224,14,17,15,16,1,2,2,1,5,0,0,-3,2,-1
506,501,506,501,14,14,15,16,1,2,2,1,5,-5,5,0,-1,-1
815,815,806,806,18,17,18,16,2,1,1,2,0,9,0,1,-1,2
600,600,595,595,18,19,18,19,2,1,1,2,0,5,0,-1,1,-1
346,342,318,318,13,14,13,13,2,1,1,2,4,24,0,-1,1,0
276,271,271,267,21,19,20,21,1,1,1,1,5,0,4,2,-1,-1
328,323,323,323,21,19,21,21,1,1,1,1,5,0,0,2,-2,0
895,886,886,881,21,19,20,21,1,1,2,2,9,0,5,2,-1,-1
984,984,984,974,13,14,15,13,2,1,2,2,0,0,10,-1,-1,2
436,426,431,426,17,16,18,16,1,5,2,1,10,-5,5,1,-2,2
487,473,473,473,14,16,15,16,1,3,3,2,14,0,0,-2,1,-1
295,286,286,281,14,17,15,16,1,1,1,2,9,0,5,-3,2,-1
206,187,187,187,18,17,18,19,2,2,2,3,19,0,0,1,-1,-1
496,492,487,492,14,14,15,13,3,3,1,2,4,5,-5,0,-1,2
956,951,951,951,13,14,12,13,1,2,3,3,5,0,0,-1,2,-1
192,182,1078,1078,21,19,20,18,1,1,1,1,10,-896,0,2,-1,2
229,234,220,224,18,17,18,16,1,1,1,1,-5,14,-4,1,-1,2
703,693,679,679,13,14,12,13,3,1,1,2,10,14,0,-1,2,-1
801,787,792,792,21,19,21,19,3,2,1,1,14,-5,0,2,-2,2
529,520,515,515,14,17,15,16,1,1,1,3,9,5,0,-3,2,-1
998,993,998,993,20,19,18,18,1,2,3,2,5,-5,5,1,1,0
651,646,646,646,13,14,15,13,3,3,3,1,5,0,0,-1,-1,2
234,234,229,234,18,17,18,18,1,1,1,1,0,5,-5,1,-1,0
642,623,614,609,13,14,15,13,2,2,3,2,19,9,5,-1,-1,2
492,487,487,482,14,14,13,13,3,3,2,1,5,0,5,0,1,0
1078,1073,1073,1068,20,19,20,18,2,2,1,4,5,0,5,1,-1,2
300,290,290,290,14,17,15,16,1,1,2,1,10,0,0,-3,2,-1
867,853,862,853,18,19,18,18,1,1,1,2,14,-9,9,-1,1,0
918,914,923,918,21,19,21,19,2,2,1,2,4,-9,5,2,-2,2
792,792,792,782,14,14,13,13,2,1,2,2,0,0,10,0,1,0
374,370,370,370,17,19,18,18,1,3,1,2,4,0,0,-2,1,0
993,984,984,979,20,19,20,21,2,2,2,1,9,0,5,1,-1,-1
524,501,506,510,14,14,13,13,3,1,1,2,23,-5,-4,0,1,0
970,960,960,951,13,14,12,13,2,1,2,4,10,0,9,-1,2,-1
407,407,403,403,17,16,18,18,2,1,1,1,0,4,0,1,-2,0
674,674,674,674,13,14,15,16,1,1,1,2,0,0,0,-1,-1,-1
487,487,482,482,21,19,21,21,1,2,1,1,0,5,0,2,-2,0
182,182,182,182,21,19,21,19,2,1,1,2,0,0,0,2,-2,2
932,923,928,923,13,14,13,13,1,2,2,1,9,-5,5,-1,1,0
698,693,693,689,13,14,12,13,2,2,2,2,5,0,4,-1,2,-1
1003,998,993,993,20,19,20,21,1,1,1,1,5,5,0,1,-1,-1
904,895,900,900,14,17,15,16,1,2,1,3,9,-5,0,-3,2,-1
693,679,674,679,13,14,15,13,3,2,1,3,14,5,-5,-1,-1,2
881,876,876,881,14,17,15,16,3,3,1,5,5,0,-5,-3,2,-1
843,839,839,839,18,17,18,16,1,2,2,1,4,0,0,1,-1,2
740,745,651,740,17,19,15,18,1,1,1,1,-5,94,-89,-2,4,-3
571,571,571,567,21,19,20,18,2,1,2,1,0,0,4,2,-1,2
1003,993,998,989,17,16,18,18,1,1,1,2,10,-5,9,1,-2,0
206,201,192,192,14,14,13,13,1,1,1,1,5,9,0,0,1,0
529,524,524,524,21,19,20,19,2,3,1,1,5,0,0,2,-1,1
412,407,412,407,13,16,15,16,3,2,1,1,5,-5,5,-3,1,-1
609,604,604,604,14,14,15,13,2,2,1,1,5,0,0,0,-1,2
365,365,370,370,13,14,12,13,1,2,2,1,0,-5,0,-1,2,-1
398,393,393,389,20,19,20,18,2,1,2,1,5,0,4,1,-1,2
506,496,496,496,14,17,15,16,3,2,1,1,10,0,0,-3,2,-1
215,206,210,206,21,19,20,21,1,4,1,2,9,-4,4,2,-1,-1
576,581,576,576,18,19,18,18,2,3,1,1,-5,5,0,-1,1,0
1012,1007,1012,1012,17,19,18,18,3,2,2,2,5,-5,0,-2,1,0
337,328,318,318,17,17,15,16,2,1,3,1,9,10,0,0,2,-1
342,342,337,337,20,19,20,21,2,3,1,1,0,5,0,1,-1,-1
220,215,206,206,14,14,13,13,3,3,2,2,5,9,0,0,1,0
862,862,862,862,14,14,15,13,2,2,1,3,0,0,0,0,-1,2
440,440,436,436,13,14,12,13,2,3,2,2,0,4,0,-1,2,-1
857,839,834,834,18,19,18,18,3,4,2,1,18,5,0,-1,1,0
1050,1054,1050,1050,20,19,18,18,1,1,1,1,-4,4,0,1,1,0
820,824,820,815,18,19,18,19,1,2,2,1,-4,4,5,-1,1,-1
440,436,436,431,13,14,15,16,1,2,2,3,4,0,5,-1,-1,-1
946,942,942,946,13,14,12,13,1,2,2,1,4,0,-4,-1,2,-1
745,731,731,632,17,16,18,18,2,3,2,1,14,0,99,1,-2,0
792,787,787,782,14,14,13,13,3,3,2,2,5,0,5,0,1,0
614,604,600,600,14,14,15,13,1,3,3,1,10,4,0,0,-1,2
614,600,600,600,18,17,18,19,3,2,1,1,14,0,0,1,-1,-1
693,684,684,684,13,14,15,13,1,2,1,1,9,0,0,-1,-1,2
881,876,876,871,14,14,15,13,2,1,4,2,5,0,5,0,-1,2
782,773,773,778,18,19,18,18,1,2,1,1,9,0,-5,-1,1,0
674,665,665,656,13,14,12,13,1,1,1,2,9,0,9,-1,2,-1
534,520,515,515,18,19,20,19,3,2,1,1,14,5,0,-1,-1,1
454,445,450,440,20,19,18,18,1,2,2,1,9,-5,10,1,1,0
890,886,890,886,14,17,15,16,3,2,2,1,4,-4,4,-3,2,-1
398,393,389,389,13,14,12,13,1,3,5,2,5,4,0,-1,2,-1
520,515,510,510,18,19,18,19,1,1,1,4,5,5,0,-1,1,-1
660,660,660,656,13,16,15,16,2,1,4,2,0,0,4,-3,1,-1
928,923,918,918,21,19,21,19,1,2,2,2,5,5,0,2,-2,2
904,904,904,904,14,14,13,13,2,3,2,1,0,0,0,0,1,0
1040,1040,1045,1045,20,19,20,18,1,2,2,1,0,-5,0,1,-1,2
267,262,262,257,14,14,15,13,2,3,2,1,5,0,5,0,-1,2
253,239,239,243,14,14,13,13,1,2,3,1,14,0,-4,0,1,0
1059,1054,1050,1050,20,19,20,21,3,2,1,1,5,4,0,1,-1,-1
1021,1026,1021,1021,13,14,12,13,1,1,1,1,-5,5,0,-1,2,-1
604,600,600,604,18,17,18,19,1,3,1,1,4,0,-4,1,-1,-1
792,787,792,792,14,17,15,16,1,2,2,5,5,-5,0,-3,2,-1
904,900,895,895,14,17,15,16,2,2,1,2,4,5,0,-3,2,-1
501,492,496,492,14,17,15,16,1,2,1,1,9,-4,4,-3,2,-1
829,810,815,824,14,14,15,16,2,3,1,1,19,-5,-9,0,-1,-1
215,206,206,206,14,17,15,16,3,1,1,3,9,0,0,-3,2,-1
224,220,215,215,14,17,15,16,3,1,3,1,4,5,0,-3,2,-1
792,782,787,782,14,14,15,13,2,1,2,1,10,-5,5,0,-1,2
253,243,248,248,21,19,20,21,1,2,1,1,10,-5,0,2,-1,-1
900,895,895,895,18,17,18,19,2,3,2,1,5,0,0,1,-1,-1
876,871,871,871,21,19,20,21,3,4,1,2,5,0,0,2,-1,-1
1040,1040,1040,1040,13,14,12,13,1,3,1,1,0,0,0,-1,2,-1
515,515,520,515,14,14,13,13,3,1,2,2,0,-5,5,0,1,0
1036,1021,1021,1017,13,14,12,13,1,2,2,1,15,0,4,-1,2,-1
543,529,534,534,18,17,18,16,3,2,2,1,14,-5,0,1,-1,2
496,482,487,482,14,14,15,13,2,2,2,1,14,-5,5,0,-1,2
581,576,576,576,14,17,15,16,4,2,1,1,5,0,0,-3,2,-1
717,717,853,717,17,16,23,16,1,1,1,1,0,-136,136,1,-7,7
1045,1045,1045,1045,17,16,15,16,1,1,1,1,0,0,0,1,1,-1
182,1073,1068,1068,18,16,18,16,1,2,1,1,-891,5,0,2,-2,2
201,192,192,192,14,14,13,13,4,2,2,2,9,0,0,0,1,0
262,267,253,253,14,17,15,16,1,2,1,1,-5,14,0,-3,2,-1
210,210,206,206,14,17,15,16,2,2,1,1,0,4,0,-3,2,-1
482,473,473,464,18,16,18,18,2,2,2,2,9,0,9,2,-2,0
951,946,946,942,13,14,12,13,2,3,2,1,5,0,4,-1,2,-1
201,196,196,192,18,19,18,19,1,2,3,2,5,0,4,-1,1,-1
206,201,206,201,21,19,20,19,3,2,1,2,5,-5,5,2,-1,1
346,1040,342,346,13,19,15,16,3,1,2,1,-694,698,-4,-6,4,-1
543,534,524,520,14,14,15,13,2,2,1,1,9,10,4,0,-1,2
923,923,918,923,14,14,15,13,2,2,3,3,0,5,-5,0,-1,2
693,693,693,689,17,19,18,18,1,1,1,4,0,0,4,-2,1,0
932,932,928,928,20,19,18,19,1,1,1,1,0,4,0,1,1,-1
271,267,262,262,14,17,15,16,2,1,2,2,4,5,0,-3,2,-1
487,473,464,464,14,14,12,13,2,2,1,2,14,9,0,0,2,-1
698,693,684,684,17,16,18,16,1,4,1,2,5,9,0,1,-2,2
548,543,543,543,18,19,18,18,4,1,1,3,5,0,0,-1,1,0
604,604,600,595,14,14,13,13,1,1,1,3,0,4,5,0,1,0
829,824,824,824,14,17,15,16,2,1,3,2,5,0,0,-3,2,-1
642,637,632,637,17,16,15,16,4,1,1,1,5,5,-5,1,1,-1
712,712,707,736,20,19,20,21,1,1,3,1,0,5,-29,1,-1,-1
468,440,436,431,13,14,12,13,1,3,3,2,28,4,5,-1,2,-1
187,1064,1059,1059,14,14,12,13,3,2,2,2,-877,5,0,0,2,-1
853,848,843,843,14,17,15,16,2,2,1,1,5,5,0,-3,2,-1
553,548,543,539,21,19,20,21,3,1,2,1,5,5,4,2,-1,-1
1064,1054,1054,1054,17,16,15,16,2,2,1,2,10,0,0,1,1,-1
323,318,318,309,14,14,13,13,2,1,3,2,5,0,9,0,1,0
1036,1031,1031,1031,13,14,15,13,2,2,2,3,5,0,0,-1,-1,2
829,824,824,824,18,19,18,19,1,2,1,2,5,0,0,-1,1,-1
342,445,337,323,17,16,18,19,1,1,2,2,-103,108,14,1,-2,-1
604,600,918,590,14,14,21,13,1,3,1,2,4,-318,328,0,-7,8
815,810,810,815,14,17,15,16,1,3,1,1,5,0,-5,-3,2,-1
581,581,581,576,18,19,18,18,2,1,2,2,0,0,5,-1,1,0
1068,1064,1064,1064,13,14,15,13,3,3,2,1,4,0,0,-1,-1,2
731,731,731,731,13,14,12,13,1,2,3,3,0,0,0,-1,2,-1
374,370,370,374,20,19,20,21,1,2,3,1,4,0,-4,1,-1,-1
989,989,984,984,17,19,18,18,1,1,1,1,0,5,0,-2,1,0
290,286,286,286,21,19,20,21,1,3,1,1,4,0,0,2,-1,-1
618,623,618,623,14,14,13,13,2,2,1,3,-5,5,-5,0,1,0
553,543,548,548,14,14,13,13,3,2,1,1,10,-5,0,0,1,0
576,571,571,576,18,19,18,18,3,1,1,3,5,0,-5,-1,1,0
745,731,721,721,13,14,12,13,2,2,1,3,14,10,0,-1,2,-1
309,300,295,290,18,19,18,19,1,2,3,2,9,5,5,-1,1,-1
646,642,646,646,17,16,18,16,1,2,2,2,4,-4,0,1,-2,2
843,834,834,829,14,17,15,16,3,2,2,2,9,0,5,-3,2,-1
750,745,745,745,20,19,18,18,3,2,1,1,5,0,0,1,1,0
210,206,210,201,14,14,13,13,1,1,1,1,4,-4,9,0,1,0
459,454,454,454,17,16,15,16,2,1,2,3,5,0,0,1,1,-1
764,759,764,759,13,14,15,16,3,2,2,2,5,-5,5,-1,-1,-1
398,389,393,393,17,16,18,18,2,2,1,1,9,-4,0,1,-2,0
693,689,689,689,20,19,20,18,1,1,1,1,4,0,0,1,-1,2
576,562,567,562,18,19,18,18,1,2,2,2,14,-5,5,-1,1,0
904,904,900,900,18,19,18,19,2,1,1,3,0,4,0,-1,1,-1
736,736,736,731,13,14,15,16,4,3,3,1,0,0,5,-1,-1,-1
956,951,946,946,20,19,20,18,2,2,1,2,5,5,0,1,-1,2
182,1078,1078,1073,18,19,18,18,1,1,1,3,-896,0,5,-1,1,0
595,595,595,595,18,19,18,19,3,3,3,3,0,0,0,-1,1,-1
876,862,857,853,14,17,15,16,3,2,1,2,14,5,4,-3,2,-1
562,557,557,557,21,19,20,21,3,2,1,2,5,0,0,2,-1,-1
510,501,501,501,21,19,21,19,1,2,1,2,9,0,0,2,-2,2
684,684,679,684,20,19,20,21,1,1,1,3,0,5,-5,1,-1,-1
1068,1064,1064,1054,17,16,15,16,3,1,2,2,4,0,10,1,1,-1
1040,1031,1031,1031,13,14,12,13,1,4,2,3,9,0,0,-1,2,-1
398,384,393,393,13,14,15,13,2,2,2,1,14,-9,0,-1,-1,2
750,745,745,740,20,19,20,18,3,3,1,1,5,0,5,1,-1,2
534,529,529,529,21,19,20,21,1,2,1,3,5,0,0,2,-1,-1
487,473,473,473,14,14,15,13,1,3,2,3,14,0,0,0,-1,2
1045,1036,1031,1031,20,19,20,21,2,3,2,2,9,5,0,1,-1,-1
445,436,445,440,13,14,15,13,1,2,1,2,9,-9,5,-1,-1,2
215,210,215,215,18,17,18,16,2,1,1,2,5,-5,0,1,-1,2
403,398,398,398,20,19,20,21,3,2,1,1,5,0,0,1,-1,-1
1078,1073,1073,1073,20,19,20,21,1,2,1,1,5,0,0,1,-1,-1
810,806,806,806,18,17,18,19,2,2,1,2,4,0,0,1,-1,-1
750,750,750,754,20,19,20,21,1,3,1,1,0,0,-4,1,-1,-1
398,398,393,417,13,14,15,13,3,2,1,3,0,5,-24,-1,-1,2
1021,1017,1021,1021,20,19,18,18,1,3,1,1,4,-4,0,1,1,0
520,515,510,510,14,17,15,16,1,1,1,2,5,5,0,-3,2,-1
773,768,768,764,13,14,15,13,1,3,2,2,5,0,4,-1,-1,2
867,857,862,862,21,19,20,21,1,2,3,1,10,-5,0,2,-1,-1
271,267,271,267,21,19,20,21,1,2,1,2,4,-4,4,2,-1,-1
951,946,946,1045,13,14,12,13,3,2,1,1,5,0,-99,-1,2,-1
937,923,923,918,17,17,15,16,2,2,2,2,14,0,5,0,2,-1
196,187,182,187,21,19,21,21,1,3,1,1,9,5,-5,2,-2,0
853,843,853,857,21,19,20,21,2,2,2,3,10,-10,-4,2,-1,-1
281,286,281,281,18,17,18,19,4,1,1,3,-5,5,0,1,-1,-1
787,782,787,782,18,19,18,19,1,1,2,1,5,-5,5,-1,1,-1
895,886,890,886,21,19,20,21,3,2,3,2,9,-4,4,2,-1,-1
646,642,642,637,13,14,12,13,2,1,2,1,4,0,5,-1,2,-1
524,515,515,515,18,17,18,19,3,2,1,1,9,0,0,1,-1,-1
951,942,937,965,17,16,18,18,2,2,1,1,9,5,-28,1,-2,0
393,393,393,393,13,14,12,13,4,3,1,3,0,0,0,-1,2,-1
253,257,253,257,14,14,15,16,4,3,1,1,-4,4,-4,0,-1,-1
609,609,604,604,18,19,18,19,2,1,1,1,0,5,0,-1,1,-1
600,600,600,600,14,17,15,16,1,2,1,1,0,0,0,-3,2,-1
215,210,210,210,21,19,20,19,3,1,1,1,5,0,0,2,-1,1
360,351,356,346,13,16,15,16,1,1,1,2,9,-5,10,-3,1,-1
384,379,379,384,20,19,18,18,1,2,3,1,5,0,-5,1,1,0
210,196,206,201,14,14,15,13,2,1,1,2,14,-10,5,0,-1,2
1040,1040,1036,1036,17,16,15,16,3,1,1,1,0,4,0,1,1,-1
693,693,698,689,13,14,12,13,1,1,1,1,0,-5,9,-1,2,-1
281,271,271,267,18,19,18,18,3,2,1,1,10,0,4,-1,1,0
224,220,220,220,14,17,15,16,2,2,2,3,4,0,0,-3,2,-1
984,979,974,974,20,19,20,21,2,2,1,1,5,5,0,1,-1,-1
914,914,914,914,14,17,15,16,3,2,1,1,0,0,0,-3,2,-1
459,454,459,459,17,16,18,18,1,2,1,1,5,-5,0,1,-2,0
829,829,829,820,21,19,20,19,3,1,3,2,0,0,9,2,-1,1
651,651,651,651,13,16,15,16,2,2,3,2,0,0,0,-3,1,-1
586,571,571,571,14,14,15,13,3,2,1,4,15,0,0,0,-1,2
736,726,726,726,20,19,20,18,1,2,1,1,10,0,0,1,-1,2
642,623,623,628,17,17,15,16,4,2,1,1,19,0,-5,0,2,-1
271,271,271,267,21,19,20,21,2,4,2,2,0,0,4,2,-1,-1
267,262,262,262,14,14,15,16,1,2,1,1,5,0,0,0,-1,-1
951,951,951,946,13,14,15,13,1,3,1,2,0,0,5,-1,-1,2
670,670,665,665,17,19,18,18,1,1,1,2,0,5,0,-2,1,0
239,229,224,215,14,14,13,13,3,3,3,3,10,5,9,0,1,0
412,403,403,407,13,14,12,13,2,4,3,1,9,0,-4,-1,2,-1
871,867,867,862,18,19,18,18,2,1,2,2,4,0,5,-1,1,0
604,600,604,600,14,14,15,13,2,1,2,1,4,-4,4,0,-1,2
567,562,567,567,14,17,15,16,2,1,1,1,5,-5,0,-3,2,-1
314,304,300,300,14,14,13,13,2,4,1,2,10,4,0,0,1,0
1007,998,993,989,13,16,15,16,1,4,3,3,9,5,4,-3,1,-1
323,314,323,318,18,17,18,16,2,4,2,1,9,-9,5,1,-1,2
567,562,557,553,18,17,18,18,1,1,1,3,5,5,4,1,-1,0
614,614,618,614,18,19,18,19,1,3,2,1,0,-4,4,-1,1,-1
707,703,703,703,20,19,18,18,2,1,1,1,4,0,0,1,1,0
346,342,342,342,13,14,12,13,2,2,1,1,4,0,0,-1,2,-1
576,562,576,707,14,14,13,11,3,2,1,1,14,-14,-131,0,1,2
979,974,974,974,17,16,18,18,2,1,3,1,5,0,0,1,-2,0
740,731,731,726,20,19,20,18,2,2,1,2,9,0,5,1,-1,2
206,201,206,201,21,19,20,21,1,2,2,1,5,-5,5,2,-1,-1
210,201,201,206,18,19,18,19,3,1,1,2,9,0,-5,-1,1,-1
717,712,703,698,17,19,18,18,4,3,1,2,5,9,5,-2,1,0
707,703,703,703,13,14,12,13,1,2,3,1,4,0,0,-1,2,-1
229,224,224,224,21,19,20,19,1,1,2,1,5,0,0,2,-1,1
337,328,323,318,20,19,18,19,2,1,1,2,9,5,5,1,1,-1
857,848,853,853,21,19,18,18,1,1,1,2,9,-5,0,2,1,0
360,356,356,346,13,14,15,13,5,4,2,3,4,0,10,-1,-1,2
965,956,956,956,17,16,18,16,4,2,3,1,9,0,0,1,-2,2
759,754,754,750,17,16,18,18,2,1,2,1,5,0,4,1,-2,0
290,286,642,286,18,17,18,16,2,2,1,2,4,-356,356,1,-1,2
501,496,492,496,18,17,18,19,3,1,2,1,5,4,-4,1,-1,-1
918,909,909,904,18,17,18,19,3,2,2,2,9,0,5,1,-1,-1
829,824,820,824,18,19,18,19,1,1,1,1,5,4,-4,-1,1,-1
712,703,707,703,17,16,18,18,2,3,1,2,9,-4,4,1,-2,0
970,965,965,960,17,16,18,18,3,1,2,1,5,0,5,1,-2,0
515,506,510,510,18,19,18,19,2,2,3,1,9,-4,0,-1,1,-1
754,754,759,759,13,14,15,16,1,2,1,1,0,-5,0,-1,-1,-1
764,782,754,754,17,17,18,18,1,2,1,1,-18,28,0,0,-1,0
398,393,393,393,20,19,20,21,1,1,1,1,5,0,0,1,-1,-1
614,604,604,604,14,14,13,13,3,1,2,1,10,0,0,0,1,0
660,656,656,651,17,16,18,18,3,2,2,1,4,0,5,1,-2,0
576,571,571,571,18,17,18,16,2,1,2,1,5,0,0,1,-1,2
482,473,478,473,18,19,18,18,2,2,2,2,9,-5,5,-1,1,0
1040,1031,1026,1026,17,19,18,18,1,2,3,1,9,5,0,-2,1,0
984,979,974,970,13,14,15,13,2,3,2,1,5,5,4,-1,-1,2
229,220,224,220,14,14,15,13,3,1,2,1,9,-4,4,0,-1,2
998,993,989,989,13,14,15,13,3,5,1,2,5,4,0,-1,-1,2
421,412,412,412,13,16,15,16,2,6,2,2,9,0,0,-3,1,-1
239,229,234,224,14,17,15,16,3,2,1,2,10,-5,10,-3,2,-1
796,796,792,796,14,14,13,13,1,3,1,1,0,4,-4,0,1,0
595,581,576,576,14,14,15,13,1,2,1,2,14,5,0,0,-1,2
356,351,342,342,17,16,18,18,2,3,5,1,5,9,0,1,-2,0
792,792,787,787,14,14,15,13,2,5,1,1,0,5,0,0,-1,2
220,215,210,210,18,19,18,19,1,1,3,1,5,5,0,-1,1,-1
421,417,421,417,20,19,20,21,3,3,3,2,4,-4,4,1,-1,-1
618,618,623,623,18,17,18,19,4,2,2,1,0,-5,0,1,-1,-1
914,914,909,904,14,14,15,13,1,3,1,5,0,5,5,0,-1,2
904,900,900,900,14,14,13,13,2,2,2,1,4,0,0,0,1,0
393,393,384,384,20,19,18,18,1,3,1,1,0,9,0,1,1,0
609,609,604,604,14,17,15,16,4,3,1,1,0,5,0,-3,2,-1
993,989,984,281,13,14,12,11,3,3,1,1,4,5,703,-1,2,1
576,571,576,571,14,14,15,13,2,2,3,1,5,-5,5,0,-1,2
867,862,857,853,18,17,18,18,1,1,1,2,5,5,4,1,-1,0
848,839,839,834,21,19,20,18,1,1,1,2,9,0,5,2,-1,2
618,618,614,614,14,17,15,16,1,3,1,3,0,4,0,-3,2,-1
426,421,417,412,13,14,15,13,1,1,2,2,5,4,5,-1,-1,2
656,651,651,656,13,14,12,13,3,3,1,2,5,0,-5,-1,2,-1
857,848,848,848,18,17,18,18,1,2,1,1,9,0,0,1,-1,0
1045,1040,1040,1036,13,14,12,13,3,2,1,2,5,0,4,-1,2,-1
1050,1050,1050,1045,20,19,18,18,1,3,2,2,0,0,5,1,1,0
998,993,998,989,20,19,18,18,2,2,2,2,5,-5,9,1,1,0
515,510,506,506,18,19,18,19,2,3,1,1,5,4,0,-1,1,-1
946,942,946,942,17,16,15,16,1,1,1,2,4,-4,4,1,1,-1
1068,1059,1050,1050,17,16,15,16,2,3,1,1,9,9,0,1,1,-1
1026,1021,1026,1021,17,19,18,18,1,1,2,1,5,-5,5,-2,1,0
764,759,754,754,20,19,20,21,2,1,1,1,5,5,0,1,-1,-1
618,609,609,609,14,17,15,16,2,2,2,1,9,0,0,-3,2,-1
642,637,637,637,17,16,18,18,2,1,2,1,5,0,0,1,-2,0
609,595,586,586,14,14,13,13,2,3,1,3,14,9,0,0,1,0
810,806,806,806,14,14,13,13,3,3,1,2,4,0,0,0,1,0
604,604,604,600,14,14,15,13,3,3,2,3,0,0,4,0,-1,2
778,773,773,778,20,19,20,21,1,2,1,1,5,0,-5,1,-1,-1
445,436,445,440,17,16,18,18,3,1,2,1,9,-9,5,1,-2,0
323,323,323,318,18,19,18,19,2,1,1,2,0,0,5,-1,1,-1
571,567,567,567,21,19,20,21,1,2,1,1,4,0,0,2,-1,-1
450,445,450,445,20,19,20,18,1,2,2,2,5,-5,5,1,-1,2
974,970,970,965,20,19,20,18,1,2,1,2,4,0,5,1,-1,2
215,215,215,215,18,17,18,19,1,3,2,1,0,0,0,1,-1,-1
346,337,337,342,17,16,15,16,2,2,1,1,9,0,-5,1,1,-1
600,595,595,590,14,17,15,16,1,1,1,1,5,0,5,-3,2,-1
440,440,436,867,17,16,18,16,1,3,2,1,0,4,-431,1,-2,2
304,295,295,290,14,14,15,13,1,1,1,3,9,0,5,0,-1,2
1007,1003,998,1003,13,14,15,16,1,2,1,1,4,5,-5,-1,-1,-1
253,248,248,243,21,19,20,21,2,2,2,3,5,0,5,2,-1,-1
796,787,792,787,18,19,18,19,1,2,2,1,9,-5,5,-1,1,-1
342,337,337,342,13,16,15,16,1,2,2,1,5,0,-5,-3,1,-1
810,801,806,801,18,19,18,19,1,2,2,3,9,-5,5,-1,1,-1
492,684,487,482,14,14,13,13,2,1,2,1,-192,197,5,0,1,0
665,665,665,656,13,14,12,13,1,3,1,2,0,0,9,-1,2,-1
1003,998,993,993,17,16,15,16,3,3,2,1,5,5,0,1,1,-1
436,436,436,436,13,14,12,13,3,2,2,1,0,0,0,-1,2,-1
229,224,224,229,14,14,13,13,3,3,1,1,5,0,-5,0,1,0
534,524,510,510,14,14,13,13,1,4,3,2,10,14,0,0,1,0
492,492,492,487,18,17,18,19,1,1,4,3,0,0,5,1,-1,-1
834,834,834,829,14,14,13,13,1,3,5,2,0,0,5,0,1,0
614,609,609,604,14,17,15,16,4,1,2,1,5,0,5,-3,2,-1
515,501,501,501,21,19,21,21,1,2,2,1,14,0,0,2,-2,0
224,220,215,215,14,17,15,16,3,3,3,1,4,5,0,-3,2,-1
215,206,206,206,21,19,20,21,1,2,1,1,9,0,0,2,-1,-1
224,220,220,215,21,19,20,21,2,1,2,2,4,0,5,2,-1,-1
337,323,323,328,13,14,15,13,2,2,1,1,14,0,-5,-1,-1,2
487,487,487,482,21,19,21,21,1,1,2,1,0,0,5,2,-2,0
1021,1012,1012,1017,13,14,12,13,2,2,1,3,9,0,-5,-1,2,-1
595,586,586,586,14,17,15,16,1,2,1,1,9,0,0,-3,2,-1
248,239,239,234,14,14,13,13,3,2,3,1,9,0,5,0,1,0
782,773,773,768,14,14,15,13,1,2,1,2,9,0,5,0,-1,2
473,468,468,468,20,19,20,18,1,1,1,2,5,0,0,1,-1,2
421,412,412,407,17,16,18,16,1,2,3,2,9,0,5,1,-2,2
670,660,665,660,20,19,20,18,2,2,3,1,10,-5,5,1,-1,2
637,632,637,637,17,19,18,18,2,2,2,1,5,-5,0,-2,1,0
1059,1054,1050,1054,13,16,15,16,2,3,3,1,5,4,-4,-3,1,-1
187,1068,1073,1073,21,19,20,21,1,2,1,1,-881,-5,0,2,-1,-1
820,806,267,815,18,19,15,19,1,3,1,3,14,539,-548,-1,4,-4
618,614,609,604,14,17,15,16,3,1,1,2,4,5,5,-3,2,-1
796,787,787,787,14,14,13,13,2,1,1,1,9,0,0,0,1,0
262,257,253,253,14,17,15,16,1,3,3,1,5,4,0,-3,2,-1
286,290,286,281,14,14,13,13,2,1,2,1,-4,4,5,0,1,0
300,295,286,290,14,14,13,13,2,1,1,1,5,9,-4,0,1,0
529,529,529,529,18,19,18,19,2,1,1,1,0,0,0,-1,1,-1
473,454,454,459,13,16,15,16,1,2,3,1,19,0,-5,-3,1,-1
623,618,618,618,14,17,15,16,1,2,1,1,5,0,0,-3,2,-1
918,914,914,909,14,14,13,13,2,5,2,2,4,0,5,0,1,0
426,412,412,412,13,14,15,13,4,2,1,1,14,0,0,-1,-1,2
773,768,768,764,13,14,12,13,3,2,1,2,5,0,4,-1,2,-1
956,951,956,946,20,19,18,18,1,2,2,2,5,-5,10,1,1,0
618,614,614,609,18,19,18,19,1,2,2,2,4,0,5,-1,1,-1
539,1059,1059,1059,18,19,18,18,1,1,2,1,-520,0,0,-1,1,0
1026,1026,1026,1021,17,16,15,16,1,1,1,3,0,0,5,1,1,-1
965,960,960,960,20,19,20,21,1,2,2,3,5,0,0,1,-1,-1
960,951,951,951,20,19,20,18,1,2,3,2,9,0,0,1,-1,2
182,1073,1073,1073,18,19,18,18,2,2,1,1,-891,0,0,-1,1,0
946,946,946,942,13,14,15,16,1,3,2,1,0,0,4,-1,-1,-1
979,970,974,970,13,16,15,16,2,1,2,2,9,-4,4,-3,1,-1
403,403,398,403,13,14,12,13,1,1,3,1,0,5,-5,-1,2,-1
815,806,801,801,18,17,18,16,3,1,3,2,9,5,0,1,-1,2
374,370,365,365,17,19,18,18,3,2,1,1,4,5,0,-2,1,0
440,436,431,431,17,19,18,18,2,1,1,3,4,5,0,-2,1,0
890,886,881,881,14,17,15,16,2,1,4,2,4,5,0,-3,2,-1
323,314,314,309,14,14,15,13,1,2,2,2,9,0,5,0,-1,2
496,492,487,487,21,19,21,19,1,1,1,1,4,5,0,2,-2,2
346,337,342,342,13,16,15,16,1,4,1,1,9,-5,0,-3,1,-1
581,576,586,576,18,19,18,18,1,1,2,1,5,-10,10,-1,1,0
323,309,309,314,18,17,18,16,2,4,1,3,14,0,-5,1,-1,2
464,459,459,459,20,19,20,18,1,3,2,1,5,0,0,1,-1,2
253,248,243,243,14,14,13,13,2,1,2,1,5,5,0,0,1,0
857,853,848,853,21,19,20,18,3,2,1,1,4,5,-5,2,-1,2
192,674,670,665,18,19,18,18,1,3,1,2,-482,4,5,-1,1,0
848,843,848,843,14,17,15,16,2,2,2,1,5,-5,5,-3,2,-1
1021,1021,1017,1017,20,19,20,21,3,1,1,2,0,4,0,1,-1,-1
679,674,674,674,13,14,12,13,3,2,2,2,5,0,0,-1,2,-1
787,787,787,782,14,14,13,13,1,1,2,1,0,0,5,0,1,0
586,581,586,581,14,14,15,13,3,2,2,3,5,-5,5,0,-1,2
567,562,557,553,21,19,20,18,1,1,1,1,5,5,4,2,-1,2
618,618,623,618,14,17,15,16,2,1,2,1,0,-5,5,-3,2,-1
365,360,360,360,17,16,18,18,2,1,1,1,5,0,0,1,-2,0
989,984,984,984,20,19,18,18,1,2,1,1,5,0,0,1,1,0
782,773,773,768,14,14,12,13,1,2,1,2,9,0,5,0,2,-1
529,506,506,501,14,14,15,13,2,2,3,2,23,0,5,0,-1,2
993,984,989,993,20,19,20,18,2,4,1,1,9,-5,-4,1,-1,2
187,182,1078,1073,14,14,13,13,1,2,2,2,5,-896,5,0,1,0
323,309,314,309,14,17,15,16,2,2,2,2,14,-5,5,-3,2,-1
243,234,234,234,14,14,15,16,3,2,1,3,9,0,0,0,-1,-1
182,1078,1073,1068,18,16,18,18,1,1,3,2,-896,5,5,2,-2,0
759,754,750,745,20,19,20,18,2,3,2,1,5,4,5,1,-1,2
318,314,314,314,14,17,15,16,1,1,1,1,4,0,0,-3,2,-1
290,281,281,281,18,19,18,19,1,2,3,3,9,0,0,-1,1,-1
656,642,642,646,20,19,18,18,2,4,1,3,14,0,-4,1,1,0
543,534,539,539,21,19,20,18,1,1,1,1,9,-5,0,2,-1,2
618,614,614,614,21,19,21,21,2,2,1,1,4,0,0,2,-2,0
951,946,951,1026,20,19,18,18,2,2,2,1,5,-5,-75,1,1,0
389,374,374,374,13,14,12,13,1,2,1,3,15,0,0,-1,2,-1
281,286,286,281,14,14,13,13,2,2,2,2,-5,0,5,0,1,0
300,295,295,295,14,17,15,16,1,1,3,1,5,0,0,-3,2,-1
571,571,567,567,18,17,18,16,2,2,2,2,0,4,0,1,-1,2
1003,1003,998,998,13,16,15,16,3,2,2,1,0,5,0,-3,1,-1
201,196,196,192,14,14,13,13,1,3,1,1,5,0,4,0,1,0
501,506,501,501,14,14,13,13,1,2,2,1,-5,5,0,0,1,0
754,745,745,750,13,14,12,13,3,1,1,1,9,0,-5,-1,2,-1
374,365,370,365,13,16,15,16,1,2,2,2,9,-5,5,-3,1,-1
914,909,909,904,14,14,15,13,4,3,2,1,5,0,5,0,-1,2
492,482,492,487,14,17,15,16,1,2,2,1,10,-10,5,-3,2,-1
600,600,595,590,14,14,13,13,2,3,1,2,0,5,5,0,1,0
614,604,600,595,14,17,15,16,2,2,1,2,10,4,5,-3,2,-1
895,890,890,890,14,14,13,13,2,2,2,2,5,0,0,0,1,0
820,810,810,810,14,14,15,13,1,1,1,3,10,0,0,0,-1,2
234,239,234,229,21,19,20,21,2,1,2,4,-5,5,5,2,-1,-1
295,290,318,290,14,17,15,16,2,2,1,1,5,-28,28,-3,2,-1
342,337,337,328,17,16,15,16,1,1,2,1,5,0,9,1,1,-1
300,286,286,290,21,19,20,21,3,2,2,1,14,0,-4,2,-1,-1
886,881,881,881,21,19,20,21,1,1,1,2,5,0,0,2,-1,-1
492,487,487,492,18,17,18,16,1,2,2,3,5,0,-5,1,-1,2
946,937,937,932,20,19,20,21,2,3,3,2,9,0,5,1,-1,-1
923,914,918,918,14,14,13,13,1,2,1,1,9,-4,0,0,1,0
267,262,271,257,14,14,13,13,1,1,2,2,5,-9,14,0,1,0
862,848,192,839,14,14,15,13,2,3,1,1,14,656,-647,0,-1,2
740,745,740,740,13,14,15,13,5,3,1,3,-5,5,0,-1,-1,2
754,946,750,754,13,14,15,16,3,1,3,1,-192,196,-4,-1,-1,-1
267,257,253,248,14,14,13,13,1,3,2,1,10,4,5,0,1,0
824,820,815,815,14,14,15,13,1,2,2,2,4,5,0,0,-1,2
914,909,914,914,18,19,18,19,1,1,2,1,5,-5,0,-1,1,-1
674,674,670,674,13,14,15,16,1,3,3,1,0,4,-4,-1,-1,-1
768,759,759,754,17,16,18,16,2,3,2,1,9,0,5,1,-2,2
965,960,965,960,20,19,18,18,1,1,2,1,5,-5,5,1,1,0
1040,1040,1036,1036,20,19,18,18,1,1,1,1,0,4,0,1,1,0
778,773,773,796,20,19,20,19,2,1,1,2,5,0,-23,1,-1,1
965,960,839,951,17,16,15,16,1,1,1,1,5,121,-112,1,1,-1
482,482,482,482,14,14,13,13,1,1,1,2,0,0,0,0,1,0
862,857,853,848,18,19,18,18,3,3,1,2,5,4,5,-1,1,0
229,229,229,229,14,14,15,13,3,1,3,1,0,0,0,0,-1,2
445,440,436,436,13,16,15,16,2,2,1,2,5,4,0,-3,1,-1
717,717,717,712,20,19,20,21,1,2,2,1,0,0,5,1,-1,-1
407,403,389,389,13,14,15,16,4,3,2,1,4,14,0,-1,-1,-1
820,810,810,810,18,17,18,16,2,2,1,1,10,0,0,1,-1,2
689,459,459,454,20,14,15,13,1,2,2,2,230,0,5,6,-1,2
210,206,206,206,14,14,15,13,2,4,2,1,4,0,0,0,-1,2
614,609,609,609,18,17,18,19,1,1,1,4,5,0,0,1,-1,-1
646,642,646,642,20,19,20,21,2,1,2,1,4,-4,4,1,-1,-1
543,534,529,529,14,14,13,13,1,1,2,1,9,5,0,0,1,0
736,731,736,731,13,14,12,13,2,3,2,1,5,-5,5,-1,2,-1
314,314,314,309,14,14,15,13,2,2,4,2,0,0,5,0,-1,2
271,271,276,262,14,17,15,16,2,1,2,1,0,-5,14,-3,2,-1
295,286,281,276,18,17,18,16,3,4,3,2,9,5,5,1,-1,2
524,520,520,520,14,14,13,13,2,2,2,2,4,0,0,0,1,0
909,904,900,900,18,19,20,19,2,3,1,1,5,4,0,-1,-1,1
726,726,721,721,20,19,20,21,1,1,1,1,0,5,0,1,-1,-1
482,468,459,459,14,14,15,13,1,1,3,2,14,9,0,0,-1,2
436,426,426,421,20,19,18,18,2,2,2,2,10,0,5,1,1,0
328,318,323,318,14,14,15,13,1,2,2,2,10,-5,5,0,-1,2
974,918,914,914,17,17,18,19,3,1,1,1,56,4,0,0,-1,-1
196,192,192,187,14,17,15,16,3,3,2,1,4,0,5,-3,2,-1
998,993,998,998,17,19,18,18,2,1,2,3,5,-5,0,-2,1,0
1007,998,993,993,17,19,18,18,3,1,1,1,9,5,0,-2,1,0
262,257,257,257,14,14,15,13,3,2,2,1,5,0,0,0,-1,2
707,707,703,703,20,19,20,18,3,2,1,1,0,4,0,1,-1,2
215,210,206,206,18,17,18,16,3,2,1,2,5,4,0,1,-1,2
501,496,496,492,18,19,18,19,1,1,2,2,5,0,4,-1,1,-1
548,529,529,524,14,14,13,13,1,1,1,1,19,0,5,0,1,0
1078,1068,1068,1068,13,14,15,13,2,1,1,3,10,0,0,-1,-1,2
773,773,768,764,20,19,20,21,3,1,1,2,0,5,4,1,-1,-1
374,365,365,365,13,14,12,13,1,4,3,2,9,0,0,-1,2,-1
801,801,801,796,18,19,18,19,1,3,1,1,0,0,5,-1,1,-1
492,482,487,482,14,17,15,16,1,2,2,2,10,-5,5,-3,2,-1
356,351,346,346,20,19,18,18,1,2,1,1,5,5,0,1,1,0
839,834,834,829,18,17,18,16,2,3,2,2,5,0,5,1,-1,2
665,660,660,660,13,14,15,13,1,3,1,3,5,0,0,-1,-1,2
468,468,473,468,20,19,18,18,1,3,2,1,0,-5,5,1,1,0
473,468,468,468,13,14,15,13,1,2,1,1,5,0,0,-1,-1,2
534,534,529,524,18,17,18,19,1,3,1,1,0,5,5,1,-1,-1
515,506,501,501,18,17,18,19,3,3,1,1,9,5,0,1,-1,-1
351,351,351,351,20,19,20,18,3,2,1,1,0,0,0,1,-1,2
224,220,220,220,18,17,18,19,3,1,2,2,4,0,0,1,-1,-1
567,567,567,562,14,14,13,13,2,1,1,2,0,0,5,0,1,0
754,745,750,754,17,16,18,18,3,2,1,1,9,-5,-4,1,-2,0
745,745,745,740,17,16,18,16,1,6,1,1,0,0,5,1,-2,2
440,431,426,426,13,14,12,13,2,2,2,1,9,5,0,-1,2,-1
267,262,262,309,14,14,13,13,3,1,1,1,5,0,-47,0,1,0
843,834,834,829,18,17,18,19,1,3,1,3,9,0,5,1,-1,-1
820,815,815,815,18,17,18,19,2,2,1,1,5,0,0,1,-1,-1
473,468,473,468,13,14,12,13,2,2,2,2,5,-5,5,-1,2,-1
346,337,351,342,17,16,15,16,2,1,2,1,9,-14,9,1,1,-1
871,867,862,857,14,17,15,16,1,3,1,2,4,5,5,-3,2,-1
618,609,609,609,14,14,15,13,1,2,2,1,9,0,0,0,-1,2
1012,1012,1012,1012,13,14,12,13,1,3,1,1,0,0,0,-1,2,-1
346,337,342,346,13,14,12,13,3,3,2,3,9,-5,-4,-1,2,-1
750,745,745,745,13,14,12,13,1,2,3,1,5,0,0,-1,2,-1
595,581,595,590,14,14,13,13,3,2,2,2,14,-14,5,0,1,0
993,993,993,993,20,19,20,18,1,2,1,1,0,0,0,1,-1,2
979,974,974,932,17,16,18,16,2,2,1,2,5,0,42,1,-2,2
398,389,389,389,17,16,15,16,2,2,3,1,9,0,0,1,1,-1
867,853,862,857,18,17,18,18,2,2,2,1,14,-9,5,1,-1,0
937,932,928,923,17,16,18,16,1,1,2,3,5,4,5,1,-2,2
801,801,801,796,18,19,18,19,3,3,1,1,0,0,5,-1,1,-1
332,318,342,323,13,14,15,13,1,4,1,1,14,-24,19,-1,-1,2
942,937,932,932,17,19,18,18,1,3,1,1,5,5,0,-2,1,0
862,853,857,857,18,17,15,16,2,2,2,1,9,-4,0,1,2,-1
581,571,567,567,18,19,18,18,1,2,1,1,10,4,0,-1,1,0
300,295,295,290,21,19,20,19,3,2,1,1,5,0,5,2,-1,1
210,196,192,187,18,17,18,19,1,3,2,1,14,4,5,1,-1,-1
398,398,398,393,20,19,20,21,3,2,2,2,0,0,5,1,-1,-1
820,815,815,810,18,17,18,19,2,2,1,2,5,0,5,1,-1,-1
468,473,468,468,13,14,15,13,1,1,3,1,-5,5,0,-1,-1,2
1045,1036,1050,1045,13,14,12,13,3,2,2,4,9,-14,5,-1,2,-1
820,815,815,810,14,14,15,13,3,3,2,1,5,0,5,0,-1,2
914,909,909,909,18,19,18,19,1,2,1,1,5,0,0,-1,1,-1
848,839,843,839,14,14,15,16,2,2,2,1,9,-4,4,0,-1,-1
1017,1012,1003,998,13,14,15,13,3,3,1,2,5,9,5,-1,-1,2
618,618,618,614,18,19,18,19,2,1,1,2,0,0,4,-1,1,-1
342,337,337,337,20,19,20,21,2,1,1,1,5,0,0,1,-1,-1
984,379,979,979,17,16,18,18,1,1,1,1,605,-600,0,1,-2,0
323,323,318,318,21,19,21,19,2,1,1,2,0,5,0,2,-2,2
1017,1017,1021,1021,13,14,12,13,3,2,4,1,0,-4,0,-1,2,-1
567,567,567,567,14,14,13,13,2,3,1,2,0,0,0,0,1,0
946,951,946,942,20,19,20,21,1,3,2,2,-5,5,4,1,-1,-1
548,543,539,539,18,19,18,18,1,2,1,1,5,4,0,-1,1,0
360,356,351,351,17,16,18,18,2,2,2,2,4,5,0,1,-2,0
520,515,515,520,18,19,18,19,2,2,1,1,5,0,-5,-1,1,-1
839,834,829,829,14,14,15,13,2,3,1,1,5,5,0,0,-1,2
553,548,534,529,14,14,13,13,2,3,2,2,5,14,5,0,1,0
796,792,792,792,14,14,15,13,1,3,2,1,4,0,0,0,-1,2
1064,1064,1064,1064,13,14,12,13,1,3,2,2,0,0,0,-1,2,-1
426,421,421,421,20,19,20,21,1,1,1,1,5,0,0,1,-1,-1
1078,1068,1073,1068,17,16,18,18,2,2,1,2,10,-5,5,1,-2,0
450,450,450,445,13,14,15,16,2,3,1,2,0,0,5,-1,-1,-1
857,857,857,848,14,17,15,16,1,3,2,2,0,0,9,-3,2,-1
632,632,632,632,20,19,20,21,1,1,1,2,0,0,0,1,-1,-1
534,524,529,529,18,19,18,19,1,2,1,2,10,-5,0,-1,1,-1
370,370,365,365,20,19,20,18,3,1,1,1,0,5,0,1,-1,2
665,660,660,660,20,19,20,21,3,2,1,1,5,0,0,1,-1,-1
764,764,764,759,17,16,18,16,1,1,2,1,0,0,5,1,-2,2
768,768,946,768,13,14,18,13,3,2,1,2,0,-178,178,-1,-4,5
1073,1068,1068,1068,17,16,15,16,1,2,1,3,5,0,0,1,1,-1
524,520,515,520,14,17,15,16,3,1,1,1,4,5,-5,-3,2,-1
674,670,670,674,20,19,20,18,2,3,1,1,4,0,-4,1,-1,2
604,595,604,609,14,14,13,13,1,2,2,1,9,-9,-5,0,1,0
431,412,412,407,13,14,12,13,2,2,1,2,19,0,5,-1,2,-1
998,989,993,993,13,14,15,13,1,2,2,2,9,-4,0,-1,-1,2
332,332,337,332,13,14,12,13,1,1,2,1,0,-5,5,-1,2,-1
946,937,942,937,20,19,20,21,3,2,1,2,9,-5,5,1,-1,-1
618,614,642,604,14,14,12,13,1,2,4,4,4,-28,38,0,2,-1
834,829,834,829,21,19,20,21,1,2,2,1,5,-5,5,2,-1,-1
721,726,712,712,13,14,12,13,2,2,3,1,-5,14,0,-1,2,-1
787,778,778,778,18,16,18,16,1,1,2,1,9,0,0,2,-2,2
529,524,524,524,14,14,13,13,1,2,1,3,5,0,0,0,1,0
562,553,548,548,18,19,20,18,1,1,1,1,9,5,0,-1,-1,2
590,581,581,576,14,17,15,16,1,1,2,1,9,0,5,-3,2,-1
1054,1054,1050,1050,17,16,18,16,1,1,1,2,0,4,0,1,-2,2
843,839,824,815,14,14,15,13,3,3,1,3,4,15,9,0,-1,2
543,534,529,534,14,14,13,13,3,2,1,1,9,5,-5,0,1,0
182,182,187,182,18,17,18,19,1,1,2,1,0,-5,5,1,-1,-1
318,318,318,314,18,17,18,16,3,1,2,1,0,0,4,1,-1,2
210,206,206,403,21,19,20,21,1,3,1,1,4,0,-197,2,-1,-1
773,768,764,764,13,14,12,13,1,1,3,1,5,4,0,-1,2,-1
773,768,768,768,20,19,18,18,1,1,2,3,5,0,0,1,1,0
787,778,778,773,18,19,18,18,1,1,2,2,9,0,5,-1,1,0
417,398,393,393,13,14,12,13,2,3,1,2,19,5,0,-1,2,-1
300,304,300,290,14,14,13,13,1,1,2,2,-4,4,10,0,1,0
248,234,243,243,14,17,15,16,1,2,2,1,14,-9,0,-3,2,-1
384,384,384,384,13,14,12,13,1,3,2,1,0,0,0,-1,2,-1
754,745,740,736,13,14,15,13,2,1,1,2,9,5,4,-1,-1,2
684,674,674,674,17,16,18,16,1,1,2,3,10,0,0,1,-2,2
918,909,909,909,18,19,18,19,2,1,1,1,9,0,0,-1,1,-1
342,328,323,323,13,17,15,16,2,1,1,1,14,5,0,-4,2,-1
220,215,220,215,14,14,13,13,2,2,2,2,5,-5,5,0,1,0
286,286,281,286,21,19,20,19,2,1,1,1,0,5,-5,2,-1,1
187,1068,1073,1073,14,14,12,13,2,2,1,2,-881,-5,0,0,2,-1
567,567,567,567,14,17,15,16,1,2,1,2,0,0,0,-3,2,-1
754,750,750,750,20,19,20,18,3,2,1,1,4,0,0,1,-1,2
703,693,736,764,13,14,12,13,1,3,2,3,10,-43,-28,-1,2,-1
557,553,548,548,18,17,18,18,1,1,1,1,4,5,0,1,-1,0
918,904,914,918,14,14,15,13,1,2,2,1,14,-10,-4,0,-1,2
731,721,721,721,20,19,18,18,1,3,1,1,10,0,0,1,1,0
951,946,946,942,20,19,18,18,2,1,1,2,5,0,4,1,1,0
478,468,468,464,13,16,15,16,2,2,2,1,10,0,4,-3,1,-1
206,196,196,192,14,17,15,16,2,5,3,2,10,0,4,-3,2,-1
1012,1012,1012,1012,13,14,15,13,1,3,2,1,0,0,0,-1,-1,2
426,421,421,421,20,19,18,18,2,1,3,1,5,0,0,1,1,0
871,867,867,867,18,17,18,18,1,4,4,5,4,0,0,1,-1,0
815,815,815,810,14,17,15,16,2,1,1,2,0,0,5,-3,2,-1
248,234,224,229,14,17,15,16,2,3,1,1,14,10,-5,-3,2,-1
993,984,984,989,13,14,12,13,5,3,3,3,9,0,-5,-1,2,-1
867,857,857,857,14,14,15,13,1,1,1,2,10,0,0,0,-1,2
914,923,914,914,18,17,18,16,2,1,3,1,-9,9,0,1,-1,2
351,342,342,332,20,19,20,21,3,2,2,1,9,0,10,1,-1,-1
1007,1003,1003,1012,13,16,15,16,3,3,1,1,4,0,-9,-3,1,-1
300,290,290,290,21,19,20,19,2,2,1,2,10,0,0,2,-1,1
646,642,642,637,17,16,18,18,1,5,1,2,4,0,5,1,-2,0
623,618,618,618,21,19,21,19,3,1,1,1,5,0,0,2,-2,2
937,937,932,937,20,19,20,21,1,2,1,1,0,5,-5,1,-1,-1
267,262,262,257,14,14,15,13,1,3,1,2,5,0,5,0,-1,2
960,965,956,960,13,14,15,13,1,3,1,3,-5,9,-4,-1,-1,2
965,956,951,946,17,16,15,16,2,1,2,2,9,5,5,1,1,-1
914,909,904,904,18,17,18,16,3,1,1,2,5,5,0,1,-1,2
210,206,201,201,21,19,21,19,3,1,1,2,4,5,0,2,-2,2
595,595,590,595,14,14,13,13,2,3,2,1,0,5,-5,0,1,0
290,286,286,286,14,17,15,16,1,1,1,2,4,0,0,-3,2,-1
450,454,459,450,20,19,20,21,1,1,4,2,-4,-5,9,1,-1,-1
562,557,557,562,21,19,20,18,1,2,1,1,5,0,-5,2,-1,2
642,646,642,637,17,16,18,18,1,1,2,1,-4,4,5,1,-2,0
628,623,623,623,18,17,18,16,1,2,1,1,5,0,0,1,-1,2
900,904,895,900,14,14,15,13,4,3,1,3,-4,9,-5,0,-1,2
459,459,454,459,17,16,18,18,1,3,1,1,0,5,-5,1,-2,0
506,487,492,642,14,14,13,9,2,1,1,1,19,-5,-150,0,1,4
1073,1054,1054,1050,20,19,20,18,1,3,2,1,19,0,4,1,-1,2
407,403,398,398,13,16,15,16,2,2,1,2,4,5,0,-3,1,-1
520,520,515,515,14,14,15,13,1,3,1,1,0,5,0,0,-1,2
623,609,614,618,18,19,18,19,1,2,1,1,14,-5,-4,-1,1,-1
886,876,871,867,21,19,20,21,1,3,1,2,10,5,4,2,-1,-1
984,974,974,979,20,19,20,18,1,1,1,1,10,0,-5,1,-1,2
389,384,389,379,17,19,18,18,1,1,2,1,5,-5,10,-2,1,0
937,923,923,928,20,19,21,21,2,2,1,1,14,0,-5,1,-2,0
543,548,543,543,14,17,15,16,3,2,1,1,-5,5,0,-3,2,-1
862,839,839,839,14,14,15,13,3,3,2,1,23,0,0,0,-1,2
1040,1036,1031,1031,20,19,18,18,2,1,1,1,4,5,0,1,1,0
1045,1040,1040,1040,17,16,15,16,1,2,1,1,5,0,0,1,1,-1
745,745,745,740,13,14,15,13,2,3,3,1,0,0,5,-1,-1,2
454,440,440,440,17,16,18,18,2,2,1,2,14,0,0,1,-2,0
689,684,684,679,13,14,15,16,2,1,2,1,5,0,5,-1,-1,-1
1007,998,998,998,13,14,12,13,2,1,1,1,9,0,0,-1,2,-1
417,412,407,407,13,14,15,13,1,2,1,1,5,5,0,-1,-1,2
374,374,360,360,13,14,15,13,1,2,1,2,0,14,0,-1,-1,2
196,187,187,187,18,19,18,19,1,2,1,1,9,0,0,-1,1,-1
356,351,346,351,17,16,15,16,3,1,1,1,5,5,-5,1,1,-1
1040,1031,1036,1031,17,16,15,16,1,1,2,1,9,-5,5,1,1,-1
623,614,609,609,14,17,15,16,3,2,3,1,9,5,0,-3,2,-1
492,492,492,492,14,14,13,13,2,1,3,1,0,0,0,0,1,0
909,909,904,909,21,19,20,19,1,2,3,1,0,5,-5,2,-1,1
871,867,862,867,14,17,15,16,2,2,5,1,4,5,-5,-3,2,-1
379,370,360,351,13,16,15,16,2,1,1,2,9,10,9,-3,1,-1
510,501,496,492,14,17,15,16,1,1,2,1,9,5,4,-3,2,-1
360,360,351,356,17,16,18,16,1,1,3,1,0,9,-5,1,-2,2
792,787,792,796,18,17,18,19,2,1,2,1,5,-5,-4,1,-1,-1
684,684,679,670,13,16,15,16,1,3,3,2,0,5,9,-3,1,-1
665,665,670,670,17,16,18,18,1,2,2,1,0,-5,0,1,-2,0
637,632,637,632,13,14,12,13,1,1,2,2,5,-5,5,-1,2,-1
806,801,796,796,18,19,18,19,2,1,3,1,5,5,0,-1,1,-1
1054,1050,1045,1045,17,16,18,16,2,2,3,1,4,5,0,1,-2,2
220,206,215,206,14,14,13,13,3,1,2,1,14,-9,9,0,1,0
300,295,300,295,18,19,18,19,1,1,2,2,5,-5,5,-1,1,-1
1054,1040,1036,1036,13,16,15,16,2,2,1,1,14,4,0,-3,1,-1
745,736,740,740,17,19,18,18,1,2,2,3,9,-4,0,-2,1,0
754,750,745,745,17,16,18,18,4,1,1,1,4,5,0,1,-2,0
951,951,942,937,13,16,15,16,1,1,2,2,0,9,5,-3,1,-1
356,356,351,351,13,14,12,13,3,3,1,1,0,5,0,-1,2,-1
806,792,782,782,21,19,21,19,1,1,1,1,14,10,0,2,-2,2
754,745,745,745,13,14,12,13,1,2,1,1,9,0,0,-1,2,-1
674,674,670,670,13,14,12,13,1,3,1,1,0,4,0,-1,2,-1
286,281,281,281,18,19,18,19,1,2,2,1,5,0,0,-1,1,-1
510,510,506,506,14,14,15,13,4,1,1,2,0,4,0,0,-1,2
684,665,656,660,13,14,12,13,1,3,2,3,19,9,-4,-1,2,-1
243,239,243,243,14,14,13,13,1,2,1,1,4,-4,0,0,1,0
201,196,201,196,14,14,15,13,2,2,1,1,5,-5,5,0,-1,2
942,937,942,937,13,14,15,13,1,2,2,2,5,-5,5,-1,-1,2
1050,1045,1040,1040,17,16,15,16,4,1,3,2,5,5,0,1,1,-1
314,309,309,314,21,19,21,21,4,2,1,1,5,0,-5,2,-2,0
623,609,637,614,14,14,15,13,1,2,2,2,14,-28,23,0,-1,2
679,670,670,670,13,16,15,16,1,3,2,1,9,0,0,-3,1,-1
257,257,253,248,14,17,15,16,3,1,1,2,0,4,5,-3,2,-1
276,267,271,262,18,19,18,18,3,1,4,2,9,-4,9,-1,1,0
778,768,773,778,13,14,12,13,1,2,4,1,10,-5,-5,-1,2,-1
712,703,707,703,20,19,20,21,2,2,3,3,9,-4,4,1,-1,-1
665,660,665,660,13,14,15,16,3,2,2,1,5,-5,5,-1,-1,-1
403,398,393,393,20,19,20,18,3,1,2,3,5,5,0,1,-1,2
337,332,328,328,20,19,18,19,2,1,1,1,5,4,0,1,1,-1
946,942,937,932,13,14,15,16,2,1,2,1,4,5,5,-1,-1,-1
562,557,557,557,18,19,18,18,3,1,1,1,5,0,0,-1,1,0
562,557,557,557,14,14,15,13,1,3,3,1,5,0,0,0,-1,2
886,881,881,881,14,14,13,13,1,1,2,3,5,0,0,0,1,0
1012,1012,1012,1012,20,19,18,18,2,1,1,3,0,0,0,1,1,0
956,951,965,951,13,14,12,13,2,2,1,2,5,-14,14,-1,2,-1
196,196,192,192,14,14,15,13,2,1,3,1,0,4,0,0,-1,2
567,553,548,543,18,17,18,16,4,2,2,1,14,5,5,1,-1,2
586,581,576,571,18,17,18,18,1,1,3,2,5,5,5,1,-1,0
829,820,820,820,14,14,15,13,3,2,3,3,9,0,0,0,-1,2
300,300,304,300,14,17,15,16,2,3,1,2,0,-4,4,-3,2,-1
806,801,801,796,14,17,15,16,2,2,2,2,5,0,5,-3,2,-1
360,360,356,356,20,19,20,18,4,1,2,1,0,4,0,1,-1,2
876,876,871,867,14,17,15,16,2,3,1,2,0,5,4,-3,2,-1
862,853,853,853,14,14,13,13,1,2,1,1,9,0,0,0,1,0
492,487,482,482,21,19,21,19,2,1,1,1,5,5,0,2,-2,2
290,286,281,276,14,14,15,13,2,1,3,2,4,5,5,0,-1,2
693,684,684,684,13,14,12,13,1,2,1,1,9,0,0,-1,2,-1
660,656,651,646,13,14,12,13,1,3,2,1,4,5,5,-1,2,-1
539,529,548,548,18,19,18,18,1,2,2,2,10,-19,0,-1,1,0
304,300,304,300,14,14,13,13,2,1,1,2,4,-4,4,0,1,0
979,965,970,965,20,19,20,21,4,2,1,2,14,-5,5,1,-1,-1
750,750,745,750,13,16,15,16,2,2,1,1,0,5,-5,-3,1,-1
914,904,900,900,14,14,13,13,2,1,2,1,10,4,0,0,1,0
459,450,445,445,13,14,15,16,2,3,1,1,9,5,0,-1,-1,-1
979,970,965,970,13,14,15,16,1,1,1,1,9,5,-5,-1,-1,-1
314,318,314,314,18,17,18,19,3,1,2,1,-4,4,0,1,-1,-1
370,360,356,356,13,14,12,13,2,6,1,3,10,4,0,-1,2,-1
834,829,829,824,18,17,18,19,1,2,3,2,5,0,5,1,-1,-1
374,360,351,346,13,14,12,13,1,2,3,1,14,9,5,-1,2,-1
1021,1017,1021,1017,17,19,18,18,3,1,1,1,4,-4,4,-2,1,0
1012,1012,1007,1012,13,14,12,13,1,3,1,1,0,5,-5,-1,2,-1
1078,1073,1073,1068,20,19,18,18,1,1,1,3,5,0,5,1,1,0
1045,1040,1040,1040,20,19,20,21,3,2,1,1,5,0,0,1,-1,-1
895,890,886,886,14,17,15,16,2,1,1,3,5,4,0,-3,2,-1
515,506,492,492,14,14,13,13,1,3,3,3,9,14,0,0,1,0
904,862,862,857,14,14,15,16,1,4,1,2,42,0,5,0,-1,-1
960,946,946,942,13,14,12,13,1,2,1,1,14,0,4,-1,2,-1
1059,1045,1050,1054,13,14,12,13,3,4,3,1,14,-5,-4,-1,2,-1
609,604,604,604,18,17,18,16,2,1,2,1,5,0,0,1,-1,2
304,295,304,309,14,14,13,13,2,2,1,3,9,-9,-5,0,1,0
759,750,750,754,13,14,12,13,4,2,3,1,9,0,-4,-1,2,-1
665,660,656,660,13,14,12,13,1,2,5,1,5,4,-4,-1,2,-1
543,543,539,539,18,17,18,18,3,3,1,1,0,4,0,1,-1,0
210,206,206,201,18,17,15,16,2,1,2,1,4,0,5,1,2,-1
267,267,267,257,18,17,18,16,2,2,2,2,0,0,10,1,-1,2
304,276,276,271,14,14,15,13,1,1,4,1,28,0,5,0,-1,2
993,984,979,974,13,14,15,13,3,2,3,2,9,5,5,-1,-1,2
253,248,248,248,14,14,15,13,1,3,2,1,5,0,0,0,-1,2
642,637,632,623,13,14,13,13,4,3,1,2,5,5,9,-1,1,0
918,914,909,909,21,19,21,19,1,3,1,1,4,5,0,2,-2,2
478,473,473,482,17,16,18,16,1,2,1,1,5,0,-9,1,-2,2
581,571,571,567,21,19,20,18,1,1,1,2,10,0,4,2,-1,2
234,234,229,229,18,19,18,19,3,2,1,2,0,5,0,-1,1,-1
900,895,890,895,14,17,15,16,2,1,1,1,5,5,-5,-3,2,-1
979,970,970,960,13,14,15,13,1,3,1,2,9,0,10,-1,-1,2
182,182,1078,1078,18,17,18,18,2,1,1,1,0,-896,0,1,-1,0
876,871,876,876,18,19,18,18,2,1,1,1,5,-5,0,-1,1,0
923,928,928,928,21,19,21,19,2,1,1,1,-5,0,0,2,-2,2
806,792,796,792,18,19,18,19,1,2,2,1,14,-4,4,-1,1,-1
923,914,914,909,18,17,18,16,2,3,2,2,9,0,5,1,-1,2
253,248,248,248,18,19,18,18,2,2,2,1,5,0,0,-1,1,0
576,571,571,571,14,14,13,13,1,1,1,3,5,0,0,0,1,0
679,679,674,679,17,16,15,16,1,3,1,1,0,5,-5,1,1,-1
389,384,384,384,13,16,15,16,2,1,1,1,5,0,0,-3,1,-1
881,881,886,876,18,17,18,18,1,2,2,1,0,-5,10,1,-1,0
210,201,210,206,18,19,18,19,1,2,4,2,9,-9,4,-1,1,-1
1064,1059,1059,1059,13,14,15,16,3,2,2,3,5,0,0,-1,-1,-1
576,567,567,567,14,14,15,16,1,2,1,3,9,0,0,0,-1,-1
1036,1036,1036,1036,13,16,15,16,1,1,1,2,0,0,0,-3,1,-1
393,389,384,389,17,16,15,16,1,2,3,2,4,5,-5,1,1,-1
759,754,750,754,13,16,15,16,1,3,3,1,5,4,-4,-3,1,-1
646,646,646,646,20,19,20,21,1,3,1,2,0,0,0,1,-1,-1
993,989,993,984,20,19,20,18,3,2,2,2,4,-4,9,1,-1,2
220,210,210,210,18,17,18,16,2,2,1,1,10,0,0,1,-1,2
281,276,281,281,21,19,20,21,2,2,1,1,5,-5,0,2,-1,-1
431,426,426,421,20,19,20,21,1,2,2,2,5,0,5,1,-1,-1
614,604,609,604,14,14,15,16,1,2,2,1,10,-5,5,0,-1,-1
651,646,642,642,17,16,18,16,2,1,1,2,5,4,0,1,-2,2
674,670,674,674,13,14,15,13,1,2,2,2,4,-4,0,-1,-1,2
886,881,886,914,18,19,20,19,4,2,2,1,5,-5,-28,-1,-1,1
806,796,801,801,21,19,21,21,2,2,1,1,10,-5,0,2,-2,0
487,487,487,487,14,14,13,13,1,3,2,1,0,0,0,0,1,0
365,360,356,356,17,16,18,18,2,2,1,4,5,4,0,1,-2,0
778,773,773,773,20,19,20,18,2,1,1,1,5,0,0,1,-1,2
492,487,487,487,14,14,15,16,3,1,1,2,5,0,0,0,-1,-1
717,712,712,712,20,19,18,18,2,5,1,1,5,0,0,1,1,0
881,871,871,871,14,14,15,13,2,3,2,2,10,0,0,0,-1,2
886,881,881,876,14,14,13,13,3,3,2,2,5,0,5,0,1,0
656,646,646,642,13,14,15,16,1,2,2,1,10,0,4,-1,-1,-1
440,436,436,440,13,14,12,13,1,2,2,2,4,0,-4,-1,2,-1
792,796,792,792,18,19,18,19,4,2,1,1,-4,4,0,-1,1,-1
356,356,351,351,17,16,18,18,1,1,3,1,0,5,0,1,-2,0
679,665,656,712,13,14,15,11,3,3,1,1,14,9,-56,-1,-1,4
318,318,318,318,14,17,15,16,1,1,1,1,0,0,0,-3,2,-1
389,370,365,360,13,14,12,13,3,1,3,1,19,5,5,-1,2,-1
571,562,553,557,14,14,15,16,1,3,3,3,9,9,-4,0,-1,-1
1007,1007,1007,1003,13,14,15,13,1,3,2,1,0,0,4,-1,-1,2
281,281,281,281,21,19,20,21,2,2,1,1,0,0,0,2,-1,-1
731,721,717,717,13,14,12,13,4,4,1,3,10,4,0,-1,2,-1
773,773,773,768,13,14,15,13,1,3,2,2,0,0,5,-1,-1,2
923,923,918,918,14,14,13,13,2,1,1,2,0,5,0,0,1,0
210,210,206,201,21,19,20,19,2,2,1,1,0,4,5,2,-1,1
576,571,571,571,14,14,13,13,1,4,2,2,5,0,0,0,1,0
1045,1040,1036,1036,20,19,20,21,2,1,2,1,5,4,0,1,-1,-1
684,679,679,679,17,16,18,18,3,1,3,1,5,0,0,1,-2,0
623,623,618,618,18,19,18,19,2,2,1,3,0,5,0,-1,1,-1
243,239,239,239,21,19,20,21,3,1,1,1,4,0,0,2,-1,-1
234,224,224,224,14,14,13,13,1,6,2,2,10,0,0,0,1,0
314,309,309,304,14,17,15,16,3,2,1,2,5,0,5,-3,2,-1
342,337,342,337,17,16,15,16,1,4,2,1,5,-5,5,1,1,-1
468,464,464,468,20,19,20,21,2,1,1,1,4,0,-4,1,-1,-1
820,810,801,796,21,19,21,21,1,1,1,1,10,9,5,2,-2,0
960,956,951,946,17,16,15,16,1,2,3,3,4,5,5,1,1,-1
684,679,679,679,20,19,20,18,3,2,1,1,5,0,0,1,-1,2
431,426,421,417,20,19,20,18,2,2,1,2,5,5,4,1,-1,2
440,431,431,431,13,14,12,13,2,2,2,3,9,0,0,-1,2,-1
717,717,717,717,20,19,20,18,1,1,1,1,0,0,0,1,-1,2
810,801,796,801,14,14,15,13,3,2,1,1,9,5,-5,0,-1,2
421,417,431,436,17,19,18,16,1,3,3,3,4,-14,-5,-2,1,2
459,454,454,450,17,16,18,18,3,2,3,2,5,0,4,1,-2,0
707,693,693,689,20,19,20,21,1,1,2,2,14,0,4,1,-1,-1
557,553,557,548,14,17,15,16,1,2,4,1,4,-4,9,-3,2,-1
876,871,871,871,14,17,15,16,2,3,1,1,5,0,0,-3,2,-1
656,642,642,646,13,14,15,13,3,2,1,2,14,0,-4,-1,-1,2
867,867,862,276,18,17,18,13,2,3,2,1,0,5,586,1,-1,5
374,374,379,379,20,19,20,21,1,3,2,1,0,-5,0,1,-1,-1
426,412,421,421,20,19,20,18,2,2,1,1,14,-9,0,1,-1,2
829,829,829,824,14,14,13,13,2,3,2,2,0,0,5,0,1,0
1026,1021,1021,1017,20,19,20,21,1,3,1,2,5,0,4,1,-1,-1
548,534,539,539,14,14,15,13,1,2,3,3,14,-5,0,0,-1,2
642,632,628,623,20,19,21,19,1,1,1,2,10,4,5,1,-2,2
581,576,571,571,18,17,15,16,1,3,2,1,5,5,0,1,2,-1
984,984,984,984,17,16,18,16,1,1,1,1,0,0,0,1,-2,2
314,314,314,309,18,17,18,19,2,1,1,1,0,0,5,1,-1,-1
609,604,604,600,18,17,18,19,1,3,3,1,5,0,4,1,-1,-1
946,586,581,586,13,14,15,16,1,3,2,5,360,5,-5,-1,-1,-1
703,703,698,698,13,14,15,13,1,2,1,2,0,5,0,-1,-1,2
553,543,543,543,14,17,15,16,2,2,1,1,10,0,0,-3,2,-1
810,801,806,806,14,17,15,16,1,2,2,1,9,-5,0,-3,2,-1
665,665,660,660,13,14,12,13,1,2,1,1,0,5,0,-1,2,-1
210,206,206,206,14,17,15,16,2,2,2,3,4,0,0,-3,2,-1
660,651,651,656,17,16,15,16,1,2,1,2,9,0,-5,1,1,-1
890,890,886,890,21,19,20,19,1,1,1,3,0,4,-4,2,-1,1
974,970,960,960,20,19,20,18,2,1,1,1,4,10,0,1,-1,2
492,492,492,492,14,14,13,13,2,2,1,2,0,0,0,0,1,0
524,524,524,515,14,14,15,13,2,1,1,3,0,0,9,0,-1,2
510,520,515,515,14,14,15,13,4,2,1,1,-10,5,0,0,-1,2
824,810,815,815,18,17,18,19,2,2,1,1,14,-5,0,1,-1,-1
937,932,932,937,13,14,15,13,2,2,1,1,5,0,-5,-1,-1,2
210,210,210,206,18,17,18,19,2,1,2,1,0,0,4,1,-1,-1
267,257,262,257,14,17,15,16,1,5,2,2,10,-5,5,-3,2,-1
492,482,473,478,18,19,18,18,1,1,1,1,10,9,-5,-1,1,0
665,660,660,656,13,14,15,13,1,2,1,2,5,0,4,-1,-1,2
881,876,881,876,14,17,15,16,1,3,1,1,5,-5,5,-3,2,-1
300,300,300,300,14,14,15,13,1,3,4,1,0,0,0,0,-1,2
642,632,637,632,13,14,15,13,2,1,2,1,10,-5,5,-1,-1,2
960,956,956,956,17,16,15,16,2,3,1,1,4,0,0,1,1,-1
239,239,239,239,21,19,20,21,2,2,1,1,0,0,0,2,-1,-1
328,323,318,314,18,17,18,16,1,3,1,2,5,5,4,1,-1,2
951,946,946,946,13,16,15,16,1,2,1,2,5,0,0,-3,1,-1
239,234,234,229,18,17,18,19,1,2,1,2,5,0,5,1,-1,-1
243,243,248,243,14,14,15,13,3,5,2,1,0,-5,5,0,-1,2
304,300,300,300,21,19,20,19,1,1,2,1,4,0,0,2,-1,1
196,192,192,187,18,17,18,19,1,3,2,1,4,0,5,1,-1,-1
318,314,309,309,14,14,15,16,2,3,1,1,4,5,0,0,-1,-1
604,600,595,590,14,14,13,13,1,1,2,1,4,5,5,0,1,0
1050,1040,220,1036,13,14,13,13,2,3,1,2,10,820,-816,-1,1,0
670,670,665,665,13,14,15,13,1,3,2,1,0,5,0,-1,-1,2
196,192,187,192,14,14,13,13,1,1,1,1,4,5,-5,0,1,0
871,862,862,867,21,19,20,21,3,2,1,1,9,0,-5,2,-1,-1
824,815,815,810,18,19,18,19,1,2,2,1,9,0,5,-1,1,-1
248,248,243,243,14,14,13,13,2,2,3,1,0,5,0,0,1,0
271,271,267,267,14,14,15,13,3,1,2,1,0,4,0,0,-1,2
759,759,754,754,17,16,18,16,1,3,1,1,0,5,0,1,-2,2
839,834,829,824,18,17,18,16,1,3,3,2,5,5,5,1,-1,2
656,651,656,656,20,19,18,18,2,1,2,1,5,-5,0,1,1,0
384,379,379,379,17,16,15,16,2,4,1,1,5,0,0,1,1,-1
839,824,824,820,14,14,13,13,1,3,2,1,15,0,4,0,1,0
290,286,295,290,14,14,13,13,1,2,2,1,4,-9,5,0,1,0
867,862,857,857,14,14,15,13,2,1,3,1,5,5,0,0,-1,2
360,360,356,351,13,14,12,13,3,1,6,1,0,4,5,-1,2,-1
989,984,979,979,20,19,20,21,4,1,3,1,5,5,0,1,-1,-1
524,520,520,520,21,19,20,19,2,2,1,1,4,0,0,2,-1,1
220,224,215,215,14,14,13,13,2,2,1,1,-4,9,0,0,1,0
234,229,229,229,18,17,18,19,2,3,1,1,5,0,0,1,-1,-1
553,548,548,543,14,14,13,13,2,2,2,2,5,0,5,0,1,0
815,815,806,810,14,17,15,16,3,3,1,1,0,9,-4,-3,2,-1
478,468,468,464,17,16,15,16,1,2,3,2,10,0,4,1,1,-1
496,492,492,487,14,17,15,16,1,5,2,3,4,0,5,-3,2,-1
374,365,370,360,13,16,15,16,1,2,2,2,9,-5,10,-3,1,-1
421,417,417,407,20,19,20,21,2,1,2,1,4,0,10,1,-1,-1
834,824,824,824,14,17,15,16,2,1,1,1,10,0,0,-3,2,-1
487,482,478,478,14,14,13,13,2,2,1,1,5,4,0,0,1,0
262,257,253,253,21,19,20,18,3,1,2,1,5,4,0,2,-1,2
229,229,229,224,14,17,15,16,2,1,1,2,0,0,5,-3,2,-1
792,787,787,787,14,17,15,16,3,2,1,1,5,0,0,-3,2,-1
201,196,192,192,14,17,15,16,3,1,1,1,5,4,0,-3,2,-1
904,895,900,895,18,19,18,19,1,1,2,2,9,-5,5,-1,1,-1
576,567,562,557,18,17,18,16,1,1,2,1,9,5,5,1,-1,2
698,689,689,684,20,19,20,18,2,3,1,2,9,0,5,1,-1,2
379,370,370,370,13,14,12,13,2,2,1,2,9,0,0,-1,2,-1
698,693,689,689,13,14,15,16,1,2,1,1,5,4,0,-1,-1,-1
215,206,210,210,21,19,20,19,3,1,1,1,9,-4,0,2,-1,1
539,539,534,529,18,17,18,19,1,4,2,1,0,5,5,1,-1,-1
510,506,501,496,18,19,18,19,1,3,1,2,4,5,5,-1,1,-1
328,323,323,318,14,17,15,16,1,1,1,2,5,0,5,-3,2,-1
717,703,707,707,13,14,15,13,3,2,1,1,14,-4,0,-1,-1,2
295,290,290,290,18,19,18,19,3,2,1,3,5,0,0,-1,1,-1
548,534,539,529,14,14,13,13,1,2,2,2,14,-5,10,0,1,0
839,834,834,834,14,14,15,13,3,3,2,1,5,0,0,0,-1,2
276,271,267,267,18,17,18,16,1,3,1,3,5,4,0,1,-1,2
539,539,539,539,14,14,15,13,2,2,1,1,0,0,0,0,-1,2
642,637,632,632,20,19,18,18,1,2,1,1,5,5,0,1,1,0
1068,1064,1064,1064,20,19,20,21,2,2,1,1,4,0,0,1,-1,-1
468,450,454,450,13,14,15,13,2,2,2,1,18,-4,4,-1,-1,2
468,473,468,473,20,19,20,21,1,3,1,1,-5,5,-5,1,-1,-1
374,370,370,370,17,16,15,16,3,2,2,1,4,0,0,1,1,-1
534,529,524,524,18,19,18,19,1,3,1,1,5,5,0,-1,1,-1
698,684,684,684,13,14,15,13,1,5,2,1,14,0,0,-1,-1,2
1003,998,1007,1007,20,19,20,21,2,3,2,1,5,-9,0,1,-1,-1
318,314,314,314,14,17,15,16,2,3,3,2,4,0,0,-3,2,-1
501,496,496,496,14,17,15,16,2,2,2,1,5,0,0,-3,2,-1
229,224,220,220,18,17,18,19,1,3,2,1,5,4,0,1,-1,-1
421,417,412,412,13,14,15,13,1,3,2,2,4,5,0,-1,-1,2
759,754,759,754,20,19,20,18,3,2,1,1,5,-5,5,1,-1,2
323,318,318,318,18,17,18,19,1,3,1,1,5,0,0,1,-1,-1
412,398,412,403,20,19,20,18,3,2,2,2,14,-14,9,1,-1,2
1031,1031,1026,1021,20,19,20,21,3,5,2,2,0,5,5,1,-1,-1
787,778,778,778,18,19,18,18,1,1,1,1,9,0,0,-1,1,0
187,187,1078,1078,14,14,13,13,1,1,1,1,0,-891,0,0,1,0
928,918,918,923,21,19,21,21,1,2,2,1,10,0,-5,2,-2,0
1007,998,993,1003,13,14,12,13,2,1,1,1,9,5,-10,-1,2,-1
365,351,351,351,13,14,15,13,3,2,1,1,14,0,0,-1,-1,2
586,567,571,571,18,19,18,18,2,2,2,1,19,-4,0,-1,1,0
736,731,721,721,13,14,12,13,3,2,1,1,5,10,0,-1,2,-1
520,496,501,501,14,14,13,13,3,2,1,1,24,-5,0,0,1,0
932,923,923,923,13,17,15,16,1,2,1,2,9,0,0,-4,2,-1
923,914,909,904,14,14,15,13,1,3,1,2,9,5,5,0,-1,2
379,370,374,374,13,14,12,13,2,1,2,1,9,-4,0,-1,2,-1
220,210,210,210,14,14,15,13,2,3,1,1,10,0,0,0,-1,2
801,792,787,787,14,14,13,13,3,2,1,1,9,5,0,0,1,0
304,304,304,300,21,19,20,19,2,3,1,1,0,0,4,2,-1,1
923,923,923,923,14,14,15,13,3,2,3,2,0,0,0,0,-1,2
881,871,876,876,14,17,15,16,1,3,2,2,10,-5,0,-3,2,-1
1064,1059,1054,1059,13,16,15,16,1,2,1,1,5,5,-5,-3,1,-1
867,867,871,871,14,14,15,13,2,2,3,1,0,-4,0,0,-1,2
778,773,768,773,13,14,12,13,1,1,1,3,5,5,-5,-1,2,-1
900,886,876,871,14,14,15,13,1,3,1,3,14,10,5,0,-1,2
543,539,539,539,18,19,18,18,3,1,3,1,4,0,0,-1,1,0
670,665,665,660,20,19,18,18,1,1,2,2,5,0,5,1,1,0
703,693,689,689,13,14,15,13,1,3,1,2,10,4,0,-1,-1,2
796,787,787,787,14,17,15,16,2,3,2,3,9,0,0,-3,2,-1
436,440,436,436,13,14,15,13,1,3,2,3,-4,4,0,-1,-1,2
351,342,337,337,17,16,15,16,2,1,2,1,9,5,0,1,1,-1
970,323,965,970,13,14,12,13,1,1,3,1,647,-642,-5,-1,2,-1
309,304,300,295,14,14,13,13,3,4,1,2,5,4,5,0,1,0
703,689,689,689,17,16,18,18,2,2,1,2,14,0,0,1,-2,0
417,412,407,412,13,14,12,13,2,1,3,3,5,5,-5,-1,2,-1
473,464,473,482,13,14,12,13,1,3,2,2,9,-9,-9,-1,2,-1
529,520,520,520,18,19,18,19,3,2,2,1,9,0,0,-1,1,-1
918,909,909,904,18,19,18,19,2,2,1,4,9,0,5,-1,1,-1
1068,1059,1059,1059,13,14,15,13,2,3,2,1,9,0,0,-1,-1,2
867,857,853,853,18,17,18,18,1,1,1,2,10,4,0,1,-1,0
314,309,304,300,14,14,15,13,1,3,1,2,5,5,4,0,-1,2
857,853,853,848,18,19,18,18,1,3,2,1,4,0,5,-1,1,0
318,318,314,314,18,19,18,19,1,3,1,1,0,4,0,-1,1,-1
1050,1045,1040,1040,20,19,20,18,2,1,1,2,5,5,0,1,-1,2
571,567,562,562,18,19,18,18,1,1,3,1,4,5,0,-1,1,0
820,820,824,824,21,19,20,21,6,1,1,2,0,-4,0,2,-1,-1
815,810,806,806,18,19,18,19,2,2,1,1,5,4,0,-1,1,-1
379,374,370,370,13,14,15,13,1,1,1,1,5,4,0,-1,-1,2
1007,1003,1003,1003,13,14,15,13,1,4,1,1,4,0,0,-1,-1,2
768,764,759,759,13,16,15,16,2,1,3,2,4,5,0,-3,1,-1
403,398,403,407,17,16,15,16,2,1,1,1,5,-5,-4,1,1,-1
248,239,239,243,21,19,20,21,1,3,1,1,9,0,-4,2,-1,-1
304,290,290,286,14,14,13,13,3,1,2,3,14,0,4,0,1,0
262,248,248,248,18,19,18,18,3,2,1,1,14,0,0,-1,1,0
431,407,412,407,13,14,12,13,1,2,2,2,24,-5,5,-1,2,-1
1021,1012,1007,1003,13,14,15,13,3,1,1,1,9,5,4,-1,-1,2
646,632,628,623,20,19,21,21,4,2,1,2,14,4,5,1,-2,0
848,839,839,839,14,14,15,16,1,3,1,4,9,0,0,0,-1,-1
337,332,328,323,13,14,15,13,2,1,1,2,5,4,5,-1,-1,2
206,196,196,196,21,19,21,21,1,3,1,2,10,0,0,2,-2,0
731,731,731,726,20,19,20,18,3,2,2,1,0,0,5,1,-1,2
1054,1050,1054,1050,17,16,15,16,2,1,3,1,4,-4,4,1,1,-1
318,314,314,309,14,14,13,13,1,2,2,2,4,0,5,0,1,0
473,468,473,468,17,16,18,18,1,3,2,1,5,-5,5,1,-2,0
215,206,206,267,14,14,15,11,1,2,2,1,9,0,-61,0,-1,4
946,946,956,956,13,14,15,13,1,2,3,1,0,-10,0,-1,-1,2
215,215,215,210,18,17,18,19,2,1,2,1,0,0,5,1,-1,-1
604,595,600,609,14,14,15,13,1,1,2,1,9,-5,-9,0,-1,2
670,665,670,660,17,16,18,18,3,3,2,3,5,-5,10,1,-2,0
229,229,220,224,14,14,15,13,1,1,3,1,0,9,-4,0,-1,2
243,239,234,234,14,14,15,13,2,3,2,1,4,5,0,0,-1,2
360,351,346,351,13,14,15,16,1,3,3,1,9,5,-5,-1,-1,-1
824,824,824,824,14,17,15,16,2,2,1,1,0,0,0,-3,2,-1
834,829,824,824,14,14,15,13,1,2,1,2,5,5,0,0,-1,2
609,600,600,600,14,14,15,13,2,2,1,2,9,0,0,0,-1,2
623,618,614,614,14,14,13,13,3,3,1,1,5,4,0,0,1,0
464,459,454,454,20,19,20,21,2,1,1,3,5,5,0,1,-1,-1
914,900,900,895,14,14,13,13,5,3,1,2,14,0,5,0,1,0
909,904,904,904,14,17,15,16,1,2,3,3,5,0,0,-3,2,-1
796,792,792,796,21,19,21,19,2,1,1,1,4,0,-4,2,-2,2
370,365,365,365,13,14,15,13,3,2,1,1,5,0,0,-1,-1,2
360,360,356,356,17,16,15,16,3,1,1,1,0,4,0,1,1,-1
1017,1007,1012,1007,13,14,12,13,2,2,2,1,10,-5,5,-1,2,-1
229,224,220,220,18,19,18,19,4,1,2,1,5,4,0,-1,1,-1
637,637,632,632,20,19,20,21,1,1,1,1,0,5,0,1,-1,-1
1017,1012,1007,1007,13,16,15,16,1,2,3,3,5,5,0,-3,1,-1
492,487,492,492,14,17,15,16,1,3,2,3,5,-5,0,-3,2,-1
886,886,881,886,14,14,13,13,2,2,1,1,0,5,-5,0,1,0
459,454,454,454,13,14,12,13,3,2,3,1,5,0,0,-1,2,-1
956,942,942,946,20,19,18,18,4,1,3,3,14,0,-4,1,1,0
328,314,309,309,14,14,13,13,1,3,2,1,14,5,0,0,1,0
506,501,506,506,21,19,20,19,1,2,1,1,5,-5,0,2,-1,1
914,904,904,904,14,14,13,13,1,1,2,1,10,0,0,0,1,0
703,693,829,689,13,14,13,16,2,1,1,1,10,-136,140,-1,1,-3
679,670,670,670,17,19,18,18,3,2,1,1,9,0,0,-2,1,0
1036,1026,1036,1026,13,14,12,13,2,2,2,1,10,-10,10,-1,2,-1
384,379,379,379,13,14,15,13,3,2,3,2,5,0,0,-1,-1,2
370,365,360,360,17,16,18,18,1,1,1,1,5,5,0,1,-2,0
1031,1026,1021,1021,13,14,12,13,2,1,1,2,5,5,0,-1,2,-1
314,314,314,309,14,14,15,16,3,2,2,1,0,0,5,0,-1,-1
192,187,187,182,14,14,13,13,2,3,1,1,5,0,5,0,1,0
431,426,431,426,20,19,20,21,1,1,3,1,5,-5,5,1,-1,-1
918,914,914,909,18,19,18,19,4,1,2,1,4,0,5,-1,1,-1
778,773,778,778,13,14,13,13,2,2,1,1,5,-5,0,-1,1,0
792,782,778,773,14,14,15,13,2,2,1,1,10,4,5,0,-1,2
829,824,820,820,14,17,15,16,3,3,1,1,5,4,0,-3,2,-1
684,674,679,679,20,19,20,18,1,3,2,1,10,-5,0,1,-1,2
726,717,717,712,17,19,18,18,1,1,1,2,9,0,5,-2,1,0
909,904,904,904,18,19,18,19,2,1,1,1,5,0,0,-1,1,-1
318,314,309,309,14,14,13,13,1,2,2,2,4,5,0,0,1,0
543,539,539,534,18,19,18,18,1,1,2,3,4,0,5,-1,1,0
318,314,318,323,21,19,21,19,2,2,1,1,4,-4,-5,2,-2,2
632,623,618,614,13,14,13,13,1,2,2,1,9,5,4,-1,1,0
918,904,904,900,14,17,15,16,4,1,1,2,14,0,4,-3,2,-1
534,539,534,529,21,19,20,21,2,3,1,2,-5,5,5,2,-1,-1
848,843,843,839,14,17,15,16,4,3,1,2,5,0,4,-3,2,-1
374,374,370,567,20,19,20,16,2,4,3,1,0,4,-197,1,-1,4
342,332,337,337,13,14,12,13,3,2,2,1,10,-5,0,-1,2,-1
1031,1026,1021,1021,13,16,15,16,2,1,1,1,5,5,0,-3,1,-1
796,792,787,782,21,19,21,21,6,1,1,2,4,5,5,2,-2,0
604,604,604,604,21,19,20,21,2,2,2,1,0,0,0,2,-1,-1
539,534,539,553,21,19,20,21,4,1,1,1,5,-5,-14,2,-1,-1
393,389,389,389,17,16,15,16,3,1,1,1,4,0,0,1,1,-1
689,689,684,684,20,19,20,21,2,1,3,1,0,5,0,1,-1,-1
267,243,234,234,14,14,15,13,3,1,2,1,24,9,0,0,-1,2
712,712,712,712,20,19,20,21,3,1,1,1,0,0,0,1,-1,-1
290,290,290,281,14,17,15,16,2,3,2,2,0,0,9,-3,2,-1
309,300,286,286,14,14,13,13,2,3,3,2,9,14,0,0,1,0
543,543,548,543,18,19,18,18,3,2,2,1,0,-5,5,-1,1,0
670,674,717,670,13,14,15,13,3,2,3,2,-4,-43,47,-1,-1,2
515,515,515,515,14,14,13,13,1,4,1,3,0,0,0,0,1,0
590,586,586,586,14,14,15,13,1,2,1,3,4,0,0,0,-1,2
768,768,764,764,20,19,18,18,2,1,1,1,0,4,0,1,1,0
337,342,332,337,13,14,13,13,3,3,1,1,-5,10,-5,-1,1,0
965,965,960,960,17,16,18,18,3,3,1,2,0,5,0,1,-2,0
224,220,215,215,14,14,15,13,3,1,1,1,4,5,0,0,-1,2
374,374,374,370,17,16,18,16,3,3,2,1,0,0,4,1,-2,2
431,421,421,426,17,16,18,16,2,1,1,1,10,0,-5,1,-2,2
820,801,796,792,18,17,18,16,1,3,2,1,19,5,4,1,-1,2
398,398,393,393,20,19,20,18,3,1,2,1,0,5,0,1,-1,2
487,473,473,473,14,14,15,13,1,2,1,2,14,0,0,0,-1,2
557,553,548,548,18,17,18,18,3,4,1,1,4,5,0,1,-1,0
956,951,951,951,20,19,20,18,2,2,1,1,5,0,0,1,-1,2
867,857,853,853,14,14,15,16,1,2,3,1,10,4,0,0,-1,-1
534,520,524,524,14,14,15,13,1,3,2,1,14,-4,0,0,-1,2
768,764,764,759,20,19,18,18,3,2,1,1,4,0,5,1,1,0
923,914,918,918,14,14,15,13,1,3,4,1,9,-4,0,0,-1,2
501,492,543,571,18,19,18,18,1,3,3,1,9,-51,-28,-1,1,0
937,932,928,928,17,16,18,16,2,1,2,1,5,4,0,1,-2,2
745,740,740,740,13,14,15,13,1,2,1,1,5,0,0,-1,-1,2
510,501,506,496,14,14,13,13,1,1,2,3,9,-5,10,0,1,0
1007,1003,1012,1012,17,19,18,18,1,1,1,1,4,-9,0,-2,1,0
417,417,412,412,20,19,20,21,1,3,1,2,0,5,0,1,-1,-1
867,862,862,867,14,14,13,13,3,2,1,3,5,0,-5,0,1,0
853,848,848,839,18,19,18,18,1,3,2,2,5,0,9,-1,1,0
548,539,534,524,14,14,13,13,2,2,1,2,9,5,10,0,1,0
215,215,215,210,18,17,18,16,3,2,1,2,0,0,5,1,-1,2
1059,1054,1054,1050,13,16,15,16,2,1,2,1,5,0,4,-3,1,-1
726,721,721,721,13,16,15,16,1,1,1,1,5,0,0,-3,1,-1
895,890,886,876,18,17,18,18,1,1,1,2,5,4,10,1,-1,0
871,867,867,867,18,17,18,16,2,2,1,1,4,0,0,1,-1,2
768,759,764,759,13,14,15,13,2,2,3,2,9,-5,5,-1,-1,2
721,712,712,712,20,19,18,18,2,1,2,3,9,0,0,1,1,0
468,464,464,459,13,14,12,13,3,2,2,1,4,0,5,-1,2,-1
956,956,960,956,20,19,20,21,1,2,2,3,0,-4,4,1,-1,-1
473,464,464,464,17,19,18,18,2,2,3,1,9,0,0,-2,1,0
267,271,262,262,21,19,20,21,4,2,1,2,-4,9,0,2,-1,-1
187,187,187,182,14,14,13,13,1,1,2,2,0,0,5,0,1,0
234,229,224,224,18,17,18,19,2,3,1,1,5,5,0,1,-1,-1
300,281,286,281,14,17,15,16,1,3,2,1,19,-5,5,-3,2,-1
215,210,224,215,14,17,15,16,1,2,4,1,5,-14,9,-3,2,-1
586,586,586,581,18,19,18,19,3,3,2,2,0,0,5,-1,1,-1
239,248,239,239,18,17,18,16,1,1,2,1,-9,9,0,1,-1,2
548,543,539,543,14,14,13,13,1,3,1,3,5,4,-4,0,1,0
670,660,665,660,13,14,15,13,2,2,2,1,10,-5,5,-1,-1,2
951,946,942,946,17,16,15,16,3,2,3,1,5,4,-4,1,1,-1
857,853,857,853,14,14,15,16,1,2,2,3,4,-4,4,0,-1,-1
862,857,853,848,18,19,18,18,2,1,2,1,5,4,5,-1,1,0
314,309,314,309,14,17,15,16,1,2,3,2,5,-5,5,-3,2,-1
632,632,623,623,13,14,15,13,1,1,2,2,0,9,0,-1,-1,2
829,806,806,806,14,14,13,13,1,3,3,3,23,0,0,0,1,0
304,300,300,300,14,14,15,13,2,3,3,1,4,0,0,0,-1,2
750,740,745,745,13,14,15,13,1,6,2,1,10,-5,0,-1,-1,2
923,923,918,918,18,17,18,16,2,1,3,1,0,5,0,1,-1,2
600,595,600,604,18,17,18,19,2,2,2,1,5,-5,-4,1,-1,-1
215,196,210,206,18,17,18,19,1,2,3,1,19,-14,4,1,-1,-1
328,314,309,309,14,14,13,13,1,4,3,1,14,5,0,0,1,0
262,257,257,253,21,19,20,18,1,2,2,1,5,0,4,2,-1,2
543,539,529,534,14,14,13,13,3,4,1,1,4,10,-5,0,1,0
346,346,346,342,13,14,12,13,1,3,1,3,0,0,4,-1,2,-1
253,239,243,243,18,17,18,18,3,2,3,1,14,-4,0,1,-1,0
632,623,618,618,17,17,18,16,1,1,3,2,9,5,0,0,-1,2
196,192,192,182,14,14,13,13,2,1,2,2,4,0,10,0,1,0
717,707,707,703,20,19,20,21,1,2,1,2,10,0,4,1,-1,-1
792,787,787,792,18,17,18,19,3,2,1,3,5,0,-5,1,-1,-1
679,660,660,670,13,14,15,13,1,2,2,1,19,0,-10,-1,-1,2
543,524,520,520,14,17,15,16,3,1,1,1,19,4,0,-3,2,-1
895,890,890,886,21,19,20,19,1,1,1,2,5,0,4,2,-1,1
337,337,337,332,17,19,18,18,1,1,1,1,0,0,5,-2,1,0
407,398,398,398,13,14,15,16,1,2,1,2,9,0,0,-1,-1,-1
206,206,206,201,18,19,18,19,2,3,1,2,0,0,5,-1,1,-1
576,567,571,567,18,19,18,18,1,2,2,1,9,-4,4,-1,1,0
848,848,848,843,18,19,18,18,2,3,1,1,0,0,5,-1,1,0
581,567,557,557,14,14,15,13,1,3,1,3,14,10,0,0,-1,2
440,436,440,454,13,14,12,13,1,2,3,1,4,-4,-14,-1,2,-1
867,853,848,843,14,14,13,13,4,2,3,2,14,5,5,0,1,0
1021,1021,1017,1017,13,14,12,13,1,2,1,3,0,4,0,-1,2,-1
876,867,862,862,14,17,15,16,2,1,2,1,9,5,0,-3,2,-1
286,281,281,276,14,17,15,16,1,3,1,1,5,0,5,-3,2,-1
693,689,693,689,13,16,15,16,2,2,1,1,4,-4,4,-3,1,-1
632,637,637,632,20,19,20,18,1,1,2,1,-5,0,5,1,-1,2
773,764,759,754,13,14,12,13,1,4,3,1,9,5,5,-1,2,-1
562,562,562,562,14,14,13,13,2,3,1,1,0,0,0,0,1,0
965,960,960,960,20,19,20,18,1,2,1,1,5,0,0,1,-1,2
1040,1031,1036,1031,17,16,15,16,2,6,1,2,9,-5,5,1,1,-1
590,539,543,548,14,14,15,16,3,3,2,1,51,-4,-5,0,-1,-1
810,796,801,801,18,17,18,16,3,2,2,1,14,-5,0,1,-1,2
632,637,632,637,17,16,18,16,1,1,1,1,-5,5,-5,1,-2,2
904,904,900,900,18,17,18,19,1,1,1,1,0,4,0,1,-1,-1
890,890,886,876,14,14,15,13,2,1,2,2,0,4,10,0,-1,2
674,670,674,674,20,19,20,21,2,3,1,3,4,-4,0,1,-1,-1
581,576,576,576,14,14,15,13,1,2,1,1,5,0,0,0,-1,2
464,459,454,450,13,14,12,13,1,3,1,3,5,5,4,-1,2,-1
965,965,960,960,17,19,18,18,1,2,1,1,0,5,0,-2,1,0
604,595,595,614,14,14,13,13,3,2,2,2,9,0,-19,0,1,0
792,792,787,782,14,17,15,16,1,1,3,1,0,5,5,-3,2,-1
886,881,881,886,18,19,18,19,2,2,1,1,5,0,-5,-1,1,-1
562,553,557,553,14,17,15,16,1,3,2,2,9,-4,4,-3,2,-1
726,717,717,717,13,14,15,13,3,1,4,3,9,0,0,-1,-1,2
876,871,876,876,14,17,15,16,2,2,1,3,5,-5,0,-3,2,-1
328,318,318,314,14,17,15,16,1,2,3,2,10,0,4,-3,2,-1
590,586,586,581,18,17,18,19,3,4,1,1,4,0,5,1,-1,-1
1017,1012,1012,1007,20,19,20,18,2,1,1,2,5,0,5,1,-1,2
201,192,196,196,14,17,15,16,2,2,1,1,9,-4,0,-3,2,-1
857,853,853,848,14,14,15,13,1,3,2,1,4,0,5,0,-1,2
295,281,276,281,18,17,18,19,2,1,1,1,14,5,-5,1,-1,-1
703,689,684,684,13,14,15,13,1,2,1,1,14,5,0,-1,-1,2
839,839,843,839,14,17,15,16,2,1,2,1,0,-4,4,-3,2,-1
721,721,717,717,17,16,18,18,3,2,1,1,0,4,0,1,-2,0
581,571,581,586,21,19,20,21,1,3,1,1,10,-10,-5,2,-1,-1
1064,1054,1059,1050,13,16,15,16,2,1,1,2,10,-5,9,-3,1,-1
440,431,431,426,17,16,18,18,2,5,3,2,9,0,5,1,-2,0
426,417,417,412,17,16,18,18,1,1,2,2,9,0,5,1,-2,0
642,637,632,637,17,16,18,18,1,3,1,1,5,5,-5,1,-2,0
703,703,698,693,13,14,15,13,1,1,3,1,0,5,5,-1,-1,2
796,796,796,792,14,14,13,13,3,1,1,4,0,0,4,0,1,0
993,984,984,989,20,19,20,21,2,1,1,1,9,0,-5,1,-1,-1
524,520,520,515,14,14,15,16,1,3,1,2,4,0,5,0,-1,-1
187,1078,1073,1078,14,14,12,13,2,1,1,1,-891,5,-5,0,2,-1
740,712,703,698,13,14,12,13,2,1,2,2,28,9,5,-1,2,-1
576,576,576,576,14,14,13,13,2,2,1,2,0,0,0,0,1,0
886,871,881,867,14,14,13,13,2,2,4,1,15,-10,14,0,1,0
942,937,937,932,13,14,15,16,3,1,2,1,5,0,5,-1,-1,-1
773,768,768,773,17,16,18,16,3,2,1,1,5,0,-5,1,-2,2
787,787,792,787,14,17,15,16,2,2,3,2,0,-5,5,-3,2,-1
304,300,290,290,14,17,15,16,2,1,1,2,4,10,0,-3,2,-1
1040,1031,1031,1036,13,14,15,13,1,2,4,1,9,0,-5,-1,-1,2
506,501,501,496,14,14,13,13,1,2,2,1,5,0,5,0,1,0
853,857,848,834,14,14,15,13,2,1,2,2,-4,9,14,0,-1,2
300,300,300,304,14,17,15,16,2,1,1,2,0,0,-4,-3,2,-1
970,960,951,951,13,14,15,13,2,3,3,1,10,9,0,-1,-1,2
478,473,468,473,20,19,20,21,1,1,3,1,5,5,-5,1,-1,-1
351,356,351,351,20,19,20,18,1,3,1,1,-5,5,0,1,-1,2
314,300,300,300,14,14,15,16,1,2,1,1,14,0,0,0,-1,-1
239,234,234,234,21,19,20,21,1,3,1,1,5,0,0,2,-1,-1
806,796,796,796,14,14,13,13,1,2,3,2,10,0,0,0,1,0
196,187,187,187,18,19,18,19,1,4,3,2,9,0,0,-1,1,-1
984,984,984,984,17,16,15,16,1,1,1,1,0,0,0,1,1,-1
717,656,651,646,17,16,18,16,3,1,2,1,61,5,5,1,-2,2
679,665,660,665,13,14,12,13,2,2,2,1,14,5,-5,-1,2,-1
731,726,543,736,13,14,10,13,2,1,3,1,5,183,-193,-1,4,-3
614,609,604,604,18,19,18,19,2,1,1,1,5,5,0,-1,1,-1
487,482,487,482,21,19,21,21,1,2,1,1,5,-5,5,2,-2,0
524,520,510,520,14,14,15,13,3,2,1,1,4,10,-10,0,-1,2
318,318,323,318,14,14,15,13,2,2,2,1,0,-5,5,0,-1,2
886,886,886,886,21,19,20,21,2,2,1,1,0,0,0,2,-1,-1
937,979,937,932,13,14,15,13,1,2,2,2,-42,42,5,-1,-1,2
1073,1068,1064,1068,17,16,18,18,1,1,1,1,5,4,-4,1,-2,0
721,712,717,712,17,16,15,16,3,2,2,1,9,-5,5,1,1,-1
595,581,567,562,14,14,13,13,2,2,2,1,14,14,5,0,1,0
670,665,670,665,13,16,15,16,3,2,1,1,5,-5,5,-3,1,-1
843,857,839,853,14,17,15,16,3,3,2,1,-14,18,-14,-3,2,-1
234,229,224,229,14,14,13,13,1,1,1,1,5,5,-5,0,1,0
534,534,534,524,14,17,15,16,3,1,3,2,0,0,10,-3,2,-1
623,618,618,618,14,14,15,13,2,1,1,2,5,0,0,0,-1,2
314,309,309,309,18,17,18,16,3,3,2,1,5,0,0,1,-1,2
374,370,370,365,20,19,18,18,3,2,3,2,4,0,5,1,1,0
801,792,792,792,14,17,15,16,2,2,1,1,9,0,0,-3,2,-1
407,393,393,393,20,19,20,18,4,2,1,2,14,0,0,1,-1,2
750,750,750,750,20,19,18,18,3,2,1,1,0,0,0,1,1,0
806,792,796,801,14,17,15,16,1,2,1,2,14,-4,-5,-3,2,-1
281,276,271,276,14,14,13,13,3,3,3,2,5,5,-5,0,1,0
792,787,787,787,18,19,18,19,1,1,1,2,5,0,0,-1,1,-1
979,974,979,974,13,14,15,13,3,3,3,1,5,-5,5,-1,-1,2
323,318,323,323,18,17,18,19,2,3,1,1,5,-5,0,1,-1,-1
853,843,843,843,14,14,15,13,1,2,1,3,10,0,0,0,-1,2
440,436,431,431,17,19,18,18,5,1,1,1,4,5,0,-2,1,0
721,717,717,712,17,16,18,16,3,3,3,1,4,0,5,1,-2,2
923,923,923,923,14,14,15,13,2,2,2,3,0,0,0,0,-1,2
637,628,623,623,13,17,15,16,2,1,1,2,9,5,0,-4,2,-1
796,782,778,778,14,17,15,16,1,1,2,1,14,4,0,-3,2,-1
1026,1036,1031,1031,13,14,15,13,2,2,1,2,-10,5,0,-1,-1,2
473,464,468,464,20,19,18,18,1,3,3,1,9,-4,4,1,1,0
323,318,323,323,18,17,18,19,2,4,2,3,5,-5,0,1,-1,-1
389,379,384,384,20,19,20,21,1,2,1,1,10,-5,0,1,-1,-1
215,215,210,210,14,14,13,13,2,1,1,2,0,5,0,0,1,0
257,248,243,239,18,19,18,18,1,2,1,1,9,5,4,-1,1,0
609,590,586,581,18,17,18,16,2,2,2,1,19,4,5,1,-1,2
876,871,871,871,14,17,15,16,2,2,1,1,5,0,0,-3,2,-1
792,792,792,787,14,17,15,16,2,1,3,1,0,0,5,-3,2,-1
693,689,693,693,17,16,18,16,1,2,1,1,4,-4,0,1,-2,2
773,764,759,754,13,16,15,16,1,2,1,2,9,5,5,-3,1,-1
520,515,515,520,21,19,20,21,1,3,1,1,5,0,-5,2,-1,-1
553,553,543,539,18,17,18,16,1,1,3,2,0,10,4,1,-1,2
412,403,407,407,17,16,18,18,2,1,2,1,9,-4,0,1,-2,0
220,215,215,215,14,14,15,16,3,3,1,1,5,0,0,0,-1,-1
417,412,407,398,20,19,20,18,2,4,2,2,5,5,9,1,-1,2
1031,1026,1026,1026,13,14,12,13,3,2,1,3,5,0,0,-1,2,-1
337,332,328,328,17,16,15,16,2,1,1,1,5,4,0,1,1,-1
501,492,496,487,14,14,15,13,2,2,1,1,9,-4,9,0,-1,2
628,623,623,623,18,19,18,19,1,1,1,1,5,0,0,-1,1,-1
496,492,492,492,18,19,18,19,3,1,3,2,4,0,0,-1,1,-1
562,524,529,524,18,19,18,19,3,2,3,1,38,-5,5,-1,1,-1
974,965,965,960,17,16,15,16,1,2,2,1,9,0,5,1,1,-1
412,407,403,403,17,16,18,18,2,3,2,1,5,4,0,1,-2,0
998,993,989,989,17,16,18,16,2,1,1,1,5,4,0,1,-2,2
581,571,571,571,14,14,15,16,3,2,1,1,10,0,0,0,-1,-1
267,257,257,257,18,19,18,18,2,1,3,1,10,0,0,-1,1,0
604,600,623,604,18,19,18,19,2,4,3,1,4,-23,19,-1,1,-1
215,206,215,220,14,14,13,13,2,2,4,1,9,-9,-5,0,1,0
346,346,346,342,17,16,18,18,2,3,2,3,0,0,4,1,-2,0
262,253,253,253,21,19,20,18,1,3,3,1,9,0,0,2,-1,2
300,295,295,300,14,14,13,13,2,4,1,1,5,0,-5,0,1,0
867,867,867,862,21,19,20,18,3,1,1,2,0,0,5,2,-1,2
229,220,220,576,21,19,20,18,1,1,2,1,9,0,-356,2,-1,2
431,421,417,792,17,19,18,21,2,1,1,1,10,4,-375,-2,1,-3
496,492,487,487,14,14,13,13,2,1,2,3,4,5,0,0,1,0
524,524,581,524,14,17,15,16,4,4,2,3,0,-57,57,-3,2,-1
604,595,595,595,18,17,18,16,1,4,1,1,9,0,0,1,-1,2
600,600,595,600,18,17,18,19,3,3,1,3,0,5,-5,1,-1,-1
295,290,290,290,18,19,18,19,1,4,1,1,5,0,0,-1,1,-1
946,942,942,937,20,19,20,21,2,2,3,1,4,0,5,1,-1,-1
220,201,196,196,14,14,15,13,3,1,2,1,19,5,0,0,-1,2
1078,1073,1073,1073,17,16,18,18,1,2,1,3,5,0,0,1,-2,0
998,998,993,993,13,14,15,13,1,1,1,1,0,5,0,-1,-1,2
389,393,389,389,13,14,15,13,2,2,1,1,-4,4,0,-1,-1,2
1003,993,998,998,17,16,18,18,3,2,2,1,10,-5,0,1,-2,0
956,960,960,960,20,19,20,21,1,1,1,1,-4,0,0,1,-1,-1
609,600,600,600,18,17,18,16,1,2,3,1,9,0,0,1,-1,2
1003,998,1003,998,20,19,20,21,1,1,3,1,5,-5,5,1,-1,-1
886,871,876,876,14,17,15,16,1,2,2,1,15,-5,0,-3,2,-1
206,187,182,182,14,14,13,13,2,2,1,1,19,5,0,0,1,0
665,665,660,656,20,19,20,18,1,1,1,2,0,5,4,1,-1,2
618,614,614,618,14,14,15,13,2,3,3,1,4,0,-4,0,-1,2
445,445,440,440,13,14,12,13,2,2,2,2,0,5,0,-1,2,-1
853,848,853,848,14,17,15,16,3,3,2,2,5,-5,5,-3,2,-1
754,745,750,750,13,14,15,13,2,2,2,1,9,-5,0,-1,-1,2
815,806,810,806,18,17,18,19,1,2,1,2,9,-4,4,1,-1,-1
318,314,314,314,18,19,18,19,1,3,3,1,4,0,0,-1,1,-1
524,510,515,515,14,14,15,16,2,2,2,3,14,-5,0,0,-1,-1
1017,993,993,989,13,14,15,13,2,2,2,1,24,0,4,-1,-1,2
224,210,206,206,14,14,13,13,1,3,1,1,14,4,0,0,1,0
736,726,726,726,20,19,20,21,2,2,1,3,10,0,0,1,-1,-1
239,234,234,234,18,19,18,18,1,3,4,1,5,0,0,-1,1,0
271,290,239,234,14,14,15,13,1,1,2,2,-19,51,5,0,-1,2
759,750,754,754,17,16,18,16,1,2,3,1,9,-4,0,1,-2,2
295,295,290,290,18,17,18,19,3,1,3,1,0,5,0,1,-1,-1
604,604,600,600,18,19,18,19,1,1,2,2,0,4,0,-1,1,-1
384,384,379,379,17,16,15,16,1,2,1,3,0,5,0,1,1,-1
904,890,895,890,14,14,13,13,1,1,2,2,14,-5,5,0,1,0
262,253,253,253,14,17,15,16,3,2,2,1,9,0,0,-3,2,-1
909,909,909,909,18,17,18,19,2,3,1,1,0,0,0,1,-1,-1
548,539,529,534,14,14,13,13,2,2,3,2,9,10,-5,0,1,0
1050,1040,1040,1036,13,14,12,13,4,3,2,2,10,0,4,-1,2,-1
923,909,904,900,14,14,15,16,2,2,1,1,14,5,4,0,-1,-1
1059,1059,1054,1059,20,19,20,18,2,1,1,3,0,5,-5,1,-1,2
651,642,646,642,17,16,15,16,1,2,1,2,9,-4,4,1,1,-1
473,473,473,473,17,16,15,16,2,2,3,2,0,0,0,1,1,-1
1003,993,993,993,20,19,18,18,2,3,1,1,10,0,0,1,1,0
881,871,871,871,21,19,20,18,1,1,1,1,10,0,0,2,-1,2
932,937,937,932,17,16,18,18,1,1,2,1,-5,0,5,1,-2,0
834,834,834,834,18,19,18,18,1,1,1,3,0,0,0,-1,1,0
520,520,520,520,14,17,15,16,2,3,2,3,0,0,0,-3,2,-1
782,773,778,778,14,14,15,13,1,2,1,1,9,-5,0,0,-1,2
642,637,632,632,20,19,18,18,3,1,1,1,5,5,0,1,1,0
557,557,553,553,14,17,15,16,1,3,1,1,0,4,0,-3,2,-1
960,960,960,956,13,14,12,13,2,1,2,2,0,0,4,-1,2,-1
820,824,815,815,14,14,15,16,2,5,3,2,-4,9,0,0,-1,-1
895,895,886,890,21,19,20,19,2,1,1,1,0,9,-4,2,-1,1
810,806,806,801,14,14,15,13,2,3,2,2,4,0,5,0,-1,2
243,234,229,229,14,17,15,16,1,1,1,1,9,5,0,-3,2,-1
736,731,731,731,13,14,15,13,1,2,1,1,5,0,0,-1,-1,2
210,201,201,206,18,17,18,19,2,2,2,1,9,0,-5,1,-1,-1
370,370,365,365,13,14,12,13,1,3,1,1,0,5,0,-1,2,-1
1045,1040,1045,1040,20,19,20,21,1,3,3,1,5,-5,5,1,-1,-1
1036,1036,1031,1031,20,19,20,18,3,1,1,1,0,5,0,1,-1,2
782,782,773,773,14,14,15,13,1,1,1,2,0,9,0,0,-1,2
881,867,862,857,14,14,13,13,1,3,2,3,14,5,5,0,1,0
900,895,914,923,18,17,18,16,1,1,1,1,5,-19,-9,1,-1,2
618,614,618,614,14,14,13,13,2,4,4,2,4,-4,4,0,1,0
871,867,867,857,18,19,18,18,2,1,2,2,4,0,10,-1,1,0
843,839,834,834,18,17,18,16,2,2,1,2,4,5,0,1,-1,2
731,736,726,731,13,14,15,13,3,4,1,1,-5,10,-5,-1,-1,2
792,787,792,787,18,17,18,16,2,3,2,1,5,-5,5,1,-1,2
712,707,707,703,20,19,18,18,2,1,2,2,5,0,4,1,1,0
764,759,754,759,13,14,15,13,1,3,1,1,5,5,-5,-1,-1,2
646,642,642,637,17,16,18,16,3,2,2,2,4,0,5,1,-2,2
656,651,651,656,17,16,15,16,2,1,3,1,5,0,-5,1,1,-1
862,857,857,857,14,14,15,16,1,3,1,3,5,0,0,0,-1,-1
1064,1064,1059,1054,20,19,18,18,1,1,1,2,0,5,5,1,1,0
609,604,604,604,18,19,18,19,2,2,3,1,5,0,0,-1,1,-1
871,871,867,867,18,19,18,18,2,3,1,1,0,4,0,-1,1,0
590,586,586,586,14,14,13,13,3,1,1,2,4,0,0,0,1,0
384,646,379,374,20,16,20,21,2,1,2,2,-262,267,5,4,-4,-1
1068,1064,1064,1064,20,19,18,18,2,1,1,1,4,0,0,1,1,0
243,243,248,239,14,17,15,16,2,1,2,2,0,-5,9,-3,2,-1
979,970,970,970,20,19,20,21,3,1,1,3,9,0,0,1,-1,-1
698,693,689,693,13,14,12,13,3,3,3,1,5,4,-4,-1,2,-1
539,534,529,534,18,19,18,18,1,2,3,1,5,5,-5,-1,1,0
665,660,660,660,13,14,15,13,1,1,3,1,5,0,0,-1,-1,2
562,557,557,557,18,17,18,16,1,3,1,2,5,0,0,1,-1,2
857,853,853,848,21,19,20,21,1,3,1,2,4,0,5,2,-1,-1
900,890,886,881,14,14,15,16,2,6,1,2,10,4,5,0,-1,-1
337,337,337,337,20,19,20,21,1,2,1,3,0,0,0,1,-1,-1
628,646,642,637,18,19,20,18,1,3,1,1,-18,4,5,-1,-1,2
271,267,267,267,14,14,13,13,1,1,2,2,4,0,0,0,1,0
820,815,815,820,14,14,15,13,2,2,1,1,5,0,-5,0,-1,2
220,215,210,210,18,17,18,19,2,1,1,1,5,5,0,1,-1,-1
614,600,600,604,14,14,13,13,1,2,1,1,14,0,-4,0,1,0
360,360,360,360,17,16,18,18,1,1,1,1,0,0,0,1,-2,0
346,342,346,346,13,14,12,13,1,1,2,3,4,-4,0,-1,2,-1
529,510,515,506,14,14,15,16,1,2,2,2,19,-5,9,0,-1,-1
257,253,248,248,18,19,18,18,2,1,1,1,4,5,0,-1,1,0
806,801,801,801,18,17,18,19,2,1,1,1,5,0,0,1,-1,-1
510,506,506,501,14,14,13,13,2,3,2,1,4,0,5,0,1,0
937,942,942,942,17,16,18,18,1,1,2,3,-5,0,0,1,-2,0
1050,1031,1031,1031,17,16,18,16,2,1,1,2,19,0,0,1,-2,2
881,876,876,871,18,17,18,18,2,1,2,2,5,0,5,1,-1,0
1064,1064,1054,1059,13,16,15,16,1,1,1,1,0,10,-5,-3,1,-1
398,389,393,389,13,14,15,13,3,1,4,1,9,-4,4,-1,-1,2
796,792,792,792,14,14,15,16,1,1,2,1,4,0,0,0,-1,-1
473,464,459,464,20,19,20,21,4,2,3,1,9,5,-5,1,-1,-1
445,440,440,440,13,14,12,13,1,3,1,3,5,0,0,-1,2,-1
337,328,337,346,17,17,18,18,2,1,3,1,9,-9,-9,0,-1,0
440,431,440,440,20,19,20,18,2,2,2,3,9,-9,0,1,-1,2
707,698,698,693,13,16,15,16,1,2,1,2,9,0,5,-3,1,-1
665,660,660,660,20,19,20,18,2,2,1,1,5,0,0,1,-1,2
782,773,778,778,18,16,18,18,1,2,1,1,9,-5,0,2,-2,0
412,412,407,407,13,14,12,13,3,3,3,1,0,5,0,-1,2,-1
773,773,764,759,20,19,20,18,3,3,1,2,0,9,5,1,-1,2
829,829,829,834,21,19,20,18,1,3,1,1,0,0,-5,2,-1,2
215,210,215,206,14,14,13,13,1,3,1,3,5,-5,9,0,1,0
304,304,309,309,14,14,13,13,1,2,3,2,0,-5,0,0,1,0
478,473,473,478,17,16,15,16,1,2,1,1,5,0,-5,1,1,-1
754,750,768,754,13,14,15,16,1,4,3,1,4,-18,14,-1,-1,-1
993,989,984,979,20,19,20,18,2,1,1,2,4,5,5,1,-1,2
604,604,600,595,18,17,18,19,1,3,1,2,0,4,5,1,-1,-1
332,323,323,328,20,19,21,21,1,3,1,1,9,0,-5,1,-2,0
773,773,768,768,13,14,12,13,2,2,1,3,0,5,0,-1,2,-1
196,192,196,192,14,14,15,13,3,2,2,2,4,-4,4,0,-1,2
501,496,496,496,14,14,13,13,3,1,2,1,5,0,0,0,1,0
806,810,806,806,14,14,15,16,3,3,1,3,-4,4,0,0,-1,-1
567,553,548,543,18,19,18,18,2,1,3,2,14,5,5,-1,1,0
365,360,360,356,20,19,20,21,1,1,1,2,5,0,4,1,-1,-1
824,810,801,796,14,14,15,13,2,3,1,2,14,9,5,0,-1,2
1073,1068,1068,1064,13,14,12,13,1,2,2,2,5,0,4,-1,2,-1
881,881,881,881,14,14,15,13,2,3,2,3,0,0,0,0,-1,2
215,215,215,201,18,19,18,19,3,3,2,2,0,0,14,-1,1,-1
300,290,290,290,14,14,15,13,2,2,3,3,10,0,0,0,-1,2
271,262,262,262,18,17,18,16,3,1,1,3,9,0,0,1,-1,2
651,646,646,642,13,14,12,13,2,3,2,1,5,0,4,-1,2,-1
201,196,201,196,18,17,18,19,2,2,2,1,5,-5,5,1,-1,-1
632,632,632,632,20,19,20,18,1,1,1,1,0,0,0,1,-1,2
360,360,356,356,17,16,18,18,1,3,1,1,0,4,0,1,-2,0
557,548,548,548,14,14,15,13,1,2,2,1,9,0,0,0,-1,2
890,886,886,886,14,14,15,13,1,3,1,1,4,0,0,0,-1,2
862,857,862,853,14,14,13,13,3,3,2,2,5,-5,9,0,1,0
300,300,300,295,14,14,15,13,1,3,3,3,0,0,5,0,-1,2
782,768,768,768,21,19,20,18,1,3,2,1,14,0,0,2,-1,2
998,998,993,989,20,19,20,18,1,1,1,3,0,5,4,1,-1,2
290,290,281,281,14,14,13,13,1,2,1,1,0,9,0,0,1,0
946,946,942,937,13,16,15,16,1,3,2,1,0,4,5,-3,1,-1
206,206,243,267,14,17,15,16,3,6,2,1,0,-37,-24,-3,2,-1
576,567,576,571,18,17,18,16,2,2,2,1,9,-9,5,1,-1,2
314,300,295,295,14,14,13,13,3,3,1,1,14,5,0,0,1,0
824,824,815,820,21,19,20,19,2,3,1,1,0,9,-5,2,-1,1
646,642,656,632,17,19,18,18,1,3,2,1,4,-14,24,-2,1,0
618,600,609,614,14,14,13,13,1,1,2,1,18,-9,-5,0,1,0
679,674,670,670,13,14,12,13,1,3,2,1,5,4,0,-1,2,-1
534,529,529,524,18,17,18,16,1,1,4,2,5,0,5,1,-1,2
918,918,918,918,18,19,18,19,2,1,1,1,0,0,0,-1,1,-1
660,651,656,656,13,14,15,16,2,3,2,1,9,-5,0,-1,-1,-1
436,426,431,426,20,19,20,21,3,2,2,1,10,-5,5,1,-1,-1
960,956,951,956,17,16,18,18,2,3,1,1,4,5,-5,1,-2,0
674,674,674,674,20,19,18,18,1,1,2,1,0,0,0,1,1,0
815,810,806,801,18,19,18,19,1,1,1,2,5,4,5,-1,1,-1
773,764,764,764,17,16,15,16,2,2,3,2,9,0,0,1,1,-1
192,187,187,187,18,17,18,19,1,2,3,1,5,0,0,1,-1,-1
271,257,253,257,14,17,15,16,3,2,1,4,14,4,-4,-3,2,-1
557,553,553,548,21,19,20,21,1,2,2,2,4,0,5,2,-1,-1
553,543,543,543,14,14,13,13,2,2,3,2,10,0,0,0,1,0
506,506,510,506,14,14,13,13,2,2,2,1,0,-4,4,0,1,0
1068,1064,1068,1064,17,16,18,18,1,2,2,1,4,-4,4,1,-2,0
487,482,478,478,14,14,15,16,1,1,2,1,5,4,0,0,-1,-1
843,839,839,839,21,19,20,18,2,2,1,1,4,0,0,2,-1,2
674,665,665,670,13,14,12,13,2,2,1,1,9,0,-5,-1,2,-1
515,506,510,501,18,19,18,19,3,2,1,2,9,-4,9,-1,1,-1
365,360,360,356,20,19,20,21,2,1,1,3,5,0,4,1,-1,-1
895,871,867,857,14,14,13,13,3,2,2,1,24,4,10,0,1,0
445,445,440,440,13,14,15,13,1,3,1,1,0,5,0,-1,-1,2
1036,1031,1026,1026,17,16,18,16,2,3,2,1,5,5,0,1,-2,2
459,445,445,445,13,14,12,13,2,3,2,1,14,0,0,-1,2,-1
843,834,834,834,14,17,15,16,1,3,1,1,9,0,0,-3,2,-1
290,290,290,290,21,19,20,19,1,1,1,1,0,0,0,2,-1,1
590,586,581,586,18,17,18,16,3,2,1,1,4,5,-5,1,-1,2
768,764,768,768,20,19,18,18,1,1,2,1,4,-4,0,1,1,0
1017,1012,1012,1012,13,14,12,13,1,2,3,1,5,0,0,-1,2,-1
937,937,932,937,20,19,18,18,3,2,1,1,0,5,-5,1,1,0
721,717,707,717,13,14,15,13,2,2,1,1,4,10,-10,-1,-1,2
937,932,937,932,20,19,20,21,1,2,2,1,5,-5,5,1,-1,-1
501,492,487,482,14,14,15,16,3,3,2,1,9,5,5,0,-1,-1
609,689,609,604,18,16,18,19,1,4,2,2,-80,80,5,2,-2,-1
215,210,215,210,18,19,18,19,2,3,2,1,5,-5,5,-1,1,-1
782,782,787,782,21,19,21,19,1,1,2,1,0,-5,5,2,-2,2
281,276,276,281,14,14,13,13,1,3,1,3,5,0,-5,0,1,0
553,557,557,562,14,14,15,13,2,3,1,1,-4,0,-5,0,-1,2
614,618,614,609,14,17,15,16,2,5,2,1,-4,4,5,-3,2,-1
557,553,553,548,18,17,18,18,1,2,1,2,4,0,5,1,-1,0
881,871,871,876,18,17,18,16,1,1,1,1,10,0,-5,1,-1,2
323,314,314,314,14,17,15,16,1,1,1,3,9,0,0,-3,2,-1
895,890,890,890,18,17,18,19,3,5,1,2,5,0,0,1,-1,-1
557,543,604,548,21,19,23,21,1,4,1,2,14,-61,56,2,-4,2
374,370,370,370,13,14,12,13,2,4,1,2,4,0,0,-1,2,-1
365,356,360,351,13,14,12,13,2,2,5,3,9,-4,9,-1,2,-1
909,890,886,886,14,14,13,13,2,4,1,3,19,4,0,0,1,0
646,642,660,637,13,14,12,13,1,4,2,2,4,-18,23,-1,2,-1
914,918,909,909,14,17,15,16,2,1,1,1,-4,9,0,-3,2,-1
998,998,993,989,17,16,18,18,2,3,2,2,0,5,4,1,-2,0
562,557,553,548,14,17,15,16,2,3,1,2,5,4,5,-3,2,-1
745,740,736,740,20,19,18,18,1,3,3,1,5,4,-4,1,1,0
271,271,271,271,18,17,18,18,2,2,1,1,0,0,0,1,-1,0
778,778,773,773,13,16,15,16,2,1,1,1,0,5,0,-3,1,-1
520,515,510,506,14,14,13,13,1,2,1,4,5,5,4,0,1,0
557,529,524,520,14,14,15,13,1,1,1,2,28,5,4,0,-1,2
271,267,267,271,14,14,15,13,1,4,1,2,4,0,-4,0,-1,2
206,182,201,201,14,14,15,16,3,1,1,1,24,-19,0,0,-1,-1
595,590,586,581,14,14,13,13,1,1,1,3,5,4,5,0,1,0
834,834,834,834,14,17,15,16,4,4,1,3,0,0,0,-3,2,-1
529,529,524,524,14,17,15,16,1,3,2,1,0,5,0,-3,2,-1
464,459,459,459,20,19,20,18,3,2,1,1,5,0,0,1,-1,2
351,342,342,342,20,19,20,18,1,3,1,2,9,0,0,1,-1,2
956,951,956,960,20,19,18,18,1,2,3,1,5,-5,-4,1,1,0
792,782,787,782,21,19,21,21,3,1,2,1,10,-5,5,2,-2,0
295,290,286,286,18,17,18,16,2,1,1,3,5,4,0,1,-1,2
754,750,754,750,20,19,20,21,2,1,1,1,4,-4,4,1,-1,-1
187,182,182,182,14,14,15,13,1,1,1,1,5,0,0,0,-1,2
628,614,609,609,18,17,18,19,1,1,1,2,14,5,0,1,-1,-1
529,520,515,515,21,19,20,19,1,2,3,2,9,5,0,2,-1,1
782,773,773,778,21,19,20,21,1,2,1,1,9,0,-5,2,-1,-1
909,909,909,909,21,19,21,21,2,3,1,1,0,0,0,2,-2,0
576,562,567,562,14,14,15,16,1,2,3,2,14,-5,5,0,-1,-1
234,229,229,224,21,19,20,21,2,2,2,1,5,0,5,2,-1,-1
600,595,595,595,18,19,18,19,1,2,1,1,5,0,0,-1,1,-1
557,553,548,548,14,14,13,13,3,3,2,3,4,5,0,0,1,0
787,773,778,778,21,19,20,18,1,2,1,1,14,-5,0,2,-1,2
1040,1040,1036,1031,17,16,15,16,1,3,2,1,0,4,5,1,1,-1
979,970,974,979,17,16,15,16,2,2,2,3,9,-4,-5,1,1,-1
595,576,581,576,21,19,20,18,1,2,2,2,19,-5,5,2,-1,2
379,365,360,360,13,14,15,13,4,3,3,1,14,5,0,-1,-1,2
998,993,993,993,13,14,15,13,1,2,1,2,5,0,0,-1,-1,2
867,862,862,867,18,19,18,18,2,1,1,3,5,0,-5,-1,1,0
323,323,337,337,18,19,18,18,2,2,2,1,0,-14,0,-1,1,0
1012,1007,1007,1007,13,14,15,16,1,3,2,1,5,0,0,-1,-1,-1
792,787,787,782,18,17,18,19,3,2,1,2,5,0,5,1,-1,-1
553,539,586,548,14,17,15,16,1,2,1,1,14,-47,38,-3,2,-1
529,515,510,515,18,19,18,19,1,2,1,3,14,5,-5,-1,1,-1
248,243,248,239,18,17,18,16,1,1,3,2,5,-5,9,1,-1,2
567,557,557,553,14,14,13,13,3,2,2,2,10,0,4,0,1,0
201,196,196,196,18,17,18,16,3,2,1,3,5,0,0,1,-1,2
534,534,534,529,21,19,20,21,1,1,2,2,0,0,5,2,-1,-1
590,581,576,576,18,17,18,18,1,1,1,1,9,5,0,1,-1,0
412,403,403,398,17,19,18,18,2,2,1,2,9,0,5,-2,1,0
796,792,792,787,18,17,18,19,1,3,2,1,4,0,5,1,-1,-1
1059,1054,1054,1054,20,19,18,18,2,1,3,1,5,0,0,1,1,0
989,993,989,984,17,16,18,18,2,2,1,2,-4,4,5,1,-2,0
736,736,736,731,17,19,18,18,1,1,2,2,0,0,5,-2,1,0
253,243,239,234,18,19,18,18,1,1,2,1,10,4,5,-1,1,0
820,820,1050,810,14,17,15,16,2,1,1,2,0,-230,240,-3,2,-1
609,604,604,600,14,14,15,16,2,2,2,2,5,0,4,0,-1,-1
473,468,473,468,17,16,15,16,2,2,3,2,5,-5,5,1,1,-1
1078,1073,1078,1073,17,16,18,18,1,1,2,1,5,-5,5,1,-2,0
895,886,890,890,14,14,13,13,1,2,3,3,9,-4,0,0,1,0
529,520,618,520,18,19,18,19,2,2,1,2,9,-98,98,-1,1,-1
262,248,243,243,14,14,13,13,2,2,1,1,14,5,0,0,1,0
670,665,665,665,13,14,15,13,2,2,2,3,5,0,0,-1,-1,2
768,759,759,754,20,19,18,18,1,2,3,2,9,0,5,1,1,0
937,923,1031,909,13,14,10,13,3,2,1,2,14,-108,122,-1,4,-3
440,436,487,440,17,16,18,18,3,2,1,1,4,-51,47,1,-2,0
445,436,436,426,17,16,15,16,2,2,2,2,9,0,10,1,1,-1
1012,1012,1012,1007,20,19,20,21,1,1,1,2,0,0,5,1,-1,-1
1021,1007,1012,1012,13,14,15,13,2,1,3,2,14,-5,0,-1,-1,2
342,337,346,360,20,19,18,18,1,1,2,1,5,-9,-14,1,1,0
867,848,843,843,18,17,18,18,1,1,1,1,19,5,0,1,-1,0
473,473,468,468,13,14,15,13,3,1,1,2,0,5,0,-1,-1,2
257,253,257,253,18,17,18,18,1,3,2,1,4,-4,4,1,-1,0
674,674,670,674,13,14,15,13,1,3,1,1,0,4,-4,-1,-1,2
932,923,928,923,13,14,15,13,1,2,1,1,9,-5,5,-1,-1,2
979,965,965,960,13,14,12,13,2,2,2,3,14,0,5,-1,2,-1
1073,1068,1068,1064,20,19,18,18,2,2,1,2,5,0,4,1,1,0
998,998,1003,1003,20,19,18,18,3,2,2,1,0,-5,0,1,1,0
698,698,693,689,20,19,20,18,1,1,3,1,0,5,4,1,-1,2
267,262,267,267,18,17,18,18,4,2,1,1,5,-5,0,1,-1,0
262,248,248,248,14,14,15,13,3,2,1,3,14,0,0,0,-1,2
942,932,932,937,20,19,18,18,2,1,1,1,10,0,-5,1,1,0
918,914,914,909,14,17,15,16,2,3,2,2,4,0,5,-3,2,-1
196,196,196,196,21,19,21,21,2,1,2,1,0,0,0,2,-2,0
529,524,524,524,18,17,18,16,2,1,1,2,5,0,0,1,-1,2
407,403,403,398,13,14,15,13,2,2,2,1,4,0,5,-1,-1,2
651,651,651,651,17,16,18,16,1,1,2,1,0,0,0,1,-2,2
553,553,548,553,14,14,15,13,1,3,1,1,0,5,-5,0,-1,2
736,721,717,721,13,14,12,13,2,3,3,1,15,4,-4,-1,2,-1
1017,1007,998,1007,13,14,12,13,2,3,3,1,10,9,-9,-1,2,-1
576,571,576,576,14,14,15,13,2,1,1,3,5,-5,0,0,-1,2
192,192,187,187,18,17,18,19,2,1,2,2,0,5,0,1,-1,-1
810,801,801,796,21,19,21,21,1,2,1,3,9,0,5,2,-2,0
524,520,524,520,14,17,15,16,2,2,3,2,4,-4,4,-3,2,-1
628,623,623,623,21,19,21,21,1,2,3,1,5,0,0,2,-2,0
581,581,576,576,18,19,18,18,1,2,1,1,0,5,0,-1,1,0
496,487,482,487,18,19,18,19,1,3,1,1,9,5,-5,-1,1,-1
1078,1068,1073,1073,13,14,12,13,1,4,3,1,10,-5,0,-1,2,-1
234,229,224,220,18,17,18,19,3,1,1,2,5,5,4,1,-1,-1
726,970,717,717,13,16,15,16,2,1,3,2,-244,253,0,-3,1,-1
764,754,759,754,17,16,15,16,1,2,2,2,10,-5,5,1,1,-1
309,309,309,304,14,17,15,16,3,1,2,1,0,0,5,-3,2,-1
365,365,360,360,13,14,15,13,1,3,2,2,0,5,0,-1,-1,2
543,524,529,529,14,14,15,13,1,2,3,1,19,-5,0,0,-1,2
782,773,778,773,14,14,13,13,1,2,2,1,9,-5,5,0,1,0
590,586,586,581,14,17,15,16,1,2,2,1,4,0,5,-3,2,-1
553,548,548,548,14,14,13,13,3,1,2,2,5,0,0,0,1,0
1073,1068,1068,1064,17,19,18,18,1,1,2,2,5,0,4,-2,1,0
206,196,201,196,14,17,15,16,2,2,1,1,10,-5,5,-3,2,-1
1012,1003,998,993,17,16,18,18,2,4,1,2,9,5,5,1,-2,0
909,900,895,890,14,17,15,16,2,2,2,1,9,5,5,-3,2,-1
224,220,220,220,18,17,18,16,1,1,1,2,4,0,0,1,-1,2
314,304,314,314,14,17,15,16,1,1,2,3,10,-10,0,-3,2,-1
276,257,271,248,14,14,13,13,1,3,3,1,19,-14,23,0,1,0
651,651,651,646,20,19,20,18,3,1,2,2,0,0,5,1,-1,2
778,750,754,750,17,16,18,16,2,2,3,1,28,-4,4,1,-2,2
867,857,853,853,21,19,20,18,2,2,1,1,10,4,0,2,-1,2
553,548,548,548,14,14,13,13,1,6,5,1,5,0,0,0,1,0
1007,998,989,989,13,14,12,13,2,1,3,1,9,9,0,-1,2,-1
445,440,445,440,17,16,18,18,2,3,1,1,5,-5,5,1,-2,0
914,909,904,904,14,14,13,13,1,4,3,3,5,5,0,0,1,0
187,182,182,182,21,19,21,21,1,1,1,1,5,0,0,2,-2,0
431,431,426,426,13,14,12,13,3,2,1,3,0,5,0,-1,2,-1
993,989,989,989,17,16,18,18,1,1,1,3,4,0,0,1,-2,0
384,374,374,374,13,14,12,13,1,3,1,2,10,0,0,-1,2,-1
1036,1031,1026,1031,17,16,15,16,1,3,2,1,5,5,-5,1,1,-1
745,740,745,740,13,14,12,13,1,3,2,1,5,-5,5,-1,2,-1
210,206,206,201,14,14,13,13,2,2,2,2,4,0,5,0,1,0
707,707,707,707,13,16,15,16,1,1,1,1,0,0,0,-3,1,-1
979,956,965,956,13,14,12,13,2,2,2,1,23,-9,9,-1,2,-1
1059,1054,1050,1050,20,19,18,18,1,2,3,2,5,4,0,1,1,0
346,342,351,337,13,14,15,13,1,1,1,3,4,-9,14,-1,-1,2
403,398,398,393,17,16,18,18,2,1,2,1,5,0,5,1,-2,0
731,731,731,731,13,14,12,13,3,3,1,3,0,0,0,-1,2,-1
576,571,571,567,14,14,13,13,1,2,1,1,5,0,4,0,1,0
726,717,721,717,13,14,12,13,3,2,2,2,9,-4,4,-1,2,-1
1021,1007,1012,1007,13,14,15,13,2,2,2,1,14,-5,5,-1,-1,2
356,346,346,346,13,14,15,13,1,2,2,1,10,0,0,-1,-1,2
271,248,248,248,21,19,20,21,2,3,2,1,23,0,0,2,-1,-1
801,787,787,787,14,14,15,16,1,2,1,1,14,0,0,0,-1,-1
909,900,918,928,14,14,13,13,3,2,2,1,9,-18,-10,0,1,0
726,745,740,740,13,14,15,13,2,1,3,1,-19,5,0,-1,-1,2
581,576,581,571,14,14,13,13,3,3,2,2,5,-5,10,0,1,0
970,951,942,942,17,16,15,16,4,3,1,1,19,9,0,1,1,-1
520,506,501,501,14,14,15,13,3,3,1,1,14,5,0,0,-1,2
693,689,689,679,13,14,12,13,1,2,2,1,4,0,10,-1,2,-1
374,360,351,346,13,14,12,13,3,3,2,1,14,9,5,-1,2,-1
323,304,304,300,14,14,13,13,2,2,1,2,19,0,4,0,1,0
360,360,360,356,20,19,20,18,1,2,2,1,0,0,4,1,-1,2
1040,1031,1031,1031,20,19,18,18,3,2,3,1,9,0,0,1,1,0
389,379,374,374,13,14,12,13,1,2,3,1,10,5,0,-1,2,-1
374,370,370,365,13,16,15,16,1,2,2,2,4,0,5,-3,1,-1
604,595,604,604,14,14,15,13,2,2,1,1,9,-9,0,0,-1,2
436,426,426,426,13,16,15,16,3,5,1,3,10,0,0,-3,1,-1
937,937,937,937,17,16,15,16,1,3,2,1,0,0,0,1,1,-1
646,646,642,642,17,19,18,18,4,1,1,2,0,4,0,-2,1,0
965,960,956,960,20,19,20,21,2,1,1,1,5,4,-4,1,-1,-1
937,937,937,932,17,16,18,16,2,3,2,1,0,0,5,1,-2,2
970,965,960,960,20,19,18,18,3,3,1,2,5,5,0,1,1,0
810,810,806,801,14,17,15,16,2,2,2,2,0,4,5,-3,2,-1
510,501,506,506,18,19,18,19,1,4,1,1,9,-5,0,-1,1,-1
229,229,229,224,14,14,13,13,2,2,2,2,0,0,5,0,1,0
215,210,206,206,18,19,18,19,1,3,1,1,5,4,0,-1,1,-1
332,332,337,332,17,16,15,16,1,1,2,1,0,-5,5,1,1,-1
721,717,721,721,20,19,18,18,3,1,2,1,4,-4,0,1,1,0
1007,993,989,989,13,14,15,13,2,1,4,2,14,4,0,-1,-1,2
412,407,407,407,20,19,18,18,1,1,3,1,5,0,0,1,1,0
909,909,904,904,18,17,18,16,5,2,1,1,0,5,0,1,-1,2
773,768,721,773,17,16,18,16,1,4,2,1,5,47,-52,1,-2,2
904,900,895,895,14,17,15,16,2,1,1,1,4,5,0,-3,2,-1
253,248,248,243,18,17,18,18,1,2,1,2,5,0,5,1,-1,0
914,909,909,909,21,19,21,19,1,1,1,1,5,0,0,2,-2,2
956,951,942,942,17,16,15,16,1,3,1,1,5,9,0,1,1,-1
440,436,436,436,17,16,18,16,1,1,1,3,4,0,0,1,-2,2
628,618,618,623,14,17,15,16,1,2,2,1,10,0,-5,-3,2,-1
286,290,286,286,14,14,15,16,2,3,1,2,-4,4,0,0,-1,-1
548,539,534,534,14,17,15,16,1,3,2,1,9,5,0,-3,2,-1
604,590,576,595,18,17,15,16,1,1,3,1,14,14,-19,1,2,-1
979,979,974,909,17,16,18,13,3,1,1,1,0,5,65,1,-2,5
829,829,829,834,18,17,18,16,4,1,1,1,0,0,-5,1,-1,2
529,520,524,524,21,19,20,21,6,2,1,1,9,-4,0,2,-1,-1
820,810,810,810,18,19,20,19,2,2,1,1,10,0,0,-1,-1,1
407,403,403,403,20,19,18,18,2,2,3,1,4,0,0,1,1,0
674,660,660,660,13,14,12,13,2,1,1,3,14,0,0,-1,2,-1
215,206,206,206,18,19,20,19,3,2,1,1,9,0,0,-1,-1,1
914,909,909,909,14,14,13,13,1,1,2,3,5,0,0,0,1,0
806,801,801,801,18,17,18,19,1,4,1,2,5,0,0,1,-1,-1
239,234,239,229,14,14,13,13,2,1,1,2,5,-5,10,0,1,0
501,496,496,492,18,19,18,19,2,1,1,2,5,0,4,-1,1,-1
351,346,342,346,20,19,18,18,3,1,1,1,5,4,-4,1,1,0
674,665,670,670,17,16,15,16,1,1,2,1,9,-5,0,1,1,-1
637,632,637,632,13,14,15,13,2,2,2,1,5,-5,5,-1,-1,2
609,604,604,609,21,19,20,19,3,1,1,1,5,0,-5,2,-1,1
553,548,548,543,14,14,15,13,2,2,1,1,5,0,5,0,-1,2
970,965,960,946,13,14,12,13,3,3,1,1,5,5,14,-1,2,-1
787,787,782,787,21,19,21,21,1,1,1,1,0,5,-5,2,-2,0
281,267,276,276,21,19,20,18,3,1,1,1,14,-9,0,2,-1,2
970,965,965,965,20,19,20,18,1,2,1,2,5,0,0,1,-1,2
576,567,576,581,14,14,15,13,4,2,1,3,9,-9,-5,0,-1,2
871,862,862,862,18,17,18,18,1,2,1,1,9,0,0,1,-1,0
651,646,646,646,20,19,18,18,2,1,2,1,5,0,0,1,1,0
806,801,801,796,14,17,15,16,1,2,2,2,5,0,5,-3,2,-1
609,759,595,595,18,16,18,16,2,1,3,1,-150,164,0,2,-2,2
642,632,642,637,13,14,15,13,5,2,2,1,10,-10,5,-1,-1,2
403,403,398,398,20,19,20,21,1,3,1,1,0,5,0,1,-1,-1
979,979,974,970,17,16,18,18,1,1,2,1,0,5,4,1,-2,0
829,824,829,824,14,17,15,16,3,2,2,1,5,-5,5,-3,2,-1
693,689,689,684,17,16,15,16,3,2,2,3,4,0,5,1,1,-1
215,215,215,210,18,17,18,16,2,1,2,1,0,0,5,1,-1,2
1050,1045,1040,1036,17,16,18,18,1,3,2,2,5,5,4,1,-2,0
445,440,440,440,20,19,20,18,1,3,1,2,5,0,0,1,-1,2
1040,1040,1040,1040,13,14,15,13,2,1,1,1,0,0,0,-1,-1,2
436,431,426,426,13,14,15,16,1,2,1,3,5,5,0,-1,-1,-1
876,876,876,871,14,14,13,13,2,2,2,2,0,0,5,0,1,0
801,796,796,801,18,17,18,19,3,3,2,1,5,0,-5,1,-1,-1
473,473,473,473,20,19,20,21,1,2,1,1,0,0,0,1,-1,-1
262,253,248,243,14,14,13,13,3,3,2,1,9,5,5,0,1,0
337,337,337,332,20,19,20,21,1,1,3,2,0,0,5,1,-1,-1
604,604,642,656,18,17,18,18,1,3,2,2,0,-38,-14,1,-1,0
839,829,824,820,18,19,18,19,1,1,2,2,10,5,4,-1,1,-1
1003,1003,998,993,17,16,18,18,3,1,1,2,0,5,5,1,-2,0
1068,1064,1064,1059,13,14,12,13,3,2,1,2,4,0,5,-1,2,-1
689,684,684,684,17,16,18,16,1,1,1,3,5,0,0,1,-2,2
614,600,600,595,18,19,18,19,1,2,3,2,14,0,5,-1,1,-1
628,623,623,623,21,19,21,21,1,2,1,1,5,0,0,2,-2,0
454,450,440,440,20,19,18,18,2,2,1,2,4,10,0,1,1,0
1078,1073,1073,1068,13,14,15,13,2,3,2,1,5,0,5,-1,-1,2
820,820,815,810,14,14,13,13,3,3,2,2,0,5,5,0,1,0
834,801,792,796,14,17,15,16,2,3,3,2,33,9,-4,-3,2,-1
543,539,543,539,14,14,15,16,3,2,1,1,4,-4,4,0,-1,-1
806,806,806,806,14,17,15,16,2,1,1,1,0,0,0,-3,2,-1
337,337,332,328,17,16,18,19,1,1,1,1,0,5,4,1,-2,-1
196,187,192,192,21,19,21,19,3,1,1,1,9,-5,0,2,-2,2
1012,1012,998,993,13,14,15,16,2,2,3,2,0,14,5,-1,-1,-1
384,374,374,370,17,16,18,16,3,1,1,1,10,0,4,1,-2,2
979,974,970,974,13,14,15,16,1,2,3,1,5,4,-4,-1,-1,-1
1021,1012,1017,1017,13,14,12,13,3,2,1,1,9,-5,0,-1,2,-1
914,909,909,909,18,19,18,19,2,2,1,3,5,0,0,-1,1,-1
1007,998,1003,1003,17,16,18,16,3,2,2,3,9,-5,0,1,-2,2
286,267,267,267,14,14,15,13,2,2,2,3,19,0,0,0,-1,2
234,229,239,234,14,14,13,13,1,1,2,1,5,-10,5,0,1,0
1054,1045,1050,1045,13,14,15,13,3,2,1,1,9,-5,5,-1,-1,2
829,820,824,824,18,17,18,19,1,3,2,1,9,-4,0,1,-1,-1
562,548,553,548,14,14,13,13,1,2,1,1,14,-5,5,0,1,0
871,867,862,862,14,17,15,16,1,1,1,2,4,5,0,-3,2,-1
267,262,262,267,14,14,15,13,1,1,1,3,5,0,-5,0,-1,2
998,989,989,989,20,19,20,21,1,3,1,1,9,0,0,1,-1,-1
764,759,759,754,20,19,20,18,2,1,2,3,5,0,5,1,-1,2
239,239,239,239,14,17,15,16,2,1,1,1,0,0,0,-3,2,-1
909,904,904,904,21,19,20,21,1,2,1,2,5,0,0,2,-1,-1
510,515,506,506,14,14,13,13,2,1,1,1,-5,9,0,0,1,0
600,581,586,586,14,17,15,16,2,3,1,1,19,-5,0,-3,2,-1
431,421,421,417,13,14,15,13,1,2,2,3,10,0,4,-1,-1,2
393,379,379,370,13,14,12,13,2,1,1,2,14,0,9,-1,2,-1
914,900,900,900,14,17,15,16,2,3,1,2,14,0,0,-3,2,-1
736,731,731,731,13,14,12,13,3,1,2,3,5,0,0,-1,2,-1
660,660,656,656,13,14,15,13,3,1,1,1,0,4,0,-1,-1,2
496,496,492,492,14,17,15,16,2,1,1,1,0,4,0,-3,2,-1
473,464,468,464,20,19,20,21,2,2,1,1,9,-4,4,1,-1,-1
337,332,328,323,20,19,18,19,3,1,1,2,5,4,5,1,1,-1
393,393,393,389,17,16,15,16,1,2,3,3,0,0,4,1,1,-1
998,993,989,989,17,16,18,16,2,1,3,3,5,4,0,1,-2,2
210,206,206,206,14,14,13,13,3,2,2,1,4,0,0,0,1,0
421,417,417,417,13,14,15,16,2,5,2,2,4,0,0,-1,-1,-1
478,1059,1054,1054,17,19,20,21,1,2,1,2,-581,5,0,-2,-1,-1
281,276,276,276,14,14,15,13,2,2,3,1,5,0,0,0,-1,2
937,937,937,937,20,19,18,18,1,2,1,1,0,0,0,1,1,0
843,834,839,839,18,19,18,18,2,3,1,2,9,-5,0,-1,1,0
834,829,824,824,14,14,15,13,1,2,1,2,5,5,0,0,-1,2
914,909,909,928,21,19,21,21,1,3,1,1,5,0,-19,2,-2,0
960,951,956,956,13,14,12,13,2,2,2,1,9,-5,0,-1,2,-1
1068,1059,1064,1064,20,19,20,18,1,1,2,1,9,-5,0,1,-1,2
440,436,436,436,20,19,20,21,2,3,1,1,4,0,0,1,-1,-1
989,984,974,974,17,16,18,18,1,1,1,1,5,10,0,1,-2,0
417,412,407,403,20,19,20,18,2,1,1,2,5,5,4,1,-1,2
965,965,965,960,20,19,20,18,3,1,4,2,0,0,5,1,-1,2
787,773,773,773,14,14,15,13,1,3,3,2,14,0,0,0,-1,2
262,262,257,257,21,19,20,18,3,1,2,1,0,5,0,2,-1,2
806,806,806,806,14,14,15,13,3,2,2,2,0,0,0,0,-1,2
942,932,923,923,13,16,15,16,1,2,1,2,10,9,0,-3,1,-1
304,290,281,286,14,14,13,13,1,2,1,1,14,9,-5,0,1,0
571,562,557,557,14,17,15,16,3,1,1,1,9,5,0,-3,2,-1
398,389,389,389,17,16,18,16,3,3,2,1,9,0,0,1,-2,2
759,754,754,754,20,19,18,18,1,3,1,1,5,0,0,1,1,0
581,581,581,581,14,14,13,13,2,2,2,2,0,0,0,0,1,0
239,229,229,224,21,19,20,19,1,3,1,1,10,0,5,2,-1,1
342,332,337,337,20,19,18,18,1,1,1,1,10,-5,0,1,1,0
510,501,506,501,14,17,15,16,1,2,2,1,9,-5,5,-3,2,-1
1031,1026,1026,1017,20,19,18,18,2,2,1,2,5,0,9,1,1,0
478,468,468,468,20,19,20,18,1,1,1,1,10,0,0,1,-1,2
492,492,487,487,21,19,21,21,2,1,3,1,0,5,0,2,-2,0
796,787,792,787,18,19,18,19,3,1,2,2,9,-5,5,-1,1,-1
271,271,267,262,18,17,18,18,1,1,2,2,0,4,5,1,-1,0
923,923,928,923,18,17,18,16,2,1,1,2,0,-5,5,1,-1,2
557,534,524,520,14,14,13,13,4,2,2,3,23,10,4,0,1,0
918,904,900,904,14,14,15,13,3,1,3,2,14,4,-4,0,-1,2
553,553,543,548,18,19,18,18,2,3,3,1,0,10,-5,-1,1,0
956,937,942,942,17,16,18,18,1,1,2,3,19,-5,0,1,-2,0
192,187,192,187,14,14,15,13,1,1,2,1,5,-5,5,0,-1,2
951,942,946,942,17,16,15,16,1,2,2,2,9,-4,4,1,1,-1
337,337,337,332,17,19,18,18,3,3,2,1,0,0,5,-2,1,0
478,478,473,473,17,16,18,16,2,1,1,1,0,5,0,1,-2,2
646,637,628,623,13,14,13,13,2,1,2,2,9,9,5,-1,1,0
398,393,398,398,17,19,18,18,1,2,1,1,5,-5,0,-2,1,0
220,215,215,215,14,14,15,16,3,3,2,2,5,0,0,0,-1,-1
684,684,684,684,20,19,20,18,1,1,1,2,0,0,0,1,-1,2
581,571,562,557,14,17,15,16,2,1,4,3,10,9,5,-3,2,-1
187,196,192,187,14,14,15,13,2,3,1,2,-9,4,5,0,-1,2
403,398,398,398,13,14,12,13,1,2,2,1,5,0,0,-1,2,-1
262,248,253,248,14,17,15,16,3,2,2,1,14,-5,5,-3,2,-1
576,581,576,576,18,19,18,18,3,1,4,1,-5,5,0,-1,1,0
342,337,346,342,20,19,20,18,1,4,1,2,5,-9,4,1,-1,2
337,342,337,337,17,16,18,16,1,1,1,2,-5,5,0,1,-2,2
1059,1059,1059,1064,20,19,18,18,3,1,1,3,0,0,-5,1,1,0
1059,1059,1054,1059,20,19,20,21,1,2,1,1,0,5,-5,1,-1,-1
1040,1036,1031,1026,20,19,18,18,2,3,1,1,4,5,5,1,1,0
281,262,262,257,14,14,13,13,1,2,1,3,19,0,5,0,1,0
614,604,604,600,14,17,15,16,3,2,2,1,10,0,4,-3,2,-1
271,267,267,267,18,19,18,18,1,2,3,1,4,0,0,-1,1,0
796,787,787,787,14,17,15,16,1,3,1,1,9,0,0,-3,2,-1
764,759,759,759,17,16,18,16,2,2,1,1,5,0,0,1,-2,2
557,548,548,553,14,14,15,13,3,2,1,1,9,0,-5,0,-1,2
520,520,520,520,21,19,20,21,2,2,1,1,0,0,0,2,-1,-1
886,881,876,871,21,19,20,21,3,1,2,1,5,5,5,2,-1,-1
473,473,473,478,20,19,20,21,2,3,1,1,0,0,-5,1,-1,-1
196,187,187,187,21,19,21,19,1,2,1,1,9,0,0,2,-2,2
464,450,450,450,13,14,15,13,2,2,3,2,14,0,0,-1,-1,2
192,182,187,187,18,19,18,19,1,2,3,1,10,-5,0,-1,1,-1
750,736,731,745,17,16,18,16,1,2,3,2,14,5,-14,1,-2,2
623,604,604,609,14,17,15,16,1,1,1,1,19,0,-5,-3,2,-1
646,642,637,642,13,14,12,13,2,2,1,3,4,5,-5,-1,2,-1
1054,1050,1054,1050,17,16,15,16,3,2,2,2,4,-4,4,1,1,-1
229,224,224,220,18,19,18,19,1,2,1,3,5,0,4,-1,1,-1
192,187,192,187,14,14,15,13,1,3,2,1,5,-5,5,0,-1,2
904,890,886,886,14,17,15,16,3,3,1,1,14,4,0,-3,2,-1
651,646,637,642,13,16,15,16,3,1,1,1,5,9,-5,-3,1,-1
342,337,342,323,17,16,15,16,1,2,3,1,5,-5,19,1,1,-1
295,281,281,281,14,14,13,13,3,2,2,1,14,0,0,0,1,0
389,384,389,384,13,14,12,13,2,1,2,1,5,-5,5,-1,2,-1
576,562,567,567,18,17,18,16,1,1,1,2,14,-5,0,1,-1,2
187,187,187,1073,18,17,18,18,3,1,2,2,0,0,-886,1,-1,0
206,196,201,196,14,17,15,16,1,2,2,1,10,-5,5,-3,2,-1
426,426,426,421,17,16,18,18,1,1,1,1,0,0,5,1,-2,0
876,867,862,862,14,14,15,13,2,3,2,1,9,5,0,0,-1,2
314,309,309,304,14,14,15,13,1,1,2,2,5,0,5,0,-1,2
993,984,979,984,13,14,12,13,2,2,4,3,9,5,-5,-1,2,-1
1040,1031,1036,1036,20,19,20,18,1,2,1,1,9,-5,0,1,-1,2
543,539,534,539,14,14,13,13,3,3,1,3,4,5,-5,0,1,0
871,867,871,871,21,19,20,18,2,1,1,1,4,-4,0,2,-1,2
337,323,323,323,13,14,13,13,2,2,1,1,14,0,0,-1,1,0
1007,993,993,993,17,16,18,18,1,2,2,1,14,0,0,1,-2,0
717,712,717,717,17,16,18,18,2,3,3,2,5,-5,0,1,-2,0
886,881,881,881,18,19,18,19,3,2,1,2,5,0,0,-1,1,-1
1007,1003,998,998,20,19,20,21,1,1,1,1,4,5,0,1,-1,-1
1050,1050,1045,1040,20,19,20,21,3,3,1,1,0,5,5,1,-1,-1
656,646,646,642,20,19,20,18,2,1,1,2,10,0,4,1,-1,2
670,665,665,665,20,19,20,21,3,2,2,1,5,0,0,1,-1,-1
586,581,586,586,14,14,15,16,2,2,2,3,5,-5,0,0,-1,-1
684,684,684,679,20,19,20,18,1,1,2,1,0,0,5,1,-1,2
365,365,365,360,17,16,18,18,3,1,2,1,0,0,5,1,-2,0
454,445,440,445,17,16,18,18,2,1,3,1,9,5,-5,1,-2,0
946,942,942,942,20,19,20,18,2,3,1,1,4,0,0,1,-1,2
257,253,253,253,18,17,18,18,1,1,2,1,4,0,0,1,-1,0
337,332,332,323,17,19,18,19,2,1,1,2,5,0,9,-2,1,-1
374,365,370,384,17,16,18,21,1,2,1,1,9,-5,-14,1,-2,-3
848,848,848,843,21,19,20,18,1,1,2,1,0,0,5,2,-1,2
586,576,581,576,18,17,18,18,1,1,1,1,10,-5,5,1,-1,0
717,712,750,712,17,16,18,16,1,1,1,1,5,-38,38,1,-2,2
1007,1007,1003,998,17,16,18,16,3,1,1,2,0,4,5,1,-2,2
548,548,543,553,14,14,15,13,2,3,1,1,0,5,-10,0,-1,2
1073,1059,1064,1059,20,19,20,18,4,3,2,1,14,-5,5,1,-1,2
853,853,853,853,21,19,20,18,1,2,1,2,0,0,0,2,-1,2
1031,1017,1021,1017,13,14,12,13,1,4,2,1,14,-4,4,-1,2,-1
881,881,876,876,14,14,15,13,1,1,1,2,0,5,0,0,-1,2
370,365,360,360,20,19,18,18,2,3,1,1,5,5,0,1,1,0
918,918,923,918,18,19,18,19,2,2,1,3,0,-5,5,-1,1,-1
974,974,970,974,13,14,15,13,1,3,1,1,0,4,-4,-1,-1,2
276,276,276,271,18,19,20,18,2,1,1,2,0,0,5,-1,-1,2
750,745,750,745,13,14,15,13,3,4,1,2,5,-5,5,-1,-1,2
965,956,946,951,17,16,18,16,1,3,4,1,9,10,-5,1,-2,2
539,529,529,524,18,19,18,19,1,2,1,1,10,0,5,-1,1,-1
773,773,768,768,13,14,12,13,1,3,1,1,0,5,0,-1,2,-1
970,965,960,956,13,14,12,13,1,3,1,2,5,5,4,-1,2,-1
801,796,796,801,18,19,18,19,1,3,1,2,5,0,-5,-1,1,-1
314,309,300,300,14,17,15,16,3,1,2,1,5,9,0,-3,2,-1
871,857,862,862,14,17,15,16,1,2,2,1,14,-5,0,-3,2,-1
1026,1036,1026,1021,13,14,15,16,1,1,4,2,-10,10,5,-1,-1,-1
374,370,370,370,20,19,18,18,1,2,1,2,4,0,0,1,1,0
482,478,473,473,18,16,18,18,2,1,1,1,4,5,0,2,-2,0
829,824,820,815,14,17,15,16,3,1,3,1,5,4,5,-3,2,-1
623,623,623,623,14,17,15,16,2,3,3,1,0,0,0,-3,2,-1
637,632,632,632,20,19,20,21,1,1,1,1,5,0,0,1,-1,-1
520,515,515,515,14,17,15,16,1,2,2,3,5,0,0,-3,2,-1
220,215,215,210,18,19,18,19,1,1,2,1,5,0,5,-1,1,-1
496,492,492,487,14,17,15,16,2,1,1,1,4,0,5,-3,2,-1
417,412,412,412,20,19,20,18,2,2,1,2,5,0,0,1,-1,2
904,904,900,904,14,14,13,13,2,3,1,1,0,4,-4,0,1,0
707,698,703,698,20,19,18,18,1,2,1,4,9,-5,5,1,1,0
337,332,328,332,20,19,21,21,2,1,1,1,5,4,-4,1,-2,0
782,782,787,782,18,19,18,19,2,1,2,1,0,-5,5,-1,1,-1
337,332,337,332,17,16,18,16,2,2,2,1,5,-5,5,1,-2,2
1054,1050,1040,1040,17,16,15,16,2,4,1,1,4,10,0,1,1,-1
614,609,609,604,14,14,13,13,3,1,2,1,5,0,5,0,1,0
918,914,909,909,14,17,15,16,2,1,2,1,4,5,0,-3,2,-1
595,553,548,553,14,14,15,16,1,1,1,1,42,5,-5,0,-1,-1
764,759,764,754,13,14,12,13,3,2,3,2,5,-5,10,-1,2,-1
286,271,267,267,14,17,15,16,3,2,3,3,15,4,0,-3,2,-1
759,750,750,750,17,19,18,18,3,3,1,1,9,0,0,-2,1,0
665,660,670,670,17,16,15,16,1,1,2,3,5,-10,0,1,1,-1
506,501,501,496,18,19,18,19,2,2,5,2,5,0,5,-1,1,-1
243,239,243,239,18,17,18,18,1,2,1,2,4,-4,4,1,-1,0
834,824,820,815,14,14,13,13,1,2,1,2,10,4,5,0,1,0
707,698,698,698,17,16,18,16,2,1,1,1,9,0,0,1,-2,2
806,796,792,796,14,17,15,16,2,1,3,1,10,4,-4,-3,2,-1
670,660,651,646,20,19,20,18,2,1,2,1,10,9,5,1,-1,2
834,824,824,829,14,14,15,13,3,2,3,1,10,0,-5,0,-1,2
609,614,614,614,21,19,21,21,2,3,1,1,-5,0,0,2,-2,0
407,403,398,398,17,16,18,16,3,1,1,4,4,5,0,1,-2,2
726,726,726,721,20,19,20,21,5,1,2,2,0,0,5,1,-1,-1
1045,1040,1040,1040,13,14,12,13,2,1,2,3,5,0,0,-1,2,-1
586,581,581,581,18,19,18,19,1,1,1,1,5,0,0,-1,1,-1
407,407,412,407,13,14,15,16,1,2,2,3,0,-5,5,-1,-1,-1
759,754,759,754,17,16,15,16,3,4,2,1,5,-5,5,1,1,-1
862,853,848,848,14,14,13,13,3,3,3,2,9,5,0,0,1,0
351,346,346,346,17,16,18,16,1,1,1,1,5,0,0,1,-2,2
932,932,928,932,20,19,18,18,1,1,1,2,0,4,-4,1,1,0
787,782,787,782,14,14,15,16,3,2,2,1,5,-5,5,0,-1,-1
253,248,248,243,21,19,20,21,1,1,1,2,5,0,5,2,-1,-1
703,693,703,712,17,19,18,18,2,1,3,2,10,-10,-9,-2,1,0
248,248,243,243,14,17,15,16,3,1,2,3,0,5,0,-3,2,-1
239,239,234,239,18,19,18,18,1,2,1,1,0,5,-5,-1,1,0
440,436,436,436,20,19,20,18,1,1,2,2,4,0,0,1,-1,2
248,243,243,239,14,17,15,16,1,2,1,1,5,0,4,-3,2,-1
215,210,210,210,14,14,15,16,1,3,3,3,5,0,0,0,-1,-1
951,946,956,960,20,19,18,18,1,1,2,4,5,-10,-4,1,1,0
314,304,309,309,21,19,21,21,2,2,1,1,10,-5,0,2,-2,0
1059,1050,1050,1050,13,14,12,13,3,1,1,1,9,0,0,-1,2,-1
374,370,365,356,13,14,12,13,3,3,1,2,4,5,9,-1,2,-1
909,909,909,909,14,17,15,16,3,2,2,1,0,0,0,-3,2,-1
229,224,220,229,14,14,15,13,1,3,1,1,5,4,-9,0,-1,2
824,820,815,815,14,17,15,16,2,3,1,3,4,5,0,-3,2,-1
689,684,684,674,17,16,18,16,1,2,1,1,5,0,10,1,-2,2
586,581,581,576,18,17,18,18,1,1,1,3,5,0,5,1,-1,0
801,792,787,773,14,14,15,13,1,3,2,2,9,5,14,0,-1,2
1054,1054,1050,1050,17,16,18,18,1,1,1,2,0,4,0,1,-2,0
750,698,698,698,17,19,18,18,1,1,2,1,52,0,0,-2,1,0
445,445,440,445,20,19,18,18,3,2,1,1,0,5,-5,1,1,0
487,487,473,478,14,14,15,13,3,3,1,1,0,14,-5,0,-1,2
703,698,693,698,13,14,15,13,2,1,1,1,5,5,-5,-1,-1,2
871,871,871,867,14,17,15,16,1,3,2,1,0,0,4,-3,2,-1
1050,1045,1040,1040,13,14,15,13,2,3,1,3,5,5,0,-1,-1,2
956,951,956,951,13,14,12,13,3,2,2,1,5,-5,5,-1,2,-1
998,998,993,993,20,19,18,18,1,1,1,1,0,5,0,1,1,0
365,360,360,356,20,19,18,18,2,1,2,2,5,0,4,1,1,0
862,853,853,857,18,19,18,18,1,2,1,2,9,0,-4,-1,1,0
942,937,932,932,13,14,15,13,3,1,1,1,5,5,0,-1,-1,2
295,295,295,290,18,17,18,19,2,1,2,1,0,0,5,1,-1,-1
600,576,581,586,14,14,13,13,1,2,1,1,24,-5,-5,0,1,0
623,412,412,407,14,14,12,13,1,2,2,2,211,0,5,0,2,-1
501,473,473,473,14,14,15,13,2,2,2,1,28,0,0,0,-1,2
815,815,806,806,21,19,20,21,1,3,1,2,0,9,0,2,-1,-1
815,796,796,796,14,14,15,13,3,2,2,3,19,0,0,0,-1,2
450,450,445,440,13,14,15,13,1,3,3,1,0,5,5,-1,-1,2
717,712,712,707,13,14,15,16,1,3,3,1,5,0,5,-1,-1,-1
492,492,487,487,18,17,18,19,2,1,1,1,0,5,0,1,-1,-1
478,473,473,468,17,16,18,18,2,1,2,2,5,0,5,1,-2,0
993,984,984,984,17,16,18,18,4,3,1,1,9,0,0,1,-2,0
440,431,436,440,13,14,15,13,1,2,1,1,9,-5,-4,-1,-1,2
224,224,229,229,14,17,15,16,2,2,2,1,0,-5,0,-3,2,-1
501,506,501,501,14,17,15,16,4,3,1,1,-5,5,0,-3,2,-1
318,314,314,314,14,17,15,16,3,2,3,1,4,0,0,-3,2,-1
379,379,379,374,13,14,12,13,3,3,3,2,0,0,5,-1,2,-1
642,632,637,632,17,16,18,16,2,1,2,1,10,-5,5,1,-2,2
660,651,660,656,17,16,15,16,3,2,3,2,9,-9,4,1,1,-1
398,389,384,384,13,14,12,13,4,3,1,1,9,5,0,-1,2,-1
928,923,923,918,14,17,15,16,1,2,2,2,5,0,5,-3,2,-1
942,946,946,942,20,19,20,21,1,2,1,1,-4,0,4,1,-1,-1
984,979,984,979,13,14,12,13,2,1,3,4,5,-5,5,-1,2,-1
323,314,309,309,14,17,15,16,2,4,1,1,9,5,0,-3,2,-1
932,918,909,909,17,17,18,19,1,2,1,1,14,9,0,0,-1,-1
946,942,946,942,17,16,15,16,1,2,2,1,4,-4,4,1,1,-1
1040,1040,1040,1040,20,19,20,21,1,1,2,1,0,0,0,1,-1,-1
703,689,689,684,13,14,12,13,2,3,2,1,14,0,5,-1,2,-1
534,520,520,520,18,17,15,16,2,2,2,1,14,0,0,1,2,-1
965,956,960,956,20,19,18,18,4,2,1,2,9,-4,4,1,1,0
417,412,412,407,13,14,12,13,2,5,1,2,5,0,5,-1,2,-1
553,548,539,539,14,17,15,16,2,1,1,2,5,9,0,-3,2,-1
309,295,290,290,21,19,20,19,1,1,1,2,14,5,0,2,-1,1
1078,1073,1073,1068,13,16,15,16,1,1,2,2,5,0,5,-3,1,-1
224,220,220,215,14,14,13,13,2,1,3,1,4,0,5,0,1,0
918,914,914,914,14,14,15,13,3,3,2,3,4,0,0,0,-1,2
773,773,778,778,13,14,13,13,1,2,1,1,0,-5,0,-1,1,0
492,487,482,482,14,17,15,16,1,1,1,1,5,5,0,-3,2,-1
328,318,314,314,21,19,21,21,1,2,1,1,10,4,0,2,-2,0
979,974,970,970,17,16,18,18,2,2,1,2,5,4,0,1,-2,0
501,496,496,492,14,14,13,13,2,2,2,1,5,0,4,0,1,0
590,590,590,590,18,17,18,19,1,1,1,3,0,0,0,1,-1,-1
1026,1012,1021,1017,13,14,12,13,1,2,2,3,14,-9,4,-1,2,-1
515,520,520,515,14,17,15,16,2,2,2,2,-5,0,5,-3,2,-1
553,553,557,553,14,14,15,13,4,2,1,3,0,-4,4,0,-1,2
192,192,192,187,21,19,21,21,2,1,1,1,0,0,5,2,-2,0
215,215,215,210,14,17,15,16,2,2,2,1,0,0,5,-3,2,-1
529,529,524,524,21,19,20,21,2,1,1,2,0,5,0,2,-1,-1
726,712,717,726,13,14,15,13,2,4,2,1,14,-5,-9,-1,-1,2
773,768,768,764,17,19,18,18,2,2,2,2,5,0,4,-2,1,0
281,271,276,271,18,19,18,18,1,2,1,1,10,-5,5,-1,1,0
412,407,407,403,13,14,12,13,2,2,2,2,5,0,4,-1,2,-1
960,956,956,956,20,19,20,21,2,1,1,2,4,0,0,1,-1,-1
506,501,492,492,14,17,15,16,1,2,3,1,5,9,0,-3,2,-1
351,351,356,346,13,14,15,13,1,1,2,2,0,-5,10,-1,-1,2
323,318,309,304,14,17,15,16,2,1,2,2,5,9,5,-3,2,-1
182,1073,1073,1073,18,16,18,18,1,2,1,2,-891,0,0,2,-2,0
201,201,196,196,14,14,13,13,2,1,1,3,0,5,0,0,1,0
539,529,534,534,18,19,18,18,2,2,3,1,10,-5,0,-1,1,0
553,539,534,539,14,14,13,13,3,2,3,2,14,5,-5,0,1,0
946,937,937,937,13,14,15,13,3,1,2,1,9,0,0,-1,-1,2
543,543,539,539,14,17,15,16,1,3,1,3,0,4,0,-3,2,-1
946,942,937,937,13,14,15,13,1,3,1,2,4,5,0,-1,-1,2
590,586,586,581,14,14,15,13,5,3,3,4,4,0,5,0,-1,2
389,389,389,384,13,16,15,16,1,1,3,1,0,0,5,-3,1,-1
567,557,553,553,18,19,18,18,1,3,3,1,10,4,0,-1,1,0
1059,1064,1045,1040,20,19,20,21,1,2,2,5,-5,19,5,1,-1,-1
501,487,487,473,18,17,18,16,1,3,2,3,14,0,14,1,-1,2
206,201,192,196,18,17,18,19,1,1,1,2,5,9,-4,1,-1,-1
562,557,567,567,18,19,18,18,1,1,1,1,5,-10,0,-1,1,0
478,473,468,464,13,14,15,13,1,1,2,2,5,5,4,-1,-1,2
642,618,750,618,13,14,10,13,2,2,1,3,24,-132,132,-1,4,-3
628,623,623,618,14,17,15,16,1,3,1,2,5,0,5,-3,2,-1
300,286,286,281,14,14,13,13,2,5,2,1,14,0,5,0,1,0
539,529,534,529,18,17,18,16,1,3,2,2,10,-5,5,1,-1,2
356,342,342,332,17,16,15,16,2,1,2,2,14,0,10,1,1,-1
407,393,393,389,13,14,12,13,2,2,2,2,14,0,4,-1,2,-1
665,656,656,656,13,14,15,13,2,2,2,2,9,0,0,-1,-1,2
970,970,979,984,13,14,15,16,1,3,3,1,0,-9,-5,-1,-1,-1
1007,1007,1003,1003,20,19,20,21,1,1,2,2,0,4,0,1,-1,-1
318,314,314,314,21,19,21,21,1,2,1,1,4,0,0,2,-2,0
792,787,787,787,21,19,21,19,2,2,1,2,5,0,0,2,-2,2
726,721,721,721,13,14,12,13,1,3,2,1,5,0,0,-1,2,-1
314,309,304,304,14,14,13,13,3,2,2,2,5,5,0,0,1,0
262,253,257,253,18,17,18,18,1,2,2,2,9,-4,4,1,-1,0
492,482,482,482,14,14,15,13,1,1,1,1,10,0,0,0,-1,2
196,196,192,192,18,17,18,16,1,1,4,1,0,4,0,1,-1,2
281,281,276,276,21,19,20,18,2,2,1,1,0,5,0,2,-1,2
1017,1012,1012,1007,13,16,15,16,1,2,1,2,5,0,5,-3,1,-1
351,337,337,332,17,16,18,18,2,2,1,2,14,0,5,1,-2,0
510,506,506,506,14,14,13,13,3,3,1,3,4,0,0,0,1,0
843,839,839,839,21,19,20,18,1,1,1,1,4,0,0,2,-1,2
614,604,604,604,18,17,18,19,1,2,1,1,10,0,0,1,-1,-1
440,440,440,440,13,14,12,13,1,1,1,1,0,0,0,-1,2,-1
979,970,979,984,20,19,18,18,1,1,2,3,9,-9,-5,1,1,0
590,586,586,586,18,19,18,19,1,1,1,1,4,0,0,-1,1,-1
857,853,848,843,14,14,15,13,2,1,1,2,4,5,5,0,-1,2
384,374,370,370,13,14,15,16,2,1,3,2,10,4,0,-1,-1,-1
946,942,942,937,13,14,15,13,1,3,1,2,4,0,5,-1,-1,2
271,257,257,253,21,19,20,18,1,1,1,1,14,0,4,2,-1,2
281,271,271,276,18,17,18,18,3,3,4,1,10,0,-5,1,-1,0
300,290,290,290,21,19,20,21,2,2,1,3,10,0,0,2,-1,-1
665,660,660,656,13,14,15,13,2,1,3,2,5,0,4,-1,-1,2
342,342,337,337,17,16,15,16,1,3,2,1,0,5,0,1,1,-1
820,824,824,815,14,14,15,13,2,3,2,2,-4,0,9,0,-1,2
295,300,300,304,14,14,15,13,2,2,1,1,-5,0,-4,0,-1,2
234,229,229,229,14,14,13,13,4,3,2,1,5,0,0,0,1,0
1026,1012,1007,1003,13,16,15,16,2,2,1,2,14,5,4,-3,1,-1
848,843,848,839,14,14,15,13,2,2,1,2,5,-5,9,0,-1,2
286,281,281,281,21,19,20,21,1,1,2,2,5,0,0,2,-1,-1
928,923,918,918,18,19,18,19,1,1,3,1,5,5,0,-1,1,-1
210,201,192,187,18,19,18,19,2,3,1,1,9,9,5,-1,1,-1
510,506,506,506,14,14,15,13,2,2,1,3,4,0,0,0,-1,2
731,731,923,726,13,14,15,13,3,3,1,1,0,-192,197,-1,-1,2
1059,1059,1054,1054,20,19,18,18,1,3,1,1,0,5,0,1,1,0
764,759,759,759,17,19,18,18,1,1,1,1,5,0,0,-2,1,0
651,646,642,646,13,14,12,13,1,4,1,1,5,4,-4,-1,2,-1
323,323,323,318,18,17,18,16,2,1,2,1,0,0,5,1,-1,2
1031,1031,1026,1026,17,16,15,16,1,1,3,1,0,5,0,1,1,-1
768,759,764,759,13,14,12,13,3,2,2,3,9,-5,5,-1,2,-1
224,220,215,210,18,19,18,19,2,1,1,2,4,5,5,-1,1,-1
365,360,360,356,13,14,12,13,2,3,1,1,5,0,4,-1,2,-1
379,374,374,370,13,14,15,13,3,2,2,2,5,0,4,-1,-1,2
689,674,670,670,13,14,12,13,2,2,1,2,15,4,0,-1,2,-1
548,539,539,534,18,19,18,18,3,3,1,2,9,0,5,-1,1,0
787,778,778,778,18,16,18,16,3,1,1,1,9,0,0,2,-2,2
515,510,515,510,14,17,15,16,2,3,2,1,5,-5,5,-3,2,-1
224,220,220,220,14,14,13,13,2,1,2,1,4,0,0,0,1,0
243,243,239,243,21,19,20,21,1,1,4,1,0,4,-4,2,-1,-1
295,290,290,295,18,19,18,19,3,3,3,1,5,0,-5,-1,1,-1
586,586,581,576,14,14,15,13,3,3,1,2,0,5,5,0,-1,2
323,318,318,314,18,19,18,19,2,2,1,1,5,0,4,-1,1,-1
295,290,286,286,21,19,20,21,1,1,1,1,5,4,0,2,-1,-1
1059,1054,1054,1054,13,14,15,16,1,2,2,2,5,0,0,-1,-1,-1
684,679,679,998,17,16,15,11,1,1,2,1,5,0,-319,1,1,4
567,557,557,557,14,14,13,13,1,2,2,2,10,0,0,0,1,0
787,782,778,773,18,17,18,18,3,2,1,2,5,4,5,1,-1,0
951,946,946,942,17,16,18,18,3,2,2,1,5,0,4,1,-2,0
229,215,220,224,14,14,13,13,1,3,3,1,14,-5,-4,0,1,0
1073,1073,1078,1073,20,19,20,21,1,1,2,2,0,-5,5,1,-1,-1
346,342,351,351,17,19,18,18,1,4,2,1,4,-9,0,-2,1,0
529,529,524,515,21,19,20,19,2,3,1,2,0,5,9,2,-1,1
914,909,909,909,18,17,18,19,1,2,1,1,5,0,0,1,-1,-1
628,623,623,618,14,17,15,16,1,2,2,2,5,0,5,-3,2,-1
642,637,642,632,17,16,15,16,3,3,2,1,5,-5,10,1,1,-1
374,374,370,370,17,16,18,18,3,1,2,1,0,4,0,1,-2,0
304,300,295,295,18,17,18,16,2,2,3,3,4,5,0,1,-1,2
234,234,229,229,14,17,15,16,2,3,1,1,0,5,0,-3,2,-1
417,417,417,417,17,16,18,18,1,3,2,1,0,0,0,1,-2,0
923,923,923,923,14,14,15,13,2,2,3,3,0,0,0,0,-1,2
867,867,867,857,18,17,18,18,1,5,4,2,0,0,10,1,-1,0
501,496,492,492,14,14,13,13,2,1,1,1,5,4,0,0,1,0
1017,1007,1017,1012,17,16,18,18,1,3,2,1,10,-10,5,1,-2,0
684,674,670,665,20,19,18,18,1,2,2,1,10,4,5,1,1,0
623,623,623,623,21,19,21,21,2,2,2,2,0,0,0,2,-2,0
332,318,328,323,13,14,15,13,1,2,2,2,14,-10,5,-1,-1,2
487,482,478,478,18,17,18,18,2,2,1,1,5,4,0,1,-1,0
618,618,614,614,18,17,18,19,3,1,3,1,0,4,0,1,-1,-1
271,257,253,257,14,14,13,13,3,1,1,1,14,4,-4,0,1,0
1045,1036,1026,1031,13,14,15,16,3,2,2,3,9,10,-5,-1,-1,-1
979,974,979,974,20,19,20,21,3,2,2,3,5,-5,5,1,-1,-1
974,970,993,979,17,16,15,16,1,4,1,1,4,-23,14,1,1,-1
984,974,970,970,13,14,12,13,1,1,1,2,10,4,0,-1,2,-1
843,839,839,839,18,17,18,18,2,1,1,2,4,0,0,1,-1,0
679,674,670,670,17,16,18,16,1,1,1,3,5,4,0,1,-2,2
1003,1003,1003,1007,20,19,20,18,1,1,1,1,0,0,-4,1,-1,2
571,557,562,562,14,17,15,16,3,2,2,2,14,-5,0,-3,2,-1
276,267,262,262,14,14,13,13,1,3,1,1,9,5,0,0,1,0
1068,1059,1050,1045,13,14,15,13,3,1,1,2,9,9,5,-1,-1,2
923,923,923,918,18,17,18,16,3,2,2,2,0,0,5,1,-1,2
881,876,867,871,14,14,13,13,2,2,4,1,5,9,-4,0,1,0
332,332,337,332,17,16,18,18,1,1,2,1,0,-5,5,1,-2,0
318,314,314,314,18,17,18,19,1,1,1,1,4,0,0,1,-1,-1
318,314,318,314,14,14,13,13,2,2,2,1,4,-4,4,0,1,0
979,974,984,979,20,19,20,18,1,2,1,2,5,-10,5,1,-1,2
487,482,478,473,21,19,20,21,1,2,1,2,5,4,5,2,-1,-1
295,295,304,309,18,19,18,19,2,1,1,3,0,-9,-5,-1,1,-1
210,215,220,215,21,19,20,21,2,2,2,2,-5,-5,5,2,-1,-1
895,881,881,876,14,14,13,13,2,2,1,2,14,0,5,0,1,0
590,590,590,590,14,14,15,13,1,2,3,2,0,0,0,0,-1,2
646,642,637,637,20,19,20,21,1,3,1,1,4,5,0,1,-1,-1
951,942,942,937,17,16,18,16,2,4,2,1,9,0,5,1,-2,2
421,412,431,412,17,16,18,18,3,1,1,1,9,-19,19,1,-2,0
304,295,290,290,14,17,15,16,2,4,3,2,9,5,0,-3,2,-1
989,974,979,1021,13,14,15,13,2,2,2,1,15,-5,-42,-1,-1,2
745,745,740,745,13,14,12,13,3,3,3,3,0,5,-5,-1,2,-1
815,815,810,806,18,17,18,16,1,3,1,3,0,5,4,1,-1,2
271,271,267,267,14,14,13,13,2,3,2,1,0,4,0,0,1,0
581,571,571,571,21,19,20,21,3,1,1,1,10,0,0,2,-1,-1
576,571,571,567,14,17,15,16,1,3,4,2,5,0,4,-3,2,-1
853,848,843,839,14,14,13,13,1,2,3,1,5,5,4,0,1,0
801,796,801,801,14,17,15,16,2,2,3,1,5,-5,0,-3,2,-1
1026,1021,1021,1021,17,16,18,16,1,1,1,1,5,0,0,1,-2,2
1073,1059,1068,1068,17,16,18,16,2,2,2,1,14,-9,0,1,-2,2
567,557,562,562,21,19,20,18,1,1,2,1,10,-5,0,2,-1,2
271,262,257,257,18,19,18,18,1,2,3,1,9,5,0,-1,1,0
909,904,895,909,21,19,20,21,1,2,2,2,5,9,-14,2,-1,-1
1054,1045,1040,1040,13,14,12,13,2,2,1,1,9,5,0,-1,2,-1
468,468,468,464,20,19,20,21,1,1,1,2,0,0,4,1,-1,-1
524,520,515,510,18,19,18,19,2,2,2,1,4,5,5,-1,1,-1
609,600,600,595,18,19,18,19,1,1,1,2,9,0,5,-1,1,-1
201,196,196,192,14,14,13,13,2,3,1,2,5,0,4,0,1,0
436,431,431,431,17,16,18,18,2,3,1,1,5,0,0,1,-2,0
253,248,243,243,14,14,15,13,1,2,2,1,5,5,0,0,-1,2
726,731,717,717,20,19,20,18,2,1,1,1,-5,14,0,1,-1,2
857,843,839,839,14,14,15,13,1,2,2,3,14,4,0,0,-1,2
224,210,206,206,14,14,13,13,3,2,1,1,14,4,0,0,1,0
257,253,248,253,18,19,18,18,3,1,1,1,4,5,-5,-1,1,0
314,309,309,309,21,19,21,19,1,3,1,1,5,0,0,2,-2,2
492,492,492,496,18,19,18,19,2,2,1,1,0,0,-4,-1,1,-1
356,351,351,346,20,19,20,18,3,1,2,2,5,0,5,1,-1,2
824,829,824,824,18,17,18,19,2,3,1,1,-5,5,0,1,-1,-1
623,618,609,609,18,19,18,19,1,1,1,2,5,9,0,-1,1,-1
210,215,215,215,14,14,13,13,2,2,2,1,-5,0,0,0,1,0
271,262,257,253,21,19,20,21,1,1,1,2,9,5,4,2,-1,-1
937,932,937,932,17,16,15,16,2,1,2,2,5,-5,5,1,1,-1
309,300,300,295,14,14,13,13,1,1,4,2,9,0,5,0,1,0
815,806,1059,824,14,14,15,13,2,2,1,2,9,-253,235,0,-1,2
904,900,895,900,18,17,18,19,3,1,1,1,4,5,-5,1,-1,-1
496,492,492,487,14,14,13,13,1,1,1,2,4,0,5,0,1,0
778,778,773,773,20,19,20,21,2,1,1,1,0,5,0,1,-1,-1
993,979,979,984,17,16,15,16,1,3,1,1,14,0,-5,1,1,-1
928,923,928,923,14,14,15,13,1,3,2,2,5,-5,5,0,-1,2
473,473,473,468,20,19,18,18,1,1,2,1,0,0,5,1,1,0
346,337,342,342,13,14,15,13,2,2,1,3,9,-5,0,-1,-1,2
623,614,609,609,14,17,15,16,3,2,1,1,9,5,0,-3,2,-1
487,482,487,487,14,14,13,13,3,1,3,3,5,-5,0,0,1,0
450,445,445,445,20,19,20,18,2,2,1,1,5,0,0,1,-1,2
295,286,281,281,14,14,15,16,2,4,1,3,9,5,0,0,-1,-1
445,440,445,436,20,19,18,18,3,1,4,2,5,-5,9,1,1,0
304,300,295,295,14,14,13,13,2,3,1,1,4,5,0,0,1,0
600,965,590,590,18,19,18,19,3,1,1,1,-365,375,0,-1,1,-1
998,993,998,993,20,19,20,18,1,2,2,1,5,-5,5,1,-1,2
679,684,679,679,20,19,20,18,3,1,3,1,-5,5,0,1,-1,2
623,628,623,623,18,17,18,16,2,1,3,1,-5,5,0,1,-1,2
300,300,295,295,18,17,18,19,3,3,2,3,0,5,0,1,-1,-1
824,829,824,820,14,14,13,13,2,1,1,2,-5,5,4,0,1,0
201,196,201,192,21,19,21,21,3,1,1,1,5,-5,9,2,-2,0
674,674,670,665,17,16,18,18,1,2,1,4,0,4,5,1,-2,0
740,731,726,721,13,14,12,13,1,3,2,1,9,5,5,-1,2,-1
257,243,243,243,14,14,15,13,3,2,2,1,14,0,0,0,-1,2
923,914,909,909,14,17,15,16,2,3,1,1,9,5,0,-3,2,-1
356,351,356,351,17,16,15,16,3,2,1,1,5,-5,5,1,1,-1
773,773,773,768,20,19,20,18,3,1,2,1,0,0,5,1,-1,2
286,286,286,281,18,19,18,19,2,1,1,1,0,0,5,-1,1,-1
736,731,736,736,13,14,15,13,1,2,2,1,5,-5,0,-1,-1,2
918,909,946,951,18,19,18,18,3,2,1,1,9,-37,-5,-1,1,0
426,426,421,421,20,19,20,18,1,1,1,1,0,5,0,1,-1,2
482,473,478,482,14,16,15,16,2,1,1,2,9,-5,-4,-2,1,-1
553,543,534,529,14,17,15,16,1,1,2,2,10,9,5,-3,2,-1
257,253,253,248,14,14,13,13,2,2,2,1,4,0,5,0,1,0
407,403,407,407,20,19,20,21,2,2,1,1,4,-4,0,1,-1,-1
787,782,787,782,14,14,13,13,2,1,2,2,5,-5,5,0,1,0
1036,1026,1021,1021,20,19,18,18,2,3,1,1,10,5,0,1,1,0
360,356,360,365,17,19,18,18,1,2,1,1,4,-4,-5,-2,1,0
300,295,300,304,18,17,18,19,1,2,1,1,5,-5,-4,1,-1,-1
590,590,586,586,14,14,15,13,1,3,1,2,0,4,0,0,-1,2
1026,1026,1064,1050,17,16,18,16,3,1,1,1,0,-38,14,1,-2,2
351,346,342,342,17,16,18,16,1,1,1,1,5,4,0,1,-2,2
867,853,853,853,14,14,13,13,3,4,1,2,14,0,0,0,1,0
782,768,773,768,18,19,18,18,1,2,3,2,14,-5,5,-1,1,0
937,932,918,932,13,14,13,13,3,1,2,1,5,14,-14,-1,1,0
520,520,520,515,21,19,20,21,2,1,4,2,0,0,5,2,-1,-1
403,393,403,398,13,14,15,13,3,2,2,1,10,-10,5,-1,-1,2
295,295,295,295,18,17,18,16,2,1,1,1,0,0,0,1,-1,2
942,937,932,932,20,19,20,21,2,3,1,2,5,5,0,1,-1,-1
810,806,806,806,21,19,20,21,3,3,1,1,4,0,0,2,-1,-1
224,210,201,196,18,19,18,19,3,1,3,1,14,9,5,-1,1,-1
271,267,267,267,14,14,13,13,1,1,1,1,4,0,0,0,1,0
520,520,524,515,14,14,13,13,2,2,1,2,0,-4,9,0,1,0
482,478,473,473,18,19,18,18,1,1,2,1,4,5,0,-1,1,0
637,632,974,632,20,19,15,21,1,1,1,1,5,-342,342,1,4,-6
581,571,567,571,14,14,13,13,3,2,2,1,10,4,-4,0,1,0
234,229,234,229,14,17,15,16,2,1,2,2,5,-5,5,-3,2,-1
750,745,745,745,13,16,15,16,1,1,3,2,5,0,0,-3,1,-1
674,674,670,670,20,19,20,21,1,3,2,1,0,4,0,1,-1,-1
553,548,553,553,21,19,20,21,3,2,1,2,5,-5,0,2,-1,-1
482,482,478,473,14,14,15,13,2,2,1,3,0,4,5,0,-1,2
956,942,946,937,13,14,12,13,2,2,1,1,14,-4,9,-1,2,-1
295,276,276,276,14,14,13,13,3,2,1,1,19,0,0,0,1,0
224,220,220,220,21,19,20,19,1,1,1,1,4,0,0,2,-1,1
604,604,600,600,18,19,18,19,3,2,1,1,0,4,0,-1,1,-1
281,281,281,276,14,17,15,16,2,2,2,1,0,0,5,-3,2,-1
454,450,454,454,20,19,20,21,2,2,1,1,4,-4,0,1,-1,-1
1073,1068,1073,1068,17,19,18,18,1,4,1,1,5,-5,5,-2,1,0
1078,1073,1073,1068,20,19,20,18,2,2,1,2,5,0,5,1,-1,2
548,534,534,787,14,17,15,11,2,2,1,1,14,0,-253,-3,2,4
778,773,768,768,13,14,12,13,2,3,3,3,5,5,0,-1,2,-1
571,567,567,562,14,14,15,13,1,3,3,1,4,0,5,0,-1,2
440,436,440,440,13,14,15,13,2,2,4,3,4,-4,0,-1,-1,2
229,229,224,224,14,17,15,16,3,2,1,1,0,5,0,-3,2,-1
548,534,539,548,14,14,13,13,3,3,4,2,14,-5,-9,0,1,0
637,623,628,628,20,19,18,19,2,2,1,1,14,-5,0,1,1,-1
886,881,881,881,21,19,20,21,1,1,2,1,5,0,0,2,-1,-1
824,801,806,801,14,14,13,13,1,2,2,2,23,-5,5,0,1,0
567,557,562,557,18,19,18,18,1,2,2,2,10,-5,5,-1,1,0
253,248,248,248,14,14,15,13,2,2,2,1,5,0,0,0,-1,2
496,496,492,496,14,14,13,13,1,3,3,1,0,4,-4,0,1,0
600,595,595,586,14,17,15,16,1,1,2,2,5,0,9,-3,2,-1
210,210,210,210,18,17,18,19,1,3,2,1,0,0,0,1,-1,-1
646,642,642,642,17,16,18,18,1,1,1,3,4,0,0,1,-2,0
867,862,862,862,14,17,15,16,1,4,3,1,5,0,0,-3,2,-1
314,309,314,309,14,17,15,16,1,2,2,2,5,-5,5,-3,2,-1
351,356,351,351,17,16,15,16,1,2,1,1,-5,5,0,1,1,-1
754,679,689,679,17,19,20,18,1,3,1,1,75,-10,10,-2,-1,2
628,618,628,623,18,17,18,16,1,2,1,2,10,-10,5,1,-1,2
745,731,726,721,13,14,15,13,2,2,2,2,14,5,5,-1,-1,2
942,937,937,937,13,14,15,13,1,1,1,1,5,0,0,-1,-1,2
660,660,656,651,13,14,12,13,2,3,1,5,0,4,5,-1,2,-1
239,234,234,229,14,17,15,16,3,2,2,3,5,0,5,-3,2,-1
581,581,576,581,14,14,15,13,1,2,1,2,0,5,-5,0,-1,2
998,989,989,989,17,16,18,18,1,2,1,2,9,0,0,1,-2,0
450,445,450,445,13,14,15,16,4,2,2,1,5,-5,5,-1,-1,-1
1059,1054,1050,1045,13,14,12,13,3,3,2,2,5,4,5,-1,2,-1
895,886,881,876,18,17,18,16,1,2,2,2,9,5,5,1,-1,2
778,773,773,773,17,16,18,18,2,2,1,2,5,0,0,1,-2,0
356,356,356,356,20,19,20,21,3,2,1,4,0,0,0,1,-1,-1
787,787,778,778,18,19,18,18,2,1,1,1,0,9,0,-1,1,0
473,440,436,436,17,16,18,18,3,2,1,2,33,4,0,1,-2,0
614,609,609,609,18,19,18,19,5,2,1,3,5,0,0,-1,1,-1
993,984,984,979,13,14,15,13,1,1,1,2,9,0,5,-1,-1,2
487,473,473,473,14,16,15,16,1,2,1,2,14,0,0,-2,1,-1
1026,1026,1026,1026,17,16,18,18,2,3,1,1,0,0,0,1,-2,0
553,548,548,543,14,17,15,16,3,1,2,2,5,0,5,-3,2,-1
736,726,721,721,13,16,15,16,3,1,3,1,10,5,0,-3,1,-1
529,515,515,520,18,19,18,19,1,2,1,1,14,0,-5,-1,1,-1
206,206,210,210,14,17,15,16,2,2,1,1,0,-4,0,-3,2,-1
824,820,820,815,14,14,15,16,2,2,3,3,4,0,5,0,-1,-1
374,374,370,374,20,19,20,21,3,1,1,1,0,4,-4,1,-1,-1
848,876,843,839,14,14,15,13,2,1,1,2,-28,33,4,0,-1,2
679,674,674,670,20,19,18,18,1,2,2,1,5,0,4,1,1,0
210,206,196,192,18,19,18,19,3,1,1,2,4,10,4,-1,1,-1
314,309,309,304,14,14,13,13,3,3,2,1,5,0,5,0,1,0
445,440,440,436,20,19,20,21,1,2,1,2,5,0,4,1,-1,-1
318,323,323,318,14,17,15,16,2,1,2,3,-5,0,5,-3,2,-1
970,960,965,960,17,16,18,18,1,2,2,2,10,-5,5,1,-2,0
524,524,515,515,18,17,18,16,2,1,3,3,0,9,0,1,-1,2
792,787,787,787,18,17,18,19,2,2,3,1,5,0,0,1,-1,-1
286,286,281,286,18,17,18,19,1,1,1,1,0,5,-5,1,-1,-1
759,759,764,754,13,14,15,13,2,3,2,2,0,-5,10,-1,-1,2
782,778,773,768,21,19,20,18,1,1,1,1,4,5,5,2,-1,2
379,374,374,370,13,14,15,13,1,2,4,3,5,0,4,-1,-1,2
726,721,721,726,20,19,20,21,2,1,1,1,5,0,-5,1,-1,-1
224,224,224,220,18,17,18,19,2,1,3,2,0,0,4,1,-1,-1
262,253,253,257,21,19,20,21,3,1,1,4,9,0,-4,2,-1,-1
482,473,473,478,14,16,15,16,1,3,1,1,9,0,-5,-2,1,-1
276,271,271,271,18,17,18,18,1,1,2,1,5,0,0,1,-1,0
609,600,600,595,21,19,20,21,3,2,1,1,9,0,5,2,-1,-1
421,417,417,417,17,19,18,18,3,3,1,2,4,0,0,-2,1,0
984,974,974,974,13,16,15,16,2,2,1,2,10,0,0,-3,1,-1
196,187,1078,1078,14,14,15,13,1,3,1,1,9,-891,0,0,-1,2
220,1045,1040,1040,14,14,15,16,2,1,1,2,-825,5,0,0,-1,-1
379,379,379,384,13,14,12,13,1,3,3,1,0,0,-5,-1,2,-1
300,300,295,295,18,17,18,16,1,3,1,2,0,5,0,1,-1,2
300,300,295,290,14,14,15,13,3,1,1,2,0,5,5,0,-1,2
276,328,276,271,18,17,20,18,1,1,2,1,-52,52,5,1,-3,2
876,867,871,904,14,14,13,13,3,2,1,2,9,-4,-33,0,1,0
637,637,637,632,17,16,15,16,2,1,2,1,0,0,5,1,1,-1
586,571,571,571,21,19,20,21,2,2,1,2,15,0,0,2,-1,-1
731,726,721,717,13,14,12,13,1,3,2,2,5,5,4,-1,2,-1
215,210,224,234,18,17,18,18,2,2,1,3,5,-14,-10,1,-1,0
300,286,286,281,14,14,15,13,2,2,1,1,14,0,5,0,-1,2
665,660,665,660,20,19,20,18,4,3,2,3,5,-5,5,1,-1,2
257,257,257,257,21,19,20,18,2,2,2,2,0,0,0,2,-1,2
904,895,895,895,14,14,13,13,5,3,2,2,9,0,0,0,1,0
979,965,960,956,20,19,18,18,1,3,2,2,14,5,4,1,1,0
1003,989,989,989,13,14,15,13,2,2,1,1,14,0,0,-1,-1,2
1003,1003,998,998,20,19,20,21,1,5,1,3,0,5,0,1,-1,-1
510,510,510,510,18,17,18,16,3,2,1,1,0,0,0,1,-1,2
459,454,454,450,13,14,15,13,1,4,2,1,5,0,4,-1,-1,2
820,796,796,792,14,14,13,13,2,2,2,2,24,0,4,0,1,0
553,543,543,539,14,14,13,13,1,2,2,1,10,0,4,0,1,0
712,703,703,703,17,16,18,16,1,2,2,3,9,0,0,1,-2,2
506,487,487,482,14,14,13,13,1,2,2,1,19,0,5,0,1,0
946,942,942,932,17,16,15,16,4,1,3,2,4,0,10,1,1,-1
562,548,548,539,14,14,15,13,1,4,1,3,14,0,9,0,-1,2
609,604,454,637,18,17,20,16,1,3,1,2,5,150,-183,1,-3,4
468,468,468,468,13,14,15,13,1,1,1,3,0,0,0,-1,-1,2
862,848,843,848,14,14,15,13,4,2,1,1,14,5,-5,0,-1,2
342,337,337,337,17,16,18,16,3,3,2,1,5,0,0,1,-2,2
384,374,374,370,20,19,20,18,3,1,1,1,10,0,4,1,-1,2
642,642,642,642,13,14,15,13,1,3,3,1,0,0,0,-1,-1,2
487,487,482,482,21,19,21,19,1,1,1,1,0,5,0,2,-2,2
993,993,993,989,17,16,15,16,3,2,2,1,0,0,4,1,1,-1
440,436,431,426,13,14,12,13,2,1,2,1,4,5,5,-1,2,-1
712,703,703,698,17,16,18,16,2,3,2,2,9,0,5,1,-2,2
468,459,464,459,20,19,18,18,3,2,2,2,9,-5,5,1,1,0
989,984,984,984,17,16,18,18,3,1,3,1,5,0,0,1,-2,0
206,201,196,201,21,19,21,19,6,2,1,2,5,5,-5,2,-2,2
960,951,946,951,20,19,20,18,3,1,1,2,9,5,-5,1,-1,2
698,693,693,693,20,19,20,18,1,1,1,1,5,0,0,1,-1,2
436,436,436,431,13,14,12,13,1,1,2,2,0,0,5,-1,2,-1
360,351,351,351,20,19,20,21,2,2,1,2,9,0,0,1,-1,-1
689,674,674,674,17,16,18,16,1,1,1,1,15,0,0,1,-2,2
412,407,407,403,17,19,18,18,2,1,2,1,5,0,4,-2,1,0
468,445,440,445,17,16,15,16,2,2,1,1,23,5,-5,1,1,-1
1059,1059,1050,1050,13,14,15,16,3,5,3,2,0,9,0,-1,-1,-1
262,248,248,243,14,14,15,13,1,2,3,2,14,0,5,0,-1,2
262,262,257,253,14,14,13,13,1,3,1,2,0,5,4,0,1,0
365,351,356,351,13,14,12,13,2,1,2,4,14,-5,5,-1,2,-1
571,562,567,571,21,19,20,21,3,1,2,5,9,-5,-4,2,-1,-1
886,881,876,876,14,14,15,16,1,2,2,1,5,5,0,0,-1,-1
586,586,590,586,14,17,15,16,2,2,2,1,0,-4,4,-3,2,-1
956,960,956,956,13,16,15,16,2,2,2,1,-4,4,0,-3,1,-1
309,300,300,295,14,14,15,16,1,4,2,1,9,0,5,0,-1,-1
1054,1059,1054,1054,17,16,15,16,1,3,1,1,-5,5,0,1,1,-1
965,951,951,946,13,14,15,13,2,2,3,2,14,0,5,-1,-1,2
290,271,271,271,14,14,13,13,3,3,1,2,19,0,0,0,1,0
1040,1036,1036,1031,20,19,20,21,2,2,1,1,4,0,5,1,-1,-1
567,632,628,628,14,14,15,13,2,1,1,1,-65,4,0,0,-1,2
206,210,206,201,21,19,20,21,2,1,1,2,-4,4,5,2,-1,-1
360,356,356,356,20,19,18,18,1,3,2,1,4,0,0,1,1,0
314,309,304,304,18,17,18,19,1,3,3,1,5,5,0,1,-1,-1
853,834,829,834,14,14,13,13,1,3,1,2,19,5,-5,0,1,0
417,417,417,417,17,16,15,16,3,3,3,1,0,0,0,1,1,-1
239,187,192,201,14,17,15,16,1,2,3,1,52,-5,-9,-3,2,-1
290,290,295,290,14,17,15,16,1,1,2,1,0,-5,5,-3,2,-1
300,300,304,300,14,14,15,13,1,2,2,3,0,-4,4,0,-1,2
314,295,281,276,14,14,15,13,1,3,2,1,19,14,5,0,-1,2
342,332,337,337,20,19,18,18,1,2,1,1,10,-5,0,1,1,0
548,548,543,543,14,17,15,16,1,3,2,2,0,5,0,-3,2,-1
857,857,857,862,18,17,18,18,4,3,2,1,0,0,-5,1,-1,0
553,553,553,553,18,17,18,16,2,3,2,1,0,0,0,1,-1,2
201,187,192,192,18,19,18,19,2,3,3,1,14,-5,0,-1,1,-1
487,478,473,473,21,19,20,21,1,1,1,2,9,5,0,2,-1,-1
586,586,581,571,14,17,15,16,2,1,2,2,0,5,10,-3,2,-1
239,234,229,267,14,17,15,16,1,1,1,2,5,5,-38,-3,2,-1
946,946,937,942,13,14,15,13,3,3,1,1,0,9,-5,-1,-1,2
454,450,454,454,20,19,20,21,2,2,2,1,4,-4,0,1,-1,-1
904,900,900,900,18,17,18,16,1,2,1,2,4,0,0,1,-1,2
665,524,524,520,13,14,15,13,1,2,1,4,141,0,4,-1,-1,2
224,224,229,229,18,19,18,19,2,1,2,1,0,-5,0,-1,1,-1
890,886,890,886,14,14,15,13,2,2,1,2,4,-4,4,0,-1,2
834,810,815,815,14,14,13,13,3,2,2,1,24,-5,0,0,1,0
956,951,951,951,20,19,18,18,1,1,2,1,5,0,0,1,1,0
768,764,750,750,13,14,12,13,2,2,3,2,4,14,0,-1,2,-1
389,379,379,374,13,14,12,13,3,2,2,1,10,0,5,-1,2,-1
792,778,787,787,14,16,15,16,1,1,2,3,14,-9,0,-2,1,-1
806,792,792,796,14,14,15,13,1,1,4,1,14,0,-4,0,-1,2
942,937,928,923,13,14,15,13,2,2,2,2,5,9,5,-1,-1,2
796,787,787,787,14,14,13,13,3,1,1,1,9,0,0,0,1,0
717,712,712,707,13,14,12,13,1,2,1,2,5,0,5,-1,2,-1
581,576,571,571,18,19,18,18,2,1,1,1,5,5,0,-1,1,0
1040,1036,1031,1031,20,19,20,18,1,3,1,1,4,5,0,1,-1,2
445,436,440,436,13,14,15,13,2,2,1,1,9,-4,4,-1,-1,2
1003,993,998,998,17,16,18,18,2,2,1,1,10,-5,0,1,-2,0
642,637,637,637,13,14,15,16,1,2,1,1,5,0,0,-1,-1,-1
515,510,506,506,14,14,15,16,2,2,3,1,5,4,0,0,-1,-1
534,534,534,534,18,19,18,18,2,3,1,1,0,0,0,-1,1,0
482,478,468,468,14,16,15,16,1,1,2,1,4,10,0,-2,1,-1
1012,487,989,989,13,14,12,13,4,1,1,2,525,-502,0,-1,2,-1
309,304,304,304,18,17,18,16,1,2,1,1,5,0,0,1,-1,2
886,881,881,881,18,17,18,19,1,3,1,1,5,0,0,1,-1,-1
360,356,356,356,13,14,15,13,1,3,1,3,4,0,0,-1,-1,2
867,867,862,881,14,14,15,13,2,3,2,2,0,5,-19,0,-1,2
623,609,600,595,14,14,13,13,2,1,1,4,14,9,5,0,1,0
224,220,224,224,18,19,18,19,3,2,2,1,4,-4,0,-1,1,-1
206,201,196,196,18,19,21,19,3,2,1,1,5,5,0,-1,-2,2
632,628,628,628,20,19,21,19,1,1,1,1,4,0,0,1,-2,2
323,318,314,314,18,17,18,16,3,1,1,2,5,4,0,1,-1,2
787,787,792,792,14,17,15,16,1,2,1,1,0,-5,0,-3,2,-1
862,843,834,839,14,14,15,13,1,3,3,3,19,9,-5,0,-1,2
534,539,534,529,18,17,18,19,2,2,3,2,-5,5,5,1,-1,-1
1036,1031,1031,1026,17,16,15,16,2,3,1,1,5,0,5,1,1,-1
1021,1012,1012,1017,17,16,15,16,2,1,1,1,9,0,-5,1,1,-1
623,618,623,628,18,19,18,19,2,1,3,1,5,-5,-5,-1,1,-1
318,323,323,318,18,17,18,19,3,3,3,1,-5,0,5,1,-1,-1
257,248,257,253,18,17,18,16,3,1,2,1,9,-9,4,1,-1,2
974,960,960,960,17,16,18,18,1,2,1,3,14,0,0,1,-2,0
909,909,909,909,14,17,15,16,2,1,3,1,0,0,0,-3,2,-1
684,679,679,684,13,16,15,16,1,2,3,1,5,0,-5,-3,1,-1
234,234,468,234,18,19,12,18,2,1,1,3,0,-234,234,-1,7,-6
201,192,187,187,21,19,21,19,1,1,3,1,9,5,0,2,-2,2
557,557,557,553,21,19,20,18,1,2,1,2,0,0,4,2,-1,2
721,712,717,717,13,14,15,16,2,3,2,1,9,-5,0,-1,-1,-1
848,843,839,839,21,19,20,21,3,1,1,1,5,4,0,2,-1,-1
459,454,450,450,13,14,12,13,4,3,2,1,5,4,0,-1,2,-1
515,510,510,510,21,19,20,19,1,2,1,1,5,0,0,2,-1,1
539,529,534,524,14,14,13,13,1,2,2,2,10,-5,10,0,1,0
403,398,393,398,17,16,18,16,3,2,3,1,5,5,-5,1,-2,2
515,520,520,520,18,19,18,19,1,1,2,1,-5,0,0,-1,1,-1
946,942,942,942,17,16,18,18,3,3,4,1,4,0,0,1,-2,0
276,271,271,276,14,14,15,13,2,2,3,3,5,0,-5,0,-1,2
426,412,417,412,17,16,15,16,3,2,2,1,14,-5,5,1,1,-1
618,609,609,609,14,14,15,13,2,2,2,1,9,0,0,0,-1,2
468,445,454,454,20,19,20,21,2,1,1,1,23,-9,0,1,-1,-1
243,234,253,234,21,19,20,21,1,2,2,1,9,-19,19,2,-1,-1
946,942,946,946,17,16,18,16,3,1,2,1,4,-4,0,1,-2,2
384,384,389,384,20,19,20,21,1,3,2,1,0,-5,5,1,-1,-1
768,768,759,759,17,16,15,16,3,3,3,2,0,9,0,1,1,-1
707,693,703,693,13,14,12,13,2,1,3,2,14,-10,10,-1,2,-1
998,993,989,979,13,14,15,13,2,5,1,2,5,4,10,-1,-1,2
450,445,445,440,17,19,18,18,1,1,1,3,5,0,5,-2,1,0
384,379,374,379,20,19,20,18,1,2,2,2,5,5,-5,1,-1,2
248,243,248,243,14,17,15,16,1,2,1,2,5,-5,5,-3,2,-1
454,436,440,436,13,14,12,13,2,2,2,1,18,-4,4,-1,2,-1
881,876,871,871,14,14,15,13,1,1,1,2,5,5,0,0,-1,2
524,524,520,515,14,14,15,16,2,3,4,2,0,4,5,0,-1,-1
590,586,590,586,21,19,20,19,1,1,2,2,4,-4,4,2,-1,1
248,248,248,248,14,17,15,16,1,1,2,1,0,0,0,-3,2,-1
464,459,454,454,20,19,20,21,2,3,3,1,5,5,0,1,-1,-1
196,196,192,192,14,14,15,16,3,1,1,1,0,4,0,0,-1,-1
314,309,309,309,21,19,21,19,1,2,1,2,5,0,0,2,-2,2
520,520,520,515,18,19,18,19,1,4,3,3,0,0,5,-1,1,-1
1026,1021,1021,1026,20,19,20,18,3,1,1,1,5,0,-5,1,-1,2
970,965,960,960,13,14,12,13,3,1,1,2,5,5,0,-1,2,-1
534,539,534,524,14,14,13,13,2,1,2,6,-5,5,10,0,1,0
1064,1064,1068,1064,13,16,15,16,2,2,1,2,0,-4,4,-3,1,-1
365,360,360,365,13,14,15,13,1,2,1,1,5,0,-5,-1,-1,2
623,618,623,618,14,14,15,13,2,2,1,2,5,-5,5,0,-1,2
740,736,736,736,17,16,18,18,2,2,2,1,4,0,0,1,-2,0
201,182,206,1073,18,19,18,18,2,2,1,2,19,-24,-867,-1,1,0
379,374,374,370,13,14,15,13,2,3,3,2,5,0,4,-1,-1,2
970,960,960,956,13,14,12,13,3,2,2,1,10,0,4,-1,2,-1
403,398,398,393,13,14,15,13,3,1,2,2,5,0,5,-1,-1,2
956,951,951,946,13,14,12,13,3,3,1,2,5,0,5,-1,2,-1
843,834,834,834,18,19,18,18,1,3,4,2,9,0,0,-1,1,0
201,196,196,192,21,19,18,19,1,2,2,1,5,0,4,2,1,-1
253,248,248,243,14,14,13,13,1,1,2,1,5,0,5,0,1,0
590,581,576,576,14,17,15,16,1,3,2,1,9,5,0,-3,2,-1
600,595,600,595,18,17,18,16,3,3,2,1,5,-5,5,1,-1,2
342,337,328,323,13,14,13,13,2,1,1,2,5,9,5,-1,1,0
834,820,815,815,14,14,13,13,1,4,1,2,14,5,0,0,1,0
778,773,768,768,20,19,20,18,1,1,2,1,5,5,0,1,-1,2
286,281,286,286,18,19,18,19,2,2,1,3,5,-5,0,-1,1,-1
557,553,548,543,14,17,15,16,1,1,2,2,4,5,5,-3,2,-1
759,754,759,759,17,16,18,18,2,2,2,1,5,-5,0,1,-2,0
1054,1045,1054,1059,13,14,15,13,1,2,1,1,9,-9,-5,-1,-1,2
848,829,820,815,14,14,15,13,1,2,1,2,19,9,5,0,-1,2
895,886,890,890,14,14,13,13,2,2,1,3,9,-4,0,0,1,0
979,974,974,974,20,19,18,18,2,2,2,1,5,0,0,1,1,0
337,332,328,328,13,14,13,13,3,2,1,1,5,4,0,-1,1,0
824,820,815,815,14,14,13,13,1,1,2,1,4,5,0,0,1,0
342,337,342,342,20,19,18,18,1,2,2,2,5,-5,0,1,1,0
717,703,703,703,13,14,12,13,4,2,1,1,14,0,0,-1,2,-1
464,454,450,445,13,14,15,16,1,3,3,2,10,4,5,-1,-1,-1
1064,1054,1059,1059,13,14,12,13,2,2,1,2,10,-5,0,-1,2,-1
693,689,689,689,17,16,18,16,2,2,1,1,4,0,0,1,-2,2
651,646,646,646,20,19,20,21,1,1,2,1,5,0,0,1,-1,-1
782,773,773,773,18,19,18,18,1,1,2,1,9,0,0,-1,1,0
323,318,318,318,14,14,13,13,2,1,2,2,5,0,0,0,1,0
314,304,304,304,14,14,15,16,1,4,3,2,10,0,0,0,-1,-1
328,318,314,314,18,19,18,19,1,1,1,1,10,4,0,-1,1,-1
965,956,956,951,20,19,20,21,1,2,1,1,9,0,5,1,-1,-1
309,304,309,300,14,17,15,16,1,1,2,6,5,-5,9,-3,2,-1
689,679,684,674,20,19,20,18,1,3,2,2,10,-5,10,1,-1,2
496,492,482,492,14,17,15,16,1,1,1,1,4,10,-10,-3,2,-1
595,595,604,600,18,17,18,19,2,1,2,1,0,-9,4,1,-1,-1
810,796,801,796,18,17,18,16,6,1,2,1,14,-5,5,1,-1,2
586,581,581,576,18,19,18,18,1,5,3,1,5,0,5,-1,1,0
192,182,182,182,18,19,18,19,1,1,1,2,10,0,0,-1,1,-1
520,501,506,548,14,14,15,13,1,2,1,1,19,-5,-42,0,-1,2
571,553,553,553,18,19,18,18,3,1,3,1,18,0,0,-1,1,0
1073,1073,1068,1068,20,19,20,21,2,3,2,1,0,5,0,1,-1,-1
1007,1003,1007,1007,13,14,15,13,2,1,2,3,4,-4,0,-1,-1,2
248,248,248,243,18,19,18,18,3,1,1,1,0,0,5,-1,1,0
731,721,721,721,13,14,12,13,2,2,1,1,10,0,0,-1,2,-1
426,426,421,417,13,14,12,13,1,3,2,2,0,5,4,-1,2,-1
824,824,820,820,21,19,20,21,1,1,3,2,0,4,0,2,-1,-1
253,248,253,248,14,14,13,13,1,1,1,2,5,-5,5,0,1,0
304,304,300,304,18,19,18,19,3,1,1,1,0,4,-4,-1,1,-1
782,782,782,782,14,17,15,16,2,1,1,2,0,0,0,-3,2,-1
215,201,192,196,14,17,15,16,3,2,3,1,14,9,-4,-3,2,-1
881,806,810,848,14,14,15,13,1,4,2,3,75,-4,-38,0,-1,2
539,520,529,524,18,19,18,19,1,2,2,2,19,-9,5,-1,1,-1
595,590,590,590,18,17,18,16,2,1,1,1,5,0,0,1,-1,2
501,501,501,501,14,17,15,16,2,1,2,1,0,0,0,-3,2,-1
487,468,464,459,14,14,12,13,1,2,2,1,19,4,5,0,2,-1
768,764,759,754,20,19,18,18,1,1,2,1,4,5,5,1,1,0
979,974,970,970,17,16,18,18,1,2,1,1,5,4,0,1,-2,0
459,464,459,459,17,16,18,18,1,2,1,1,-5,5,0,1,-2,0
909,900,900,900,14,17,15,16,2,1,2,3,9,0,0,-3,2,-1
182,1073,1078,1073,18,16,18,18,1,2,1,2,-891,-5,5,2,-2,0
529,524,520,520,14,14,15,13,2,3,1,2,5,4,0,0,-1,2
389,384,384,379,17,16,15,16,2,3,1,1,5,0,5,1,1,-1
764,759,759,759,17,16,18,16,1,2,1,1,5,0,0,1,-2,2
881,881,876,876,14,14,15,16,1,1,1,3,0,5,0,0,-1,-1
698,660,665,665,17,16,15,16,3,2,2,1,38,-5,0,1,1,-1
618,604,604,604,18,17,18,16,1,2,1,1,14,0,0,1,-1,2
1031,1021,1021,1026,17,16,18,18,3,2,3,2,10,0,-5,1,-2,0
557,553,548,548,18,19,18,18,1,1,3,1,4,5,0,-1,1,0
506,501,506,501,21,19,20,21,1,2,1,2,5,-5,5,2,-1,-1
1026,1021,1021,1021,17,16,18,18,3,3,2,3,5,0,0,1,-2,0
520,515,515,520,18,19,18,19,3,3,1,1,5,0,-5,-1,1,-1
454,454,454,454,13,14,15,13,2,1,3,2,0,0,0,-1,-1,2
900,900,900,900,18,19,18,19,1,1,2,2,0,0,0,-1,1,-1
773,764,759,754,17,16,18,18,1,1,2,2,9,5,5,1,-2,0
201,187,192,187,18,17,18,19,3,2,2,1,14,-5,5,1,-1,-1
487,482,487,482,14,14,15,13,3,1,2,1,5,-5,5,0,-1,2
328,323,318,318,14,14,15,13,1,1,3,2,5,5,0,0,-1,2
1021,1012,1012,1017,17,16,15,16,3,2,3,1,9,0,-5,1,1,-1
787,778,778,773,14,14,15,13,1,1,2,2,9,0,5,0,-1,2
974,974,974,974,20,19,20,18,1,1,1,1,0,0,0,1,-1,2
698,693,693,693,20,19,20,18,2,2,1,1,5,0,0,1,-1,2
595,586,586,586,14,14,13,13,1,2,3,1,9,0,0,0,1,0
1054,965,970,960,20,19,20,21,4,2,2,2,89,-5,10,1,-1,-1
374,374,374,374,13,14,12,13,1,2,4,3,0,0,0,-1,2,-1
450,445,450,450,17,16,18,18,1,4,2,1,5,-5,0,1,-2,0
693,693,693,689,17,16,18,18,1,2,2,2,0,0,4,1,-2,0
689,679,679,679,20,19,20,18,2,2,1,2,10,0,0,1,-1,2
473,473,473,468,13,14,12,13,1,2,1,4,0,0,5,-1,2,-1
182,182,1078,1078,14,14,13,13,2,1,1,1,0,-896,0,0,1,0
1054,1045,1040,1036,17,19,18,18,2,1,2,2,9,5,4,-2,1,0
459,450,450,454,20,19,18,18,1,2,1,1,9,0,-4,1,1,0
979,974,974,979,13,14,15,13,1,3,2,1,5,0,-5,-1,-1,2
323,318,314,314,21,19,21,19,1,1,1,2,5,4,0,2,-2,2
918,923,918,918,21,19,21,19,3,3,1,1,-5,5,0,2,-2,2
571,562,553,553,21,19,20,21,3,3,1,1,9,9,0,2,-1,-1
215,206,206,210,18,19,18,19,3,1,1,2,9,0,-4,-1,1,-1
787,787,787,782,14,14,15,13,3,1,2,2,0,0,5,0,-1,2
567,562,562,562,18,19,18,18,1,1,1,2,5,0,0,-1,1,0
1021,1012,1021,1017,20,19,18,18,3,2,1,2,9,-9,4,1,1,0
993,989,984,984,20,19,20,18,2,1,1,1,4,5,0,1,-1,2
393,389,393,393,17,19,18,18,3,4,1,1,4,-4,0,-2,1,0
431,431,431,431,13,14,15,13,1,1,1,1,0,0,0,-1,-1,2
482,473,473,473,14,14,12,13,1,2,3,1,9,0,0,0,2,-1
670,660,656,660,17,16,18,18,1,2,3,1,10,4,-4,1,-2,0
487,464,459,459,14,14,15,16,1,2,3,1,23,5,0,0,-1,-1
403,407,407,407,13,14,12,13,3,3,2,1,-4,0,0,-1,2,-1
1021,1017,1012,1012,13,14,12,13,1,1,3,1,4,5,0,-1,2,-1
1026,1017,1021,1021,13,14,15,13,2,2,1,4,9,-4,0,-1,-1,2
796,778,768,768,14,16,15,16,1,1,1,2,18,10,0,-2,1,-1
979,974,970,970,13,14,12,13,1,3,1,2,5,4,0,-1,2,-1
234,224,229,229,14,17,15,16,1,3,1,1,10,-5,0,-3,2,-1
717,712,712,712,13,14,12,13,2,3,2,1,5,0,0,-1,2,-1
346,342,342,337,17,16,15,16,3,2,3,2,4,0,5,1,1,-1
796,796,796,792,21,19,21,21,2,3,2,1,0,0,4,2,-2,0
1064,1054,1059,1054,13,14,15,16,2,2,2,2,10,-5,5,-1,-1,-1
796,792,796,792,14,14,13,13,1,3,2,2,4,-4,4,0,1,0
914,890,895,895,14,14,15,13,1,2,1,2,24,-5,0,0,-1,2
857,853,853,853,18,19,18,18,3,2,3,2,4,0,0,-1,1,0
243,229,224,224,14,14,13,13,2,4,2,2,14,5,0,0,1,0
918,914,918,909,18,19,18,19,1,1,2,2,4,-4,9,-1,1,-1
923,914,914,914,18,17,18,19,2,2,1,1,9,0,0,1,-1,-1
487,487,482,482,21,19,21,19,1,1,1,1,0,5,0,2,-2,2
1012,1003,1003,998,20,19,20,21,3,2,1,2,9,0,5,1,-1,-1
365,360,360,356,20,19,20,21,4,2,1,2,5,0,4,1,-1,-1
993,989,984,989,13,14,15,13,2,2,5,1,4,5,-5,-1,-1,2
890,890,886,886,21,19,20,19,1,1,1,1,0,4,0,2,-1,1
642,637,642,642,20,19,20,21,3,2,2,1,5,-5,0,1,-1,-1
374,370,365,370,13,14,15,13,1,2,4,1,4,5,-5,-1,-1,2
506,496,501,501,14,14,15,16,2,2,3,2,10,-5,0,0,-1,-1
468,464,464,459,13,14,15,16,2,1,1,1,4,0,5,-1,-1,-1
1073,1068,1068,1068,17,16,18,18,3,2,3,1,5,0,0,1,-2,0
698,689,693,693,13,14,12,13,2,3,2,2,9,-4,0,-1,2,-1
595,586,586,586,18,17,18,19,2,1,2,1,9,0,0,1,-1,-1
923,909,900,914,14,14,15,13,2,2,2,1,14,9,-14,0,-1,2
571,562,562,557,14,14,13,13,3,3,4,2,9,0,5,0,1,0
637,632,637,632,20,19,20,21,1,2,3,1,5,-5,5,1,-1,-1
1064,1059,1064,1059,20,19,18,18,2,2,2,1,5,-5,5,1,1,0
454,450,445,445,17,19,18,18,2,3,1,1,4,5,0,-2,1,0
792,787,782,782,21,19,21,19,1,1,1,1,5,5,0,2,-2,2
548,548,548,548,14,17,15,16,2,3,1,3,0,0,0,-3,2,-1
553,539,534,529,14,17,15,16,1,1,3,2,14,5,5,-3,2,-1
482,482,478,473,18,17,18,18,1,1,1,3,0,4,5,1,-1,0
267,271,267,262,14,17,15,16,2,1,2,1,-4,4,5,-3,2,-1
853,848,848,848,18,17,18,16,3,3,1,2,5,0,0,1,-1,2
782,773,778,778,14,14,15,13,1,2,1,1,9,-5,0,0,-1,2
712,707,712,707,20,19,20,21,1,2,2,1,5,-5,5,1,-1,-1
918,914,914,918,21,19,21,21,1,2,1,1,4,0,-4,2,-2,0
262,253,642,253,14,14,15,16,3,2,1,3,9,-389,389,0,-1,-1
998,998,993,993,20,19,20,18,3,1,1,1,0,5,0,1,-1,2
721,717,717,721,20,19,20,21,1,1,1,1,4,0,-4,1,-1,-1
234,224,215,215,14,14,15,13,1,2,3,2,10,9,0,0,-1,2
590,595,590,590,18,17,18,19,3,1,3,2,-5,5,0,1,-1,-1
1031,1017,1021,1017,13,14,12,13,3,2,2,2,14,-4,4,-1,2,-1
820,815,815,810,18,17,18,19,3,5,1,2,5,0,5,1,-1,-1
618,618,632,618,18,19,18,19,3,1,1,1,0,-14,14,-1,1,-1
965,951,951,951,17,19,18,18,3,1,1,1,14,0,0,-2,1,0
595,590,595,595,18,19,18,19,3,4,2,3,5,-5,0,-1,1,-1
1021,1026,1021,1021,13,14,15,13,3,3,2,2,-5,5,0,-1,-1,2
693,689,689,689,17,16,18,18,1,2,1,2,4,0,0,1,-2,0
267,257,262,257,14,14,15,13,2,1,1,1,10,-5,5,0,-1,2
1073,1068,1068,1068,20,19,20,21,1,2,1,2,5,0,0,1,-1,-1
239,234,234,234,18,17,18,18,2,4,1,2,5,0,0,1,-1,0
754,754,745,745,17,16,18,18,1,3,1,2,0,9,0,1,-2,0
614,609,609,604,18,17,18,16,2,2,1,2,5,0,5,1,-1,2
562,557,557,553,21,19,20,21,1,3,1,2,5,0,4,2,-1,-1
764,759,759,759,20,19,20,21,2,3,1,1,5,0,0,1,-1,-1
365,360,360,356,17,16,15,16,2,1,4,2,5,0,4,1,1,-1
918,918,918,923,14,14,15,13,1,1,1,1,0,0,-5,0,-1,2
1078,1073,1078,1073,13,14,15,13,1,2,1,1,5,-5,5,-1,-1,2
286,281,276,271,14,14,13,13,1,1,2,1,5,5,5,0,1,0
314,309,309,309,18,19,18,19,2,2,4,4,5,0,0,-1,1,-1
323,323,323,323,18,17,18,19,1,1,1,1,0,0,0,1,-1,-1
332,323,323,323,17,17,18,16,1,2,1,3,9,0,0,0,-1,2
1059,1050,1054,1045,20,19,20,21,2,2,5,2,9,-4,9,1,-1,-1
257,253,248,253,21,19,20,18,2,2,1,3,4,5,-5,2,-1,2
1054,1054,1054,1054,13,14,12,13,3,2,3,1,0,0,0,-1,2,-1
239,243,239,239,14,14,15,13,2,3,2,1,-4,4,0,0,-1,2
454,576,571,567,20,19,20,18,1,1,1,2,-122,5,4,1,-1,2
360,360,360,356,13,14,15,16,2,3,1,1,0,0,4,-1,-1,-1
796,782,773,773,14,14,15,13,3,2,1,2,14,9,0,0,-1,2
984,974,970,970,13,14,15,13,2,3,1,1,10,4,0,-1,-1,2
342,342,337,342,13,14,15,13,1,3,1,3,0,5,-5,-1,-1,2
1026,1021,1026,1021,20,19,18,18,1,4,2,1,5,-5,5,1,1,0
1021,1017,1017,1017,20,19,20,21,1,3,1,1,4,0,0,1,-1,-1
890,886,886,881,14,14,13,13,2,2,3,4,4,0,5,0,1,0
389,374,384,379,13,14,15,13,3,4,2,1,15,-10,5,-1,-1,2
515,506,501,506,14,14,13,13,1,3,2,3,9,5,-5,0,1,0
886,881,886,886,18,19,18,19,3,2,2,1,5,-5,0,-1,1,-1
792,782,792,796,21,19,21,21,1,2,1,1,10,-10,-4,2,-2,0
318,318,314,318,18,19,21,19,3,3,1,1,0,4,-4,-1,-2,2
937,932,932,937,20,19,20,18,1,2,1,1,5,0,-5,1,-1,2
323,323,323,323,14,14,13,13,2,2,2,1,0,0,0,0,1,0
801,796,796,796,21,19,21,19,2,3,1,1,5,0,0,2,-2,2
876,871,871,867,14,14,15,13,1,1,3,1,5,0,4,0,-1,2
1054,1045,1040,1036,17,16,18,18,2,2,2,3,9,5,4,1,-2,0
839,834,834,834,21,19,20,18,1,2,3,1,5,0,0,2,-1,2
740,726,726,726,17,16,15,16,2,2,1,2,14,0,0,1,1,-1
684,684,684,684,20,19,20,18,1,3,2,1,0,0,0,1,-1,2
712,707,717,712,13,14,15,13,1,4,2,1,5,-10,5,-1,-1,2
979,970,965,965,13,14,15,13,2,1,2,1,9,5,0,-1,-1,2
220,220,220,220,14,14,15,13,6,3,2,1,0,0,0,0,-1,2
979,974,970,970,17,19,18,18,1,2,2,1,5,4,0,-2,1,0
1064,1064,1059,1054,20,19,18,18,3,3,5,1,0,5,5,1,1,0
562,557,562,557,14,17,15,16,1,2,2,1,5,-5,5,-3,2,-1
436,426,431,421,13,14,15,13,3,3,1,1,10,-5,10,-1,-1,2
923,918,937,946,21,19,20,21,2,1,1,1,5,-19,-9,2,-1,-1
1045,1045,1045,1045,17,16,18,16,1,2,1,2,0,0,0,1,-2,2
454,450,440,440,17,16,18,18,3,3,1,1,4,10,0,1,-2,0
656,656,651,651,17,16,18,16,3,1,1,1,0,5,0,1,-2,2
192,1078,1078,1078,18,19,18,18,1,1,1,1,-886,0,0,-1,1,0
740,731,736,740,17,16,15,16,2,5,1,1,9,-5,-4,1,1,-1
398,398,393,393,13,16,15,16,1,2,1,2,0,5,0,-3,1,-1
210,206,215,210,14,14,13,13,2,2,2,2,4,-9,5,0,1,0
389,393,407,412,17,16,15,16,1,1,1,1,-4,-14,-5,1,1,-1
496,492,492,496,18,17,18,19,2,3,1,1,4,0,-4,1,-1,-1
815,815,815,815,21,19,20,21,1,1,1,1,0,0,0,2,-1,-1
1059,1050,1059,1054,13,14,12,13,1,1,1,2,9,-9,5,-1,2,-1
229,220,215,210,18,17,18,16,1,1,1,1,9,5,5,1,-1,2
187,1073,1064,1068,14,14,15,13,1,2,1,1,-886,9,-4,0,-1,2
974,970,974,970,20,19,18,18,2,1,2,1,4,-4,4,1,1,0
937,937,932,928,20,19,20,19,1,1,1,1,0,5,4,1,-1,1
398,398,398,398,20,19,18,18,1,3,2,1,0,0,0,1,1,0
431,426,426,426,13,14,12,13,3,3,3,3,5,0,0,-1,2,-1
318,314,314,314,18,19,18,19,1,2,1,1,4,0,0,-1,1,-1
942,937,937,937,13,14,12,13,1,1,3,1,5,0,0,-1,2,-1
206,196,201,196,18,17,18,19,3,2,2,2,10,-5,5,1,-1,-1
356,351,346,346,13,14,12,13,3,3,1,2,5,5,0,-1,2,-1
337,337,328,360,20,19,21,21,1,2,1,5,0,9,-32,1,-2,0
206,196,201,192,14,14,13,13,3,4,1,2,10,-5,9,0,1,0
900,900,895,895,21,19,20,19,2,1,1,1,0,5,0,2,-1,1
993,989,984,989,13,14,12,13,1,2,3,1,4,5,-5,-1,2,-1
224,210,210,210,14,14,13,13,1,3,1,3,14,0,0,0,1,0
1003,998,998,1003,13,14,15,13,3,2,1,3,5,0,-5,-1,-1,2
534,529,534,529,14,17,15,16,1,2,3,1,5,-5,5,-3,2,-1
290,290,290,290,18,17,18,19,2,4,2,1,0,0,0,1,-1,-1
562,553,543,548,14,14,13,13,3,2,1,3,9,10,-5,0,1,0
487,487,478,473,18,17,18,18,3,1,1,2,0,9,5,1,-1,0
412,407,403,398,13,14,15,13,3,3,2,2,5,4,5,-1,-1,2
557,548,543,543,18,19,18,18,1,3,1,1,9,5,0,-1,1,0
571,562,562,557,14,14,15,13,1,1,1,3,9,0,5,0,-1,2
759,717,717,721,13,14,15,13,2,3,1,3,42,0,-4,-1,-1,2
717,717,717,717,13,14,15,13,1,3,2,3,0,0,0,-1,-1,2
754,745,754,745,13,16,15,16,1,2,2,1,9,-9,9,-3,1,-1
942,937,937,937,13,14,12,13,1,1,2,1,5,0,0,-1,2,-1
290,290,286,290,14,14,15,13,1,3,1,1,0,4,-4,0,-1,2
923,918,918,918,18,19,18,19,1,2,1,2,5,0,0,-1,1,-1
787,782,778,773,14,17,15,16,1,1,2,1,5,4,5,-3,2,-1
323,318,323,323,18,17,18,16,1,4,3,3,5,-5,0,1,-1,2
436,426,426,426,20,19,20,21,2,2,2,1,10,0,0,1,-1,-1
267,262,267,267,18,19,18,18,2,2,2,2,5,-5,0,-1,1,0
820,815,820,815,14,14,15,16,3,2,2,1,5,-5,5,0,-1,-1
1017,1012,1012,1012,17,19,18,18,4,1,1,1,5,0,0,-2,1,0
323,314,318,314,18,17,18,16,1,2,1,2,9,-4,4,1,-1,2
914,904,904,900,14,14,15,13,1,3,1,2,10,0,4,0,-1,2
801,792,796,801,14,17,15,16,2,6,2,1,9,-4,-5,-3,2,-1
787,726,782,782,14,16,15,16,2,1,1,2,61,-56,0,-2,1,-1
867,862,867,862,14,17,15,16,1,1,2,1,5,-5,5,-3,2,-1
604,604,604,600,18,17,18,16,1,3,2,2,0,0,4,1,-1,2
286,281,281,281,14,14,13,13,3,3,2,1,5,0,0,0,1,0
529,515,515,510,18,17,18,16,2,1,2,3,14,0,5,1,-1,2
464,468,464,464,13,14,12,13,1,3,1,1,-4,4,0,-1,2,-1
614,618,618,614,21,19,21,21,4,1,1,2,-4,0,4,2,-2,0
393,393,384,384,20,19,20,21,3,1,1,1,0,9,0,1,-1,-1
417,412,412,407,17,16,15,16,2,1,1,2,5,0,5,1,1,-1
478,473,468,473,17,19,18,18,2,3,1,1,5,5,-5,-2,1,0
764,759,764,764,13,14,12,13,3,2,2,2,5,-5,0,-1,2,-1
946,956,942,946,20,19,20,18,2,2,1,1,-10,14,-4,1,-1,2
403,398,398,398,13,14,15,13,1,2,1,2,5,0,0,-1,-1,2
904,904,895,895,18,17,18,19,2,1,3,2,0,9,0,1,-1,-1
740,740,736,736,20,19,18,18,1,1,3,1,0,4,0,1,1,0
234,229,234,234,14,14,13,13,2,2,2,3,5,-5,0,0,1,0
1078,1068,1064,1064,13,14,15,16,2,1,1,1,10,4,0,-1,-1,-1
895,900,895,895,14,14,15,13,2,4,1,1,-5,5,0,0,-1,2
600,262,262,262,21,14,15,13,1,2,2,1,338,0,0,7,-1,2
614,604,614,609,14,17,15,16,2,4,1,2,10,-10,5,-3,2,-1
1054,1054,1054,1059,13,14,15,13,1,2,3,2,0,0,-5,-1,-1,2
445,450,436,436,20,19,20,21,2,1,1,2,-5,14,0,1,-1,-1
562,557,548,548,21,19,20,18,1,3,1,2,5,9,0,2,-1,2
623,614,614,609,14,14,15,13,1,2,1,4,9,0,5,0,-1,2
886,881,876,876,18,17,18,16,3,1,3,1,5,5,0,1,-1,2
595,586,590,590,14,17,15,16,1,2,1,5,9,-4,0,-3,2,-1
726,717,717,721,13,14,15,13,2,2,3,1,9,0,-4,-1,-1,2
960,951,956,951,17,16,18,16,3,1,2,1,9,-5,5,1,-2,2
853,843,843,843,14,14,15,16,1,3,3,3,10,0,0,0,-1,-1
454,450,450,450,20,19,20,21,2,3,1,1,4,0,0,1,-1,-1
600,600,600,604,18,17,18,19,2,2,3,1,0,0,-4,1,-1,-1
337,332,332,332,20,19,20,21,1,1,1,2,5,0,0,1,-1,-1
717,712,717,712,13,14,15,13,1,2,1,2,5,-5,5,-1,-1,2
454,450,445,450,17,16,15,16,2,3,3,1,4,5,-5,1,1,-1
674,674,670,670,17,19,18,18,1,3,2,3,0,4,0,-2,1,0
586,581,576,571,18,19,18,18,1,3,2,1,5,5,5,-1,1,0
614,614,614,609,14,14,13,13,2,3,2,2,0,0,5,0,1,0
1073,1078,1073,1073,20,19,20,21,2,1,1,3,-5,5,0,1,-1,-1
257,248,239,239,18,19,18,18,2,1,1,3,9,9,0,-1,1,0
182,182,1078,1073,14,14,15,13,2,2,1,2,0,-896,5,0,-1,2
1031,1021,1026,1021,13,16,15,16,1,1,1,2,10,-5,5,-3,1,-1
421,417,417,417,20,19,20,21,3,2,1,4,4,0,0,1,-1,-1
1073,1068,1068,1068,17,19,18,18,1,3,1,1,5,0,0,-2,1,0
482,482,478,482,14,14,13,13,1,1,2,1,0,4,-4,0,1,0
909,895,904,904,18,19,18,19,1,3,2,1,14,-9,0,-1,1,-1
557,543,543,543,14,17,15,16,3,3,2,1,14,0,0,-3,2,-1
1073,1064,1059,1054,13,14,12,13,2,1,1,1,9,5,5,-1,2,-1
1003,998,998,998,20,19,20,21,2,4,3,1,5,0,0,1,-1,-1
604,600,600,600,21,19,20,19,4,2,1,1,4,0,0,2,-1,1
665,665,665,660,13,14,15,13,1,4,1,2,0,0,5,-1,-1,2
867,867,867,862,14,14,13,13,2,2,1,1,0,0,5,0,1,0
801,792,787,787,14,14,13,13,1,1,3,1,9,5,0,0,1,0
370,365,356,360,13,14,15,13,1,3,4,1,5,9,-4,-1,-1,2
937,932,923,918,17,16,15,16,2,1,1,2,5,9,5,1,1,-1
595,595,595,590,18,19,18,19,1,1,1,1,0,0,5,-1,1,-1
229,224,220,215,14,17,15,16,3,1,2,1,5,4,5,-3,2,-1
984,979,979,974,13,16,15,16,3,1,2,1,5,0,5,-3,1,-1
862,857,857,853,18,17,18,16,3,1,1,2,5,0,4,1,-1,2
1073,1073,1073,1068,20,19,18,18,1,3,2,2,0,0,5,1,1,0
867,862,857,853,18,19,18,18,3,2,3,1,5,5,4,-1,1,0
843,839,839,834,14,14,13,13,1,3,1,2,4,0,5,0,1,0
721,717,717,712,13,16,15,16,1,4,2,2,4,0,5,-3,1,-1
853,848,848,848,18,19,20,18,1,3,1,1,5,0,0,-1,-1,2
703,693,698,707,17,16,18,18,2,5,3,1,10,-5,-9,1,-2,0
206,192,201,206,18,17,18,16,2,1,1,1,14,-9,-5,1,-1,2
1068,1064,1064,1068,20,19,18,18,1,2,3,1,4,0,-4,1,1,0
974,960,956,956,13,14,12,13,2,2,1,1,14,4,0,-1,2,-1
257,253,253,253,18,17,18,18,3,3,3,1,4,0,0,1,-1,0
904,890,886,886,18,17,18,19,1,2,3,1,14,4,0,1,-1,-1
539,539,534,534,18,19,18,18,1,1,2,1,0,5,0,-1,1,0
557,548,548,548,14,17,15,16,1,1,1,1,9,0,0,-3,2,-1
609,600,595,600,14,14,13,13,1,3,2,1,9,5,-5,0,1,0
201,192,192,192,14,14,13,13,3,4,1,2,9,0,0,0,1,0
960,956,956,960,13,14,15,16,1,3,3,3,4,0,-4,-1,-1,-1
557,553,548,548,18,19,18,18,1,1,3,1,4,5,0,-1,1,0
642,642,642,637,20,19,20,18,2,3,1,2,0,0,5,1,-1,2
586,581,581,576,18,19,18,18,3,1,1,2,5,0,5,-1,1,0
567,562,557,562,18,17,18,18,1,2,3,3,5,5,-5,1,-1,0
196,196,192,192,18,19,18,19,2,1,2,1,0,4,0,-1,1,-1
1031,1021,1021,1021,13,14,15,13,2,2,5,1,10,0,0,-1,-1,2
764,759,759,759,17,16,15,16,1,1,3,1,5,0,0,1,1,-1
871,867,871,867,18,17,18,18,2,2,1,3,4,-4,4,1,-1,0
248,239,243,239,14,14,15,13,1,2,3,2,9,-4,4,0,-1,2
707,707,703,703,13,14,12,13,1,3,1,2,0,4,0,-1,2,-1
510,501,506,510,18,17,18,19,3,2,3,3,9,-5,-4,1,-1,-1
459,459,459,459,17,19,18,18,2,1,2,1,0,0,0,-2,1,0
328,323,328,328,18,19,18,19,1,2,1,1,5,-5,0,-1,1,-1
857,848,843,834,21,19,20,21,1,1,2,2,9,5,9,2,-1,-1
450,445,445,440,13,14,15,16,2,1,2,2,5,0,5,-1,-1,-1
796,792,792,787,14,14,13,13,2,2,2,2,4,0,5,0,1,0
450,445,440,445,13,14,12,13,2,3,3,3,5,5,-5,-1,2,-1
553,543,543,548,14,14,13,13,1,2,2,3,10,0,-5,0,1,0
618,506,506,506,21,19,20,21,2,4,1,1,112,0,0,2,-1,-1
890,890,890,886,21,19,20,19,3,1,2,2,0,0,4,2,-1,1
895,886,890,886,21,19,20,21,3,2,2,3,9,-4,4,2,-1,-1
295,290,290,286,14,17,15,16,3,2,3,2,5,0,4,-3,2,-1
464,454,454,454,13,16,15,16,2,4,3,1,10,0,0,-3,1,-1
253,253,248,248,18,19,18,18,1,1,3,3,0,5,0,-1,1,0
318,314,314,314,14,17,15,16,1,2,3,3,4,0,0,-3,2,-1
1059,1059,1059,1059,13,14,12,13,3,3,2,2,0,0,0,-1,2,-1
510,501,506,506,21,19,20,21,1,2,1,2,9,-5,0,2,-1,-1
412,407,412,403,13,14,15,16,1,2,2,2,5,-5,9,-1,-1,-1
520,520,510,801,14,14,13,11,1,3,3,1,0,10,-291,0,1,2
389,370,370,370,13,14,15,13,1,3,1,3,19,0,0,-1,-1,2
1064,1054,1054,1050,13,14,12,13,2,2,1,2,10,0,4,-1,2,-1
614,609,609,609,14,17,15,16,3,2,1,1,5,0,0,-3,2,-1
524,506,496,487,14,17,15,16,1,2,4,2,18,10,9,-3,2,-1
637,637,628,623,17,19,18,19,3,1,1,2,0,9,5,-2,1,-1
871,857,857,867,14,14,15,13,1,2,1,1,14,0,-10,0,-1,2
801,796,796,796,14,14,15,13,1,2,1,2,5,0,0,0,-1,2
843,834,834,834,18,19,18,18,3,2,2,1,9,0,0,-1,1,0
909,900,900,895,14,14,13,13,1,3,2,3,9,0,5,0,1,0
323,314,520,309,14,17,13,16,1,3,1,2,9,-206,211,-3,4,-3
464,468,459,459,17,16,18,18,1,1,1,1,-4,9,0,1,-2,0
787,773,778,782,21,19,20,21,3,3,1,1,14,-5,-4,2,-1,-1
520,510,510,510,18,17,18,16,1,4,1,1,10,0,0,1,-1,2
182,1078,1078,1078,21,19,20,21,1,1,1,1,-896,0,0,2,-1,-1
956,956,960,337,13,14,15,9,3,2,2,1,0,-4,623,-1,-1,6
314,304,309,309,21,19,21,21,1,2,1,1,10,-5,0,2,-2,0
234,229,229,224,14,17,15,16,1,2,2,2,5,0,5,-3,2,-1
820,810,815,815,18,17,18,19,1,2,3,2,10,-5,0,1,-1,-1
768,754,759,754,20,19,20,18,2,2,1,1,14,-5,5,1,-1,2
974,979,970,965,17,19,18,18,2,1,1,1,-5,9,5,-2,1,0
445,445,445,445,13,14,15,13,4,2,1,3,0,0,0,-1,-1,2
220,224,224,224,21,19,20,21,4,2,1,1,-4,0,0,2,-1,-1
562,557,562,562,21,19,20,21,1,2,1,1,5,-5,0,2,-1,-1
520,515,510,510,14,14,13,13,1,3,1,1,5,5,0,0,1,0
1050,1045,1040,1036,13,14,12,13,1,1,2,4,5,5,4,-1,2,-1
210,201,196,196,14,14,13,13,1,4,3,3,9,5,0,0,1,0
609,604,604,604,21,19,20,21,2,1,1,2,5,0,0,2,-1,-1
398,398,398,398,17,16,15,16,3,3,1,1,0,0,0,1,1,-1
370,356,360,360,20,19,20,21,2,4,1,1,14,-4,0,1,-1,-1
229,220,215,215,18,17,18,16,1,2,1,1,9,5,0,1,-1,2
974,970,970,970,17,16,18,18,1,4,1,1,4,0,0,1,-2,0
496,487,487,487,14,14,15,13,1,2,1,3,9,0,0,0,-1,2
337,323,323,328,17,17,18,19,2,2,1,1,14,0,-5,0,-1,-1
890,862,862,871,14,14,15,13,4,2,2,3,28,0,-9,0,-1,2
445,440,436,436,17,16,15,16,2,3,2,1,5,4,0,1,1,-1
192,182,182,182,18,19,18,19,1,2,1,1,10,0,0,-1,1,-1
529,524,524,529,18,19,18,19,1,2,3,1,5,0,-5,-1,1,-1
642,637,642,642,20,19,18,18,1,3,2,3,5,-5,0,1,1,0
904,881,876,871,18,17,18,18,2,2,2,2,23,5,5,1,-1,0
951,942,951,960,20,19,20,18,2,2,1,1,9,-9,-9,1,-1,2
271,271,276,271,14,14,13,13,2,4,2,1,0,-5,5,0,1,0
824,820,815,815,21,19,20,21,1,1,1,1,4,5,0,2,-1,-1
689,689,684,679,17,16,15,16,1,3,2,2,0,5,5,1,1,-1
764,754,764,773,20,19,18,18,2,1,1,1,10,-10,-9,1,1,0
632,623,623,623,13,14,13,13,1,2,1,2,9,0,0,-1,1,0
689,689,689,693,17,16,18,18,1,2,1,1,0,0,-4,1,-2,0
553,539,543,543,18,19,18,18,1,1,1,2,14,-4,0,-1,1,0
900,900,895,895,21,19,20,21,2,2,1,2,0,5,0,2,-1,-1
1031,1026,1021,1021,20,19,18,18,2,1,1,1,5,5,0,1,1,0
998,993,993,993,20,19,20,21,1,2,1,1,5,0,0,1,-1,-1
206,210,201,201,14,14,15,13,2,3,1,2,-4,9,0,0,-1,2
595,590,590,590,14,17,15,16,2,2,2,2,5,0,0,-3,2,-1
1031,1021,1017,1017,17,16,18,16,3,1,1,3,10,4,0,1,-2,2
295,286,286,286,14,14,13,13,4,2,2,2,9,0,0,0,1,0
876,871,876,867,14,17,15,16,1,3,2,2,5,-5,9,-3,2,-1
839,829,829,829,18,19,18,19,3,2,1,1,10,0,0,-1,1,-1
726,717,721,717,17,16,18,18,2,4,2,1,9,-4,4,1,-2,0
323,323,318,318,14,14,13,13,1,2,1,1,0,5,0,0,1,0
187,182,1078,1073,18,19,18,18,3,2,2,1,5,-896,5,-1,1,0
314,314,309,309,18,17,18,16,2,3,2,4,0,5,0,1,-1,2
834,829,824,824,18,17,18,19,1,2,1,1,5,5,0,1,-1,-1
618,618,618,614,21,19,21,19,2,1,2,2,0,0,4,2,-2,2
876,876,881,871,14,14,13,13,2,2,1,1,0,-5,10,0,1,0
824,815,810,810,14,17,15,16,3,3,3,3,9,5,0,-3,2,-1
796,796,796,796,18,19,18,19,1,1,1,2,0,0,0,-1,1,-1
210,215,215,210,21,19,20,19,2,1,1,2,-5,0,5,2,-1,1
356,351,351,351,20,19,20,18,3,2,1,1,5,0,0,1,-1,2
618,623,623,618,14,17,15,16,2,1,2,3,-5,0,5,-3,2,-1
876,867,871,871,21,19,20,21,3,2,2,1,9,-4,0,2,-1,-1
557,548,553,553,18,19,18,18,2,2,2,3,9,-5,0,-1,1,0
712,703,712,712,20,19,20,21,1,3,1,1,9,-9,0,1,-1,-1
703,703,703,703,20,19,18,18,3,2,2,1,0,0,0,1,1,0
267,257,431,248,14,17,23,16,3,1,1,3,10,-174,183,-3,-6,7
703,703,698,698,20,19,20,21,1,3,1,1,0,5,0,1,-1,-1
351,342,342,342,13,14,12,13,2,3,1,1,9,0,0,-1,2,-1
1003,998,1003,1003,20,19,20,18,3,5,1,2,5,-5,0,1,-1,2
970,970,970,965,13,14,12,13,1,3,1,2,0,0,5,-1,2,-1
881,876,876,876,18,17,18,18,1,1,1,1,5,0,0,1,-1,0
431,421,557,417,13,14,18,13,1,5,1,1,10,-136,140,-1,-4,5
665,656,656,656,13,14,12,13,3,3,1,2,9,0,0,-1,2,-1
759,754,750,750,20,19,20,18,2,1,2,1,5,4,0,1,-1,2
764,764,768,764,20,19,20,21,3,1,1,1,0,-4,4,1,-1,-1
590,581,581,576,14,14,15,16,3,1,2,1,9,0,5,0,-1,-1
712,703,698,698,13,14,15,13,2,2,3,1,9,5,0,-1,-1,2
660,646,651,646,17,16,18,16,2,2,1,2,14,-5,5,1,-2,2
403,389,389,384,17,16,18,16,1,3,2,4,14,0,5,1,-2,2
543,539,534,539,14,14,13,13,1,3,1,3,4,5,-5,0,1,0
370,365,360,365,13,14,12,13,3,1,1,3,5,5,-5,-1,2,-1
965,956,960,956,17,16,18,16,1,4,1,2,9,-4,4,1,-2,2
187,1073,1078,1073,21,19,20,21,1,2,1,2,-886,-5,5,2,-1,-1
323,318,318,318,14,17,15,16,2,1,2,1,5,0,0,-3,2,-1
726,717,717,721,13,16,15,16,2,2,3,1,9,0,-4,-3,1,-1
960,956,951,956,13,14,15,16,2,2,3,1,4,5,-5,-1,-1,-1
510,506,510,506,18,17,18,19,2,1,3,2,4,-4,4,1,-1,-1
656,642,642,646,17,16,15,16,2,2,2,3,14,0,-4,1,1,-1
487,487,482,482,18,19,18,19,2,2,1,1,0,5,0,-1,1,-1
276,271,271,276,18,17,18,18,1,2,1,1,5,0,-5,1,-1,0
918,914,914,914,14,14,15,16,1,3,2,1,4,0,0,0,-1,-1
651,651,651,646,20,19,20,21,1,3,1,2,0,0,5,1,-1,-1
862,853,853,857,18,17,18,18,3,1,1,1,9,0,-4,1,-1,0
984,974,970,965,13,14,15,13,2,3,3,1,10,4,5,-1,-1,2
876,876,871,871,18,17,18,18,4,1,1,1,0,5,0,1,-1,0
820,820,815,810,14,14,15,13,1,3,1,2,0,5,5,0,-1,2
590,586,581,581,18,17,18,16,1,1,1,1,4,5,0,1,-1,2
1064,1064,1064,1068,20,19,18,18,1,2,1,2,0,0,-4,1,1,0
993,989,1003,998,13,14,12,13,1,2,2,3,4,-14,5,-1,2,-1
778,773,768,768,13,14,12,13,2,3,1,1,5,5,0,-1,2,-1
590,595,586,586,18,17,18,16,2,1,1,1,-5,9,0,1,-1,2
689,684,689,689,20,19,20,21,1,2,1,3,5,-5,0,1,-1,-1
215,206,210,210,18,19,18,19,1,2,1,1,9,-4,0,-1,1,-1
1045,1040,1040,1040,17,16,18,18,1,2,1,1,5,0,0,1,-2,0
768,759,759,759,13,14,15,16,3,3,2,1,9,0,0,-1,-1,-1
243,243,243,239,18,19,18,18,2,2,2,1,0,0,4,-1,1,0
192,187,182,1078,21,19,21,21,2,1,1,1,5,5,-896,2,-2,0
993,989,984,979,20,19,20,18,1,2,1,5,4,5,5,1,-1,2
806,801,796,787,14,14,15,16,1,3,2,4,5,5,9,0,-1,-1
637,623,623,623,13,14,13,13,1,2,2,2,14,0,0,-1,1,0
459,454,459,454,17,16,18,16,6,1,2,2,5,-5,5,1,-2,2
309,304,309,304,14,17,15,16,1,1,2,1,5,-5,5,-3,2,-1
923,918,918,918,18,19,18,19,1,1,2,1,5,0,0,-1,1,-1
970,970,965,960,17,16,18,18,2,3,2,2,0,5,5,1,-2,0
890,881,881,876,14,17,15,16,2,2,3,2,9,0,5,-3,2,-1
482,482,478,478,14,14,13,13,2,2,1,1,0,4,0,0,1,0
543,534,524,524,21,19,20,19,1,1,1,1,9,10,0,2,-1,1
539,534,534,534,21,19,20,21,1,2,2,3,5,0,0,2,-1,-1
689,679,679,674,13,14,15,13,2,1,3,2,10,0,5,-1,-1,2
276,267,271,271,14,17,15,16,1,2,2,1,9,-4,0,-3,2,-1
773,773,768,778,20,19,20,18,1,1,1,1,0,5,-10,1,-1,2
796,792,787,787,18,17,18,19,2,1,3,2,4,5,0,1,-1,-1
182,1078,1073,1073,14,14,12,13,1,1,1,1,-896,5,0,0,2,-1
487,473,482,482,14,14,13,13,1,2,1,1,14,-9,0,0,1,0
496,492,492,492,18,19,18,19,1,2,1,2,4,0,0,-1,1,-1
524,520,520,515,18,17,18,19,1,1,2,2,4,0,5,1,-1,-1
543,534,529,529,14,14,13,13,2,1,2,1,9,5,0,0,1,0
918,914,914,914,14,17,15,16,1,2,3,1,4,0,0,-3,2,-1
337,337,332,332,17,16,18,18,3,3,1,1,0,5,0,1,-2,0
1064,1059,1059,1059,17,16,18,18,2,2,3,1,5,0,0,1,-2,0
646,646,642,642,17,16,18,18,1,1,2,1,0,4,0,1,-2,0
539,520,520,524,14,14,15,13,3,2,1,2,19,0,-4,0,-1,2
1003,989,989,984,13,14,15,16,2,2,2,1,14,0,5,-1,-1,-1
271,271,271,271,14,14,15,13,2,1,2,1,0,0,0,0,-1,2
1040,1036,1036,1031,13,14,12,13,3,2,3,2,4,0,5,-1,2,-1
234,220,220,215,18,17,18,19,1,2,2,3,14,0,5,1,-1,-1
384,379,374,374,13,14,15,13,1,2,3,3,5,5,0,-1,-1,2
768,759,759,764,13,14,15,13,1,1,2,1,9,0,-5,-1,-1,2
234,224,215,210,14,14,13,13,3,1,1,4,10,9,5,0,1,0
454,464,454,459,20,19,20,18,1,3,1,1,-10,10,-5,1,-1,2
487,487,487,487,14,14,13,13,1,2,3,2,0,0,0,0,1,0
440,431,426,426,13,14,12,13,2,4,1,2,9,5,0,-1,2,-1
300,295,300,295,18,19,18,19,3,3,2,1,5,-5,5,-1,1,-1
853,843,839,843,14,14,13,13,3,2,3,3,10,4,-4,0,1,0
689,689,684,684,20,19,20,18,1,3,2,1,0,5,0,1,-1,2
253,234,239,239,14,14,13,13,3,2,1,1,19,-5,0,0,1,0
581,567,567,562,21,19,20,18,1,2,1,1,14,0,5,2,-1,2
1040,1040,1045,1040,20,19,20,18,2,1,1,3,0,-5,5,1,-1,2
192,182,196,182,14,17,15,16,1,2,1,1,10,-14,14,-3,2,-1
520,571,571,571,14,14,13,13,1,2,3,4,-51,0,0,0,1,0
454,450,450,450,20,19,20,21,1,2,1,1,4,0,0,1,-1,-1
454,445,450,450,13,14,15,16,1,2,1,1,9,-5,0,-1,-1,-1
946,951,951,946,13,14,12,13,3,1,1,1,-5,0,5,-1,2,-1
290,290,286,300,14,14,13,13,2,3,1,1,0,4,-14,0,1,0
890,886,886,886,18,19,18,19,1,1,2,1,4,0,0,-1,1,-1
253,248,239,239,14,17,15,16,3,3,3,1,5,9,0,-3,2,-1
904,895,890,886,14,14,13,13,1,3,1,3,9,5,4,0,1,0
609,609,712,604,21,19,12,21,1,1,1,1,0,-103,108,2,7,-9
224,220,215,215,21,19,20,21,3,1,1,1,4,5,0,2,-1,-1
993,984,965,965,13,14,15,13,3,5,1,2,9,19,0,-1,-1,2
703,693,693,693,13,14,15,13,3,3,1,1,10,0,0,-1,-1,2
839,834,839,834,14,14,15,13,3,3,1,1,5,-5,5,0,-1,2
810,801,806,801,14,14,15,16,3,4,2,2,9,-5,5,0,-1,-1
740,731,717,712,13,14,15,13,2,1,1,2,9,14,5,-1,-1,2
993,993,993,993,17,19,18,18,2,1,2,1,0,0,0,-2,1,0
267,257,257,253,18,17,18,18,1,3,2,1,10,0,4,1,-1,0
510,510,506,506,14,14,13,13,2,3,3,1,0,4,0,0,1,0
496,487,482,482,18,17,18,19,2,3,1,1,9,5,0,1,-1,-1
604,595,595,586,14,14,13,13,3,4,1,2,9,0,9,0,1,0
398,393,393,389,20,19,20,21,2,1,3,2,5,0,4,1,-1,-1
1040,1036,1040,1031,13,14,12,13,3,2,2,2,4,-4,9,-1,2,-1
286,281,281,276,18,19,18,18,1,2,2,1,5,0,5,-1,1,0
253,253,248,248,14,17,15,16,1,1,2,1,0,5,0,-3,2,-1
529,524,529,529,14,17,15,16,2,2,2,1,5,-5,0,-3,2,-1
904,895,900,895,18,19,18,19,1,2,2,1,9,-5,5,-1,1,-1
965,956,951,951,17,16,18,18,2,3,1,2,9,5,0,1,-2,0
506,506,506,510,18,17,18,19,1,1,3,1,0,0,-4,1,-1,-1
646,642,637,637,17,16,15,16,2,1,1,2,4,5,0,1,1,-1
332,323,323,323,13,14,15,13,1,2,1,1,9,0,0,-1,-1,2
712,712,707,707,20,19,20,21,1,1,1,1,0,5,0,1,-1,-1
440,436,431,431,13,14,12,13,3,2,1,2,4,5,0,-1,2,-1
1026,1026,1021,1021,17,16,18,18,1,1,1,1,0,5,0,1,-2,0
660,660,665,670,17,16,18,18,1,1,1,1,0,-5,-5,1,-2,0
862,857,853,853,21,19,20,18,1,1,1,2,5,4,0,2,-1,2
304,300,300,295,18,17,18,16,3,2,2,1,4,0,5,1,-1,2
407,407,403,407,20,19,18,18,1,1,3,1,0,4,-4,1,1,0
853,843,848,848,18,17,18,18,1,2,2,1,10,-5,0,1,-1,0
473,464,464,464,20,19,20,21,1,2,1,2,9,0,0,1,-1,-1
1073,1059,1073,1068,13,14,12,13,1,4,2,1,14,-14,5,-1,2,-1
618,618,628,623,21,19,21,19,2,2,2,1,0,-10,5,2,-2,2
1045,1031,510,1036,17,16,15,16,4,2,1,2,14,521,-526,1,1,-1
257,243,239,243,14,14,15,13,3,3,2,1,14,4,-4,0,-1,2
309,295,295,290,14,17,15,16,1,2,1,2,14,0,5,-3,2,-1
271,267,271,267,21,19,20,18,2,2,2,1,4,-4,4,2,-1,2
567,557,562,562,18,17,18,16,1,1,1,1,10,-5,0,1,-1,2
323,323,323,323,18,19,21,19,2,2,1,2,0,0,0,-1,-2,2
707,707,707,707,13,14,15,13,1,3,3,2,0,0,0,-1,-1,2
276,271,271,267,14,14,13,13,1,3,2,1,5,0,4,0,1,0
670,670,670,670,20,19,20,21,3,1,1,1,0,0,0,1,-1,-1
914,918,914,914,21,19,21,21,1,2,1,1,-4,4,0,2,-2,0
942,942,937,932,13,14,15,16,3,3,2,2,0,5,5,-1,-1,-1
721,721,721,717,13,14,12,13,3,1,3,2,0,0,4,-1,2,-1
196,192,187,187,14,17,15,16,1,1,1,1,4,5,0,-3,2,-1
571,562,557,553,14,14,13,13,2,1,2,3,9,5,4,0,1,0
239,229,229,229,14,14,15,13,1,2,2,1,10,0,0,0,-1,2
857,843,843,843,18,19,18,18,1,1,1,1,14,0,0,-1,1,0
1040,1036,1036,1031,17,16,15,16,2,2,3,2,4,0,5,1,1,-1
712,703,707,707,13,14,15,13,2,4,2,1,9,-4,0,-1,-1,2
684,679,679,684,20,19,18,18,3,1,1,1,5,0,-5,1,1,0
440,436,436,436,17,16,18,18,2,1,2,3,4,0,0,1,-2,0
618,600,600,590,14,14,13,13,3,4,2,2,18,0,10,0,1,0
951,951,946,942,20,19,18,18,3,1,1,1,0,5,4,1,1,0
1068,1064,1064,1059,13,14,15,16,3,2,3,2,4,0,5,-1,-1,-1
492,473,468,464,14,14,15,13,2,1,2,1,19,5,4,0,-1,2
778,773,768,773,13,14,15,16,1,2,5,2,5,5,-5,-1,-1,-1
529,524,707,524,14,14,20,13,1,2,1,1,5,-183,183,0,-6,7
942,932,932,937,13,14,13,13,2,2,1,1,10,0,-5,-1,1,0
220,215,210,210,18,17,18,19,1,1,1,1,5,5,0,1,-1,-1
703,698,698,698,20,19,18,18,1,2,1,3,5,0,0,1,1,0
342,337,323,323,13,14,13,13,1,1,1,1,5,14,0,-1,1,0
848,843,839,839,18,17,18,16,3,3,1,1,5,4,0,1,-1,2
834,820,820,815,14,17,15,16,1,2,1,3,14,0,5,-3,2,-1
689,689,684,684,13,14,12,13,1,2,2,3,0,5,0,-1,2,-1
182,1068,1078,1073,18,19,18,18,2,2,2,3,-886,-10,5,-1,1,0
478,473,473,468,17,16,15,16,2,1,2,1,5,0,5,1,1,-1
276,271,271,267,21,19,20,21,2,2,1,1,5,0,4,2,-1,-1
1007,1003,1003,998,20,19,20,21,2,2,2,1,4,0,5,1,-1,-1
646,637,642,642,17,16,15,16,2,2,1,1,9,-5,0,1,1,-1
436,426,421,421,13,16,15,16,2,3,2,2,10,5,0,-3,1,-1
515,515,515,510,14,17,15,16,3,1,1,3,0,0,5,-3,2,-1
370,370,370,370,17,16,15,16,2,1,2,1,0,0,0,1,1,-1
346,337,337,332,13,14,12,13,1,2,1,2,9,0,5,-1,2,-1
393,384,389,389,20,19,20,21,2,2,1,1,9,-5,0,1,-1,-1
1021,1012,1017,1017,17,19,18,18,1,3,2,1,9,-5,0,-2,1,0
1017,1007,1003,1003,13,14,15,13,2,3,1,1,10,4,0,-1,-1,2
534,524,524,529,21,19,20,19,1,3,2,4,10,0,-5,2,-1,1
510,501,506,506,14,14,15,13,1,2,3,1,9,-5,0,0,-1,2
534,529,524,524,14,14,13,13,3,1,1,2,5,5,0,0,1,0
243,239,239,239,21,19,20,21,3,1,1,2,4,0,0,2,-1,-1
895,886,886,886,14,14,13,13,5,1,1,3,9,0,0,0,1,0
974,970,979,974,13,14,15,13,1,1,2,2,4,-9,5,-1,-1,2
243,234,234,229,18,19,18,19,1,2,3,2,9,0,5,-1,1,-1
1068,1068,1064,1064,20,19,18,18,1,1,1,1,0,4,0,1,1,0
304,300,304,304,18,17,18,19,2,2,3,1,4,-4,0,1,-1,-1
534,529,524,524,18,17,18,19,3,2,1,1,5,5,0,1,-1,-1
989,984,970,970,17,16,18,18,2,1,3,2,5,14,0,1,-2,0
421,421,421,417,20,19,20,21,1,2,2,2,0,0,4,1,-1,-1
473,468,468,459,20,19,20,18,2,2,2,1,5,0,9,1,-1,2
674,674,674,674,13,16,15,16,3,1,2,1,0,0,0,-3,1,-1
271,271,267,262,18,19,20,18,3,1,2,2,0,4,5,-1,-1,2
262,253,262,257,14,14,13,13,3,2,2,1,9,-9,5,0,1,0
304,295,300,295,14,17,15,16,3,3,4,2,9,-5,5,-3,2,-1
604,600,590,576,14,14,15,13,1,1,2,2,4,10,14,0,-1,2
1012,1007,1012,1007,17,16,18,18,3,2,2,2,5,-5,5,1,-2,0
229,206,215,210,18,17,18,16,1,4,2,2,23,-9,5,1,-1,2
581,581,581,576,21,19,20,18,1,1,1,1,0,0,5,2,-1,2
281,267,262,267,14,14,13,13,2,1,1,1,14,5,-5,0,1,0
454,450,445,445,17,16,18,18,2,1,1,2,4,5,0,1,-2,0
487,473,473,473,21,19,20,21,2,2,1,1,14,0,0,2,-1,-1
839,839,839,834,14,14,13,13,2,1,1,1,0,0,5,0,1,0
407,407,398,398,13,14,15,13,2,3,3,2,0,9,0,-1,-1,2
220,220,215,215,18,19,18,19,3,2,1,1,0,5,0,-1,1,-1
689,684,684,689,20,19,20,18,1,2,3,1,5,0,-5,1,-1,2
567,553,557,548,14,14,13,13,1,5,1,2,14,-4,9,0,1,0
243,239,239,234,14,17,15,16,2,2,1,3,4,0,5,-3,2,-1
182,182,1078,1073,14,14,13,13,2,1,1,2,0,-896,5,0,1,0
745,736,731,736,17,16,18,18,3,1,1,1,9,5,-5,1,-2,0
524,506,510,515,18,17,18,19,2,2,1,1,18,-4,-5,1,-1,-1
1059,1054,1059,1054,13,14,12,13,1,2,2,1,5,-5,5,-1,2,-1
318,314,314,314,18,19,18,19,1,2,1,1,4,0,0,-1,1,-1
384,384,384,384,17,16,15,16,1,1,3,1,0,0,0,1,1,-1
389,384,384,384,17,16,18,16,1,1,1,1,5,0,0,1,-2,2
393,393,389,389,17,16,18,16,1,1,1,2,0,4,0,1,-2,2
506,506,510,506,14,14,15,13,2,2,2,1,0,-4,4,0,-1,2
182,1073,1078,1078,18,16,18,16,1,2,1,1,-891,-5,0,2,-2,2
478,473,468,468,17,16,18,18,2,1,4,1,5,5,0,1,-2,0
820,815,815,815,14,14,13,13,2,3,1,3,5,0,0,0,1,0
267,262,257,262,14,14,15,13,3,4,1,1,5,5,-5,0,-1,2
323,318,318,318,14,14,13,13,1,4,1,1,5,0,0,0,1,0
1012,1007,1007,1007,13,14,12,13,1,4,3,2,5,0,0,-1,2,-1
1073,1064,1068,1064,17,19,18,18,3,2,1,3,9,-4,4,-2,1,0
956,960,960,960,20,19,20,18,1,3,3,1,-4,0,0,1,-1,2
693,684,674,684,20,19,18,18,2,1,3,2,9,10,-10,1,1,0
520,510,515,515,21,19,20,21,1,2,1,1,10,-5,0,2,-1,-1
773,773,768,773,13,14,15,16,1,1,3,1,0,5,-5,-1,-1,-1
215,215,210,210,14,17,15,16,1,2,1,1,0,5,0,-3,2,-1
229,206,196,201,14,14,13,13,3,1,1,3,23,10,-5,0,1,0
562,553,553,548,18,19,18,18,2,2,1,2,9,0,5,-1,1,0
571,562,567,557,18,19,18,18,2,2,2,2,9,-5,10,-1,1,0
923,923,923,918,18,17,18,16,1,1,2,2,0,0,5,1,-1,2
764,759,754,750,13,14,12,13,3,3,2,2,5,5,4,-1,2,-1
271,267,267,267,18,17,18,18,2,3,1,1,4,0,0,1,-1,0
834,824,824,824,14,14,13,13,1,4,1,2,10,0,0,0,1,0
576,576,576,576,18,17,18,18,2,3,1,1,0,0,0,1,-1,0
510,510,510,506,18,17,18,19,1,3,1,2,0,0,4,1,-1,-1
220,215,215,210,21,19,20,19,2,3,3,2,5,0,5,2,-1,1
356,346,356,351,13,14,12,13,3,2,5,3,10,-10,5,-1,2,-1
515,506,510,515,21,19,20,21,2,2,1,3,9,-4,-5,2,-1,-1
267,267,267,262,18,19,20,18,1,1,1,2,0,0,5,-1,-1,2
731,726,726,726,17,16,18,18,1,4,1,2,5,0,0,1,-2,0
421,407,412,412,20,19,20,18,2,2,1,1,14,-5,0,1,-1,2
478,468,468,473,17,16,15,16,2,4,1,1,10,0,-5,1,1,-1
764,750,754,754,13,14,12,13,3,2,1,2,14,-4,0,-1,2,-1
370,370,370,365,17,16,15,16,3,3,2,2,0,0,5,1,1,-1
187,1078,1073,1064,14,16,15,16,2,1,3,4,-891,5,9,-2,1,-1
857,848,848,848,18,17,18,16,1,1,3,1,9,0,0,1,-1,2
839,839,834,834,14,14,13,13,3,2,1,3,0,5,0,0,1,0
1068,1059,1059,1059,13,14,15,13,2,3,1,1,9,0,0,-1,-1,2
956,946,942,946,17,16,15,16,2,1,3,4,10,4,-4,1,1,-1
370,360,360,360,20,19,20,21,1,2,1,1,10,0,0,1,-1,-1
393,384,379,379,17,16,15,16,2,3,1,1,9,5,0,1,1,-1
393,384,389,384,13,14,12,13,1,4,2,2,9,-5,5,-1,2,-1
1017,1012,1012,1007,17,16,15,16,2,1,1,2,5,0,5,1,1,-1
782,787,787,782,14,17,15,16,1,1,2,2,-5,0,5,-3,2,-1
1007,1003,1007,1003,13,14,12,13,1,3,3,2,4,-4,4,-1,2,-1
248,243,243,243,18,17,18,16,2,2,1,1,5,0,0,1,-1,2
1036,1026,1021,1021,17,16,15,16,2,1,1,1,10,5,0,1,1,-1
210,201,196,192,14,14,15,16,2,1,2,2,9,5,4,0,-1,-1
810,801,806,806,14,17,15,16,2,2,1,1,9,-5,0,-3,2,-1
1054,1050,1040,1045,13,14,15,16,1,1,1,2,4,10,-5,-1,-1,-1
820,810,806,806,14,14,13,13,3,3,3,2,10,4,0,0,1,0
562,557,562,557,14,14,15,16,2,4,1,1,5,-5,5,0,-1,-1
421,421,417,417,20,19,20,21,1,1,3,2,0,4,0,1,-1,-1
1068,1064,1064,1068,20,19,20,21,1,2,1,5,4,0,-4,1,-1,-1
356,342,351,356,13,16,15,16,2,2,2,1,14,-9,-5,-3,1,-1
670,665,665,665,17,16,15,16,3,2,3,2,5,0,0,1,1,-1
567,562,567,557,14,17,15,16,2,1,2,1,5,-5,10,-3,2,-1
468,689,450,450,20,16,18,18,1,1,3,3,-221,239,0,4,-2,0
257,248,248,248,14,14,15,16,2,3,2,1,9,0,0,0,-1,-1
501,487,473,468,14,14,12,13,1,3,3,2,14,14,5,0,2,-1
998,984,989,989,17,16,15,16,1,2,3,3,14,-5,0,1,1,-1
304,295,295,295,14,14,15,13,2,2,2,1,9,0,0,0,-1,2
257,248,253,253,14,17,15,16,3,4,1,1,9,-5,0,-3,2,-1
881,876,876,876,14,17,15,16,1,2,1,2,5,0,0,-3,2,-1
623,618,618,614,14,14,15,13,1,3,1,2,5,0,4,0,-1,2
698,698,698,693,17,16,15,16,1,3,2,4,0,0,5,1,1,-1
810,810,806,806,14,14,13,13,2,1,1,2,0,4,0,0,1,0
857,843,839,834,14,14,13,13,2,2,1,2,14,4,5,0,1,0
843,839,834,834,14,17,15,16,1,4,1,1,4,5,0,-3,2,-1
487,482,482,482,14,17,15,16,1,1,1,1,5,0,0,-3,2,-1
951,942,942,946,20,19,20,18,2,1,1,1,9,0,-4,1,-1,2
262,257,257,253,21,19,20,21,2,3,1,2,5,0,4,2,-1,-1
215,215,215,206,14,14,15,13,2,3,2,3,0,0,9,0,-1,2
309,309,309,309,14,14,15,13,1,3,2,3,0,0,0,0,-1,2
248,248,248,248,14,14,13,13,2,3,1,4,0,0,0,0,1,0
501,501,496,496,14,14,15,13,5,3,1,2,0,5,0,0,-1,2
314,314,314,314,18,19,18,19,2,1,2,1,0,0,0,-1,1,-1
689,693,689,684,17,16,15,16,3,5,1,2,-4,4,5,1,1,-1
407,407,407,403,17,16,18,16,3,1,3,1,0,0,4,1,-2,2
543,534,539,539,21,19,20,21,1,2,1,1,9,-5,0,2,-1,-1
445,445,445,440,13,14,12,13,1,1,2,3,0,0,5,-1,2,-1
900,890,895,895,14,14,15,13,3,3,1,3,10,-5,0,0,-1,2
979,979,979,979,13,16,15,16,1,2,2,1,0,0,0,-3,1,-1
553,548,543,543,18,19,18,18,1,2,1,1,5,5,0,-1,1,0
1040,1036,1031,1031,13,14,12,13,1,2,4,2,4,5,0,-1,2,-1
876,867,871,871,14,14,15,13,1,3,2,2,9,-4,0,0,-1,2
698,698,707,707,13,14,15,13,1,1,2,2,0,-9,0,-1,-1,2
356,351,346,342,13,14,15,13,1,3,1,2,5,5,4,-1,-1,2
693,684,679,679,13,14,15,13,2,3,1,1,9,5,0,-1,-1,2
192,187,192,187,14,14,13,13,1,2,3,1,5,-5,5,0,1,0
707,698,698,698,20,19,18,18,2,3,1,1,9,0,0,1,1,0
942,942,937,937,17,19,18,18,2,1,2,2,0,5,0,-2,1,0
993,984,979,974,13,14,15,13,1,3,1,4,9,5,5,-1,-1,2
759,754,754,754,20,19,20,21,3,2,3,3,5,0,0,1,-1,-1
187,182,187,182,18,17,18,19,2,2,2,1,5,-5,5,1,-1,-1
384,384,379,407,20,19,20,21,3,1,1,3,0,5,-28,1,-1,-1
782,778,778,768,14,16,15,16,1,1,1,2,4,0,10,-2,1,-1
393,393,393,389,17,16,18,16,3,2,1,2,0,0,4,1,-2,2
979,974,974,979,20,19,20,21,2,2,1,3,5,0,-5,1,-1,-1
304,295,304,314,21,19,20,21,3,3,1,3,9,-9,-10,2,-1,-1
534,539,539,539,14,14,13,13,2,3,1,1,-5,0,0,0,1,0
843,824,824,824,21,19,20,19,3,2,1,2,19,0,0,2,-1,1
946,937,937,937,13,14,12,13,2,3,1,2,9,0,0,-1,2,-1
393,389,389,379,17,19,18,18,3,1,2,1,4,0,10,-2,1,0
1007,998,1003,1003,20,19,20,18,1,1,2,1,9,-5,0,1,-1,2
281,271,281,276,14,14,15,13,2,2,3,1,10,-10,5,0,-1,2
820,810,806,806,14,14,13,13,3,2,2,1,10,4,0,0,1,0
271,262,267,271,14,14,13,13,1,1,2,1,9,-5,-4,0,1,0
450,445,445,440,17,16,18,18,3,1,2,2,5,0,5,1,-2,0
398,393,393,393,13,14,15,13,1,2,2,1,5,0,0,-1,-1,2
721,717,712,717,13,14,12,13,2,3,2,3,4,5,-5,-1,2,-1
571,557,548,557,14,17,15,16,1,2,1,3,14,9,-9,-3,2,-1
970,970,970,965,17,19,18,18,1,1,2,2,0,0,5,-2,1,0
271,271,267,257,18,17,15,16,2,2,3,2,0,4,10,1,2,-1
1054,1050,1050,1040,17,16,15,16,1,1,1,2,4,0,10,1,1,-1
1073,1073,1068,1073,20,19,20,21,1,1,1,1,0,5,-5,1,-1,-1
918,914,918,918,14,14,15,16,3,4,2,2,4,-4,0,0,-1,-1
679,674,674,674,13,14,12,13,5,2,1,1,5,0,0,-1,2,-1
182,1078,1073,1078,14,14,15,13,1,1,1,1,-896,5,-5,0,-1,2
684,674,674,670,20,19,18,18,1,2,1,1,10,0,4,1,1,0
904,890,890,886,14,17,15,16,3,3,2,1,14,0,4,-3,2,-1
520,515,515,520,14,14,13,13,3,2,2,1,5,0,-5,0,1,0
1031,1026,1021,1017,13,14,15,13,2,3,1,1,5,5,4,-1,-1,2
843,834,834,834,14,17,15,16,1,3,2,1,9,0,0,-3,2,-1
557,534,524,529,14,14,13,13,1,2,1,1,23,10,-5,0,1,0
1026,1017,1012,1012,13,14,12,13,1,1,1,1,9,5,0,-1,2,-1
773,764,764,764,13,14,15,13,1,2,1,2,9,0,0,-1,-1,2
1073,1064,1068,1064,13,14,12,13,3,2,1,1,9,-4,4,-1,2,-1
271,276,271,271,21,19,20,21,2,3,1,1,-5,5,0,2,-1,-1
201,192,196,196,14,14,13,13,2,2,2,3,9,-4,0,0,1,0
248,243,239,239,21,19,20,18,1,3,1,2,5,4,0,2,-1,2
651,637,632,642,13,14,15,13,2,3,1,4,14,5,-10,-1,-1,2
506,506,501,506,14,14,13,13,3,3,1,3,0,5,-5,0,1,0
745,740,740,736,17,19,18,18,3,3,1,2,5,0,4,-2,1,0
1026,1021,1017,1012,13,14,15,13,1,1,1,1,5,4,5,-1,-1,2
520,506,501,501,14,14,13,13,1,2,3,1,14,5,0,0,1,0
909,900,909,904,14,14,15,13,1,3,2,2,9,-9,5,0,-1,2
206,196,196,192,14,14,15,13,1,2,1,1,10,0,4,0,-1,2
267,262,248,243,14,14,15,13,2,3,1,2,5,14,5,0,-1,2
824,815,820,820,21,19,20,21,1,2,2,1,9,-5,0,2,-1,-1
253,248,253,253,18,17,18,18,1,1,2,1,5,-5,0,1,-1,0
365,356,356,356,13,14,15,13,1,2,1,1,9,0,0,-1,-1,2
431,426,421,417,17,16,15,16,1,1,1,2,5,5,4,1,1,-1
876,871,871,867,14,14,15,13,2,3,2,2,5,0,4,0,-1,2
243,229,229,229,14,14,13,13,4,1,1,1,14,0,0,0,1,0
557,557,553,553,21,19,20,18,1,1,1,2,0,4,0,2,-1,2
407,403,393,393,17,16,18,16,3,1,3,2,4,10,0,1,-2,2
1040,1036,1031,1026,13,14,15,13,3,3,3,2,4,5,5,-1,-1,2
224,215,234,215,21,19,20,19,3,1,1,1,9,-19,19,2,-1,1
876,867,862,862,14,14,15,16,3,3,1,1,9,5,0,0,-1,-1
182,1073,1073,1068,18,16,18,16,2,1,2,1,-891,0,5,2,-2,2
989,984,979,979,17,16,18,16,2,3,2,1,5,5,0,1,-2,2
440,431,426,417,17,19,18,18,2,2,1,2,9,5,9,-2,1,0
267,262,257,262,14,14,15,13,2,1,2,1,5,5,-5,0,-1,2
848,839,834,839,18,19,18,18,1,1,1,1,9,5,-5,-1,1,0
281,281,276,281,14,14,15,13,1,3,1,3,0,5,-5,0,-1,2
384,384,384,379,20,19,20,21,1,1,2,2,0,0,5,1,-1,-1
482,478,487,487,18,19,18,19,2,1,2,2,4,-9,0,-1,1,-1
820,815,806,806,21,19,20,21,1,2,3,2,5,9,0,2,-1,-1
843,834,834,829,14,17,15,16,2,1,2,1,9,0,5,-3,2,-1
1045,1040,1050,1054,20,19,20,18,2,1,3,1,5,-10,-4,1,-1,2
689,684,684,684,20,19,20,21,1,3,1,3,5,0,0,1,-1,-1
473,468,468,468,13,14,15,13,3,1,1,2,5,0,0,-1,-1,2
806,806,810,806,18,19,18,19,4,3,2,3,0,-4,4,-1,1,-1
571,557,557,557,18,19,18,18,1,2,1,3,14,0,0,-1,1,0
548,548,548,548,14,17,15,16,2,1,1,1,0,0,0,-3,2,-1
886,871,876,876,14,14,15,13,1,2,3,3,15,-5,0,0,-1,2
529,524,557,524,14,17,15,16,3,2,1,3,5,-33,33,-3,2,-1
576,539,539,534,21,19,20,21,2,1,1,3,37,0,5,2,-1,-1
1031,1040,1040,1026,17,16,18,18,2,1,2,3,-9,0,14,1,-2,0
318,314,314,314,14,14,13,13,1,1,1,1,4,0,0,0,1,0
946,942,937,937,20,19,20,18,2,1,1,1,4,5,0,1,-1,2
740,736,740,740,13,14,15,16,1,2,1,1,4,-4,0,-1,-1,-1
923,914,914,914,14,14,13,13,2,2,1,1,9,0,0,0,1,0
534,529,529,524,18,17,18,19,3,3,2,1,5,0,5,1,-1,-1
417,407,403,407,17,16,15,16,1,2,1,1,10,4,-4,1,1,-1
834,820,810,810,14,17,15,16,2,2,1,1,14,10,0,-3,2,-1
914,904,895,890,14,17,15,16,2,1,3,1,10,9,5,-3,2,-1
426,426,426,421,17,16,18,18,3,3,1,2,0,0,5,1,-2,0
942,937,928,923,17,16,18,16,3,3,1,2,5,9,5,1,-2,2
820,815,815,815,18,17,18,19,3,1,1,1,5,0,0,1,-1,-1
496,501,496,492,21,19,21,19,2,1,1,1,-5,5,4,2,-2,2
384,379,384,384,17,16,18,16,3,6,3,1,5,-5,0,1,-2,2
609,609,609,609,14,17,15,16,4,2,1,1,0,0,0,-3,2,-1
192,182,1078,1073,14,14,15,16,2,2,1,2,10,-896,5,0,-1,-1
614,614,618,618,21,19,21,19,2,1,2,1,0,-4,0,2,-2,2
989,989,984,984,17,16,15,16,1,2,1,1,0,5,0,1,1,-1
286,281,276,276,21,19,20,18,1,3,1,1,5,5,0,2,-1,2
529,529,492,524,14,17,13,16,1,2,1,1,0,37,-32,-3,4,-3
703,693,703,703,17,16,18,18,4,2,2,1,10,-10,0,1,-2,0
600,595,595,595,21,19,20,21,1,1,1,1,5,0,0,2,-1,-1
421,417,421,421,20,19,20,18,1,2,3,1,4,-4,0,1,-1,2
965,960,960,956,13,14,12,13,2,2,2,2,5,0,4,-1,2,-1
642,642,642,637,17,16,15,16,1,3,2,1,0,0,5,1,1,-1
1003,998,993,984,13,14,15,13,2,3,2,1,5,5,9,-1,-1,2
923,914,909,904,18,17,18,16,2,2,3,1,9,5,5,1,-1,2
234,229,229,224,14,14,15,13,2,1,3,2,5,0,5,0,-1,2
707,703,707,707,20,19,18,18,3,2,2,1,4,-4,0,1,1,0
623,623,628,628,18,17,18,19,2,1,1,1,0,-5,0,1,-1,-1
1064,1059,1059,1059,20,19,20,18,2,1,2,1,5,0,0,1,-1,2
1045,1040,1040,1040,13,14,12,13,2,1,2,3,5,0,0,-1,2,-1
365,360,360,360,13,14,15,13,3,5,2,1,5,0,0,-1,-1,2
984,979,974,974,20,19,20,21,2,3,4,2,5,5,0,1,-1,-1
365,365,356,356,13,14,15,13,1,1,2,1,0,9,0,-1,-1,2
993,989,984,989,13,16,15,16,3,1,3,1,4,5,-5,-3,1,-1
1078,1073,1073,1073,17,16,15,16,1,1,1,3,5,0,0,1,1,-1
740,712,731,736,13,19,15,16,2,1,1,1,28,-19,-5,-6,4,-1
782,778,778,778,14,14,13,13,2,1,2,1,4,0,0,0,1,0
431,431,431,431,20,19,20,21,1,1,1,3,0,0,0,1,-1,-1
1017,1003,1003,1003,13,14,15,13,3,3,1,3,14,0,0,-1,-1,2
436,431,426,426,20,19,20,21,2,1,1,1,5,5,0,1,-1,-1
346,342,356,337,17,16,18,16,3,1,2,2,4,-14,19,1,-2,2
1031,1026,1026,1026,17,16,15,16,4,1,1,1,5,0,0,1,1,-1
1026,1021,1017,1012,13,14,15,13,2,1,3,2,5,4,5,-1,-1,2
862,857,862,862,14,14,15,13,2,3,2,3,5,-5,0,0,-1,2
900,895,900,895,21,19,20,21,2,2,1,2,5,-5,5,2,-1,-1
956,946,951,946,20,19,20,18,1,2,3,1,10,-5,5,1,-1,2
267,267,271,262,18,19,18,18,2,2,2,1,0,-4,9,-1,1,0
215,220,215,210,21,19,20,19,2,3,3,1,-5,5,5,2,-1,1
342,337,337,332,13,16,15,16,2,2,2,1,5,0,5,-3,1,-1
937,932,928,923,17,16,18,19,2,1,1,2,5,4,5,1,-2,-1
979,965,956,951,13,14,15,13,2,1,1,2,14,9,5,-1,-1,2
1073,1050,1050,1050,13,14,15,13,1,1,2,1,23,0,0,-1,-1,2
773,768,759,764,20,19,20,18,2,1,1,1,5,9,-5,1,-1,2
726,721,721,721,17,16,18,16,2,1,2,1,5,0,0,1,-2,2
412,403,398,403,13,14,15,13,1,1,1,3,9,5,-5,-1,-1,2
224,224,224,224,21,19,20,19,2,2,1,1,0,0,0,2,-1,1
567,567,562,557,18,17,18,16,2,1,4,2,0,5,5,1,-1,2
1017,1017,1017,1017,17,16,18,18,1,3,1,1,0,0,0,1,-2,0
384,384,379,379,17,16,15,16,1,1,2,1,0,5,0,1,1,-1
389,389,374,379,20,19,20,18,3,1,3,1,0,15,-5,1,-1,2
1003,998,998,993,20,19,20,21,3,3,2,2,5,0,5,1,-1,-1
993,989,979,979,20,19,20,21,1,3,1,1,4,10,0,1,-1,-1
646,637,637,632,17,16,15,16,1,3,3,2,9,0,5,1,1,-1
290,281,281,286,14,17,15,16,2,1,1,1,9,0,-5,-3,2,-1
773,764,768,764,20,19,20,21,4,2,1,2,9,-4,4,1,-1,-1
567,562,562,557,18,17,18,16,2,3,3,3,5,0,5,1,-1,2
403,398,398,393,17,19,18,18,1,2,3,1,5,0,5,-2,1,0
679,679,679,679,13,14,15,16,1,2,1,2,0,0,0,-1,-1,-1
871,871,871,867,14,17,15,16,1,5,4,3,0,0,4,-3,2,-1
834,829,829,834,14,14,15,13,3,3,1,1,5,0,-5,0,-1,2
234,234,239,234,14,17,15,16,3,1,2,1,0,-5,5,-3,2,-1
539,534,529,529,14,14,13,13,2,3,1,1,5,5,0,0,1,0
501,496,496,496,14,14,15,13,1,2,2,1,5,0,0,0,-1,2
374,365,370,365,20,19,20,21,2,2,2,2,9,-5,5,1,-1,-1
764,759,759,764,20,19,20,21,1,1,1,1,5,0,-5,1,-1,-1
820,810,810,815,14,17,15,16,2,3,1,4,10,0,-5,-3,2,-1
374,365,360,360,17,16,18,16,2,3,1,2,9,5,0,1,-2,2
745,731,736,731,13,14,12,13,3,2,2,2,14,-5,5,-1,2,-1
196,196,192,192,18,19,18,19,3,3,1,1,0,4,0,-1,1,-1
314,300,295,295,18,17,18,16,2,2,1,1,14,5,0,1,-1,2
693,689,689,689,13,14,15,13,3,3,1,1,4,0,0,-1,-1,2
623,614,618,623,14,14,15,13,1,2,3,1,9,-4,-5,0,-1,2
271,262,267,262,18,17,18,18,3,3,1,2,9,-5,5,1,-1,0
421,412,417,407,13,14,12,13,3,4,2,2,9,-5,10,-1,2,-1
1045,1040,1036,1036,13,14,15,13,1,4,3,2,5,4,0,-1,-1,2
665,660,660,660,13,14,12,13,3,3,2,3,5,0,0,-1,2,-1
379,374,370,365,20,19,20,21,3,2,1,2,5,4,5,1,-1,-1
342,342,342,337,13,16,15,16,1,3,1,1,0,0,5,-3,1,-1
215,210,210,206,18,17,18,16,3,1,2,1,5,0,4,1,-1,2
196,196,196,192,21,19,21,21,2,1,1,2,0,0,4,2,-2,0
215,201,201,192,21,19,21,21,1,2,2,1,14,0,9,2,-2,0
740,731,726,731,13,14,15,13,2,3,1,1,9,5,-5,-1,-1,2
253,253,253,248,18,17,15,16,2,3,2,2,0,0,5,1,2,-1
576,567,567,567,14,17,15,16,1,2,2,1,9,0,0,-3,2,-1
595,590,586,586,14,14,13,13,2,3,1,3,5,4,0,0,1,0
374,370,370,365,13,14,12,13,2,3,2,2,4,0,5,-1,2,-1
1031,1031,1031,1031,20,19,18,18,1,1,4,1,0,0,0,1,1,0
262,257,257,253,21,19,20,21,2,4,2,1,5,0,4,2,-1,-1
956,956,951,951,20,19,18,18,3,1,1,1,0,5,0,1,1,0
768,764,764,759,20,19,20,21,3,6,1,2,4,0,5,1,-1,-1
510,506,510,506,14,14,15,13,1,3,2,1,4,-4,4,0,-1,2
886,871,867,867,18,17,18,18,3,3,1,1,15,4,0,1,-1,0
407,393,379,379,13,16,15,16,2,3,1,1,14,14,0,-3,1,-1
1068,1059,1054,1059,17,16,18,16,1,3,1,1,9,5,-5,1,-2,2
717,698,698,698,13,14,15,13,9,2,1,5,19,0,0,-1,-1,2
871,862,862,220,14,14,15,21,1,2,1,1,9,0,642,0,-1,-6
778,768,773,881,17,16,15,11,1,1,2,1,10,-5,-108,1,1,4
1031,1026,1031,1026,17,19,18,18,1,2,4,1,5,-5,5,-2,1,0
979,974,974,979,17,16,18,18,1,4,1,1,5,0,-5,1,-2,0
946,946,951,951,13,14,15,13,1,3,1,1,0,-5,0,-1,-1,2
623,618,623,618,14,14,15,13,1,1,1,3,5,-5,5,0,-1,2
829,824,829,820,14,17,15,16,1,2,2,2,5,-5,9,-3,2,-1
946,946,946,946,13,14,15,16,2,1,2,1,0,0,0,-1,-1,-1
520,515,510,510,18,17,18,16,1,1,1,2,5,5,0,1,-1,2
1031,1031,1026,1026,20,19,20,18,3,1,3,2,0,5,0,1,-1,2
604,600,600,600,21,19,20,19,1,3,1,2,4,0,0,2,-1,1
942,937,942,932,17,16,15,16,2,2,2,2,5,-5,10,1,1,-1
839,834,834,829,18,17,18,16,1,3,1,2,5,0,5,1,-1,2
965,956,956,960,13,14,15,13,1,2,1,1,9,0,-4,-1,-1,2
224,220,215,210,21,19,20,21,1,3,1,2,4,5,5,2,-1,-1
286,276,286,271,18,19,18,18,1,3,1,3,10,-10,15,-1,1,0
389,384,379,384,20,19,18,18,4,1,1,1,5,5,-5,1,1,0
698,684,689,689,13,14,15,13,1,2,2,1,14,-5,0,-1,-1,2
590,586,586,581,14,14,15,13,3,3,2,2,4,0,5,0,-1,2
684,674,670,670,13,14,15,13,2,3,1,3,10,4,0,-1,-1,2
974,960,956,951,20,19,20,21,2,2,2,1,14,4,5,1,-1,-1
895,890,886,886,18,17,18,19,2,2,1,1,5,4,0,1,-1,-1
754,745,745,740,13,14,12,13,2,3,2,1,9,0,5,-1,2,-1
210,201,192,196,18,19,18,19,1,1,3,3,9,9,-4,-1,1,-1
721,712,707,703,17,16,15,16,1,1,1,1,9,5,4,1,1,-1
614,614,614,614,18,19,18,19,1,2,3,1,0,0,0,-1,1,-1
946,937,923,928,17,16,15,16,3,2,1,1,9,14,-5,1,1,-1
1007,1007,998,993,13,14,15,13,2,2,1,1,0,9,5,-1,-1,2
970,956,951,951,13,14,12,13,2,2,2,2,14,5,0,-1,2,-1
745,736,740,736,20,19,20,21,1,1,1,2,9,-4,4,1,-1,-1
600,595,586,600,18,19,20,19,1,2,1,4,5,9,-14,-1,-1,1
215,201,196,201,14,14,15,13,1,2,1,2,14,5,-5,0,-1,2
839,834,834,829,14,14,15,13,3,2,1,1,5,0,5,0,-1,2
871,867,867,867,18,17,18,16,1,4,5,1,4,0,0,1,-1,2
754,750,754,759,20,19,20,18,3,2,2,2,4,-4,-5,1,-1,2
600,590,586,586,14,14,15,13,3,3,1,3,10,4,0,0,-1,2
1017,1007,1012,1017,17,16,15,16,2,3,2,1,10,-5,-5,1,1,-1
736,731,731,731,20,19,20,18,1,2,3,1,5,0,0,1,-1,2
876,871,871,867,18,19,18,18,3,1,2,1,5,0,4,-1,1,0
482,487,482,482,18,17,18,19,2,1,1,1,-5,5,0,1,-1,-1
262,267,267,267,14,14,13,13,4,2,1,1,-5,0,0,0,1,0
426,417,412,417,17,16,15,16,1,2,3,1,9,5,-5,1,1,-1
234,229,234,229,14,14,15,16,2,1,1,1,5,-5,5,0,-1,-1
801,796,796,792,18,19,18,19,3,2,1,1,5,0,4,-1,1,-1
600,595,590,595,14,14,15,13,1,1,1,1,5,5,-5,0,-1,2
604,595,586,586,14,14,15,13,2,3,3,2,9,9,0,0,-1,2
928,928,923,918,14,17,15,16,1,1,2,1,0,5,5,-3,2,-1
300,290,290,290,14,14,13,13,2,1,2,1,10,0,0,0,1,0
379,370,374,370,17,16,15,16,2,2,1,2,9,-4,4,1,1,-1
764,689,689,693,17,16,15,16,1,2,1,3,75,0,-4,1,1,-1
365,360,365,365,20,19,20,21,1,2,1,1,5,-5,0,1,-1,-1
970,965,970,965,20,19,20,21,3,1,1,2,5,-5,5,1,-1,-1
960,956,951,951,17,16,15,16,3,1,2,1,4,5,0,1,1,-1
853,848,848,848,18,19,18,18,3,3,1,3,5,0,0,-1,1,0
965,960,956,951,20,19,20,21,1,1,1,1,5,4,5,1,-1,-1
426,426,412,412,17,16,18,16,1,1,1,1,0,14,0,1,-2,2
857,862,857,862,18,17,18,18,2,3,1,1,-5,5,-5,1,-1,0
1054,1050,1050,1050,17,16,15,16,3,1,3,1,4,0,0,1,1,-1
239,234,229,229,14,14,15,13,2,2,1,3,5,5,0,0,-1,2
360,346,351,351,17,16,15,16,1,4,1,1,14,-5,0,1,1,-1
239,229,229,229,14,17,15,16,3,1,1,1,10,0,0,-3,2,-1
1054,1050,1050,1050,20,19,20,18,1,2,1,2,4,0,0,1,-1,2
642,632,623,628,13,16,15,16,3,1,2,1,10,9,-5,-3,1,-1
618,609,614,614,18,19,18,19,2,2,1,1,9,-5,0,-1,1,-1
721,717,717,721,20,19,20,21,1,1,2,3,4,0,-4,1,-1,-1
1068,1059,1054,1059,13,14,12,13,1,2,1,3,9,5,-5,-1,2,-1
1050,1050,1045,1040,17,16,15,16,3,1,1,2,0,5,5,1,1,-1
1007,1007,1007,1003,13,14,12,13,3,2,2,2,0,0,4,-1,2,-1
890,886,881,881,14,14,13,13,2,2,1,2,4,5,0,0,1,0
510,496,496,501,18,17,18,19,2,2,3,2,14,0,-5,1,-1,-1
857,853,853,853,21,19,20,21,3,2,1,3,4,0,0,2,-1,-1
576,571,567,567,14,14,15,13,1,3,3,1,5,4,0,0,-1,2
764,759,754,754,17,16,18,16,2,1,1,2,5,5,0,1,-2,2
478,468,473,473,13,14,12,13,1,2,2,3,10,-5,0,-1,2,-1
932,923,928,923,17,17,18,19,1,2,1,3,9,-5,5,0,-1,-1
239,234,234,234,21,19,20,21,2,2,1,3,5,0,0,2,-1,-1
960,951,956,960,20,19,20,18,1,2,1,1,9,-5,-4,1,-1,2
309,304,300,304,18,19,18,19,1,3,2,1,5,4,-4,-1,1,-1
417,407,412,412,20,19,20,18,2,2,1,1,10,-5,0,1,-1,2
426,421,426,421,17,16,15,16,1,2,4,1,5,-5,5,1,1,-1
656,651,651,646,17,19,18,18,2,1,2,1,5,0,5,-2,1,0
618,614,618,614,14,14,15,13,2,2,1,1,4,-4,4,0,-1,2
501,492,487,487,18,19,18,19,3,2,1,1,9,5,0,-1,1,-1
239,239,243,239,18,19,20,18,3,1,1,1,0,-4,4,-1,-1,2
243,234,234,239,14,14,15,13,1,2,3,1,9,0,-5,0,-1,2
895,900,890,886,18,17,18,16,2,3,2,2,-5,10,4,1,-1,2
304,304,300,304,21,19,20,21,2,3,3,2,0,4,-4,2,-1,-1
628,623,618,623,21,19,21,21,1,1,1,1,5,5,-5,2,-2,0
304,304,300,300,18,17,18,19,3,1,1,1,0,4,0,1,-1,-1
543,539,539,539,18,17,18,16,1,1,1,1,4,0,0,1,-1,2
876,862,862,867,14,17,15,16,1,2,1,1,14,0,-5,-3,2,-1
229,215,215,215,14,14,13,13,2,3,3,2,14,0,0,0,1,0
1017,1017,1012,1012,20,19,20,18,1,1,1,1,0,5,0,1,-1,2
923,923,923,918,18,17,18,19,2,1,3,1,0,0,5,1,-1,-1
286,281,281,276,14,14,15,16,3,1,2,2,5,0,5,0,-1,-1
1064,1059,1064,1059,13,16,15,16,3,1,2,1,5,-5,5,-3,1,-1
286,281,281,276,14,14,15,13,1,2,1,2,5,0,5,0,-1,2
857,853,857,853,14,14,15,13,3,3,2,3,4,-4,4,0,-1,2
562,557,562,553,18,19,18,18,1,1,2,2,5,-5,9,-1,1,0
1068,1064,1064,1054,17,19,18,18,3,1,4,3,4,0,10,-2,1,0
234,229,234,229,18,19,18,19,2,2,2,2,5,-5,5,-1,1,-1
871,867,857,853,18,17,18,16,2,1,4,2,4,10,4,1,-1,2
501,501,515,501,18,17,18,16,2,1,1,2,0,-14,14,1,-1,2
576,571,571,571,18,19,18,18,1,1,1,1,5,0,0,-1,1,0
459,454,459,454,20,19,20,21,1,1,1,3,5,-5,5,1,-1,-1
196,182,187,253,14,14,15,13,1,2,2,1,14,-5,-66,0,-1,2
295,286,290,290,18,17,18,16,1,2,1,1,9,-4,0,1,-1,2
403,393,393,393,17,16,18,18,2,1,2,1,10,0,0,1,-2,0
281,271,267,267,14,17,15,16,3,3,1,1,10,4,0,-3,2,-1
890,886,886,881,21,19,20,21,2,1,2,3,4,0,5,2,-1,-1
684,679,679,674,17,16,15,16,1,1,2,2,5,0,5,1,1,-1
548,534,543,539,14,14,15,13,3,3,4,3,14,-9,4,0,-1,2
707,703,703,707,20,19,18,18,3,2,1,1,4,0,-4,1,1,0
393,393,398,398,13,16,15,16,2,4,2,1,0,-5,0,-3,1,-1
979,970,974,970,17,16,18,16,1,1,2,2,9,-4,4,1,-2,2
234,215,210,206,14,14,13,13,1,3,2,2,19,5,4,0,1,0
1068,1064,1068,1059,17,16,15,16,3,2,3,2,4,-4,9,1,1,-1
806,810,806,806,21,19,20,21,2,1,1,1,-4,4,0,2,-1,-1
656,646,651,642,13,14,15,16,2,3,2,3,10,-5,9,-1,-1,-1
623,614,614,609,14,17,15,16,2,2,1,1,9,0,5,-3,2,-1
314,304,300,295,14,14,15,13,3,3,1,2,10,4,5,0,-1,2
1012,1007,1007,1007,20,19,20,21,2,2,1,3,5,0,0,1,-1,-1
942,932,932,932,20,19,20,21,1,2,1,1,10,0,0,1,-1,-1
286,281,281,276,18,17,18,16,2,1,1,1,5,0,5,1,-1,2
318,314,314,314,18,17,18,19,1,2,1,3,4,0,0,1,-1,-1
337,323,314,314,13,14,15,13,2,3,1,1,14,9,0,-1,-1,2
248,239,239,234,18,19,18,18,1,2,1,1,9,0,5,-1,1,0
271,271,267,267,14,14,13,13,2,3,1,2,0,4,0,0,1,0
220,210,210,210,18,19,18,19,2,2,3,3,10,0,0,-1,1,-1
1045,1045,1040,1040,20,19,18,18,2,1,2,2,0,5,0,1,1,0
374,370,365,365,13,14,12,13,3,1,1,1,4,5,0,-1,2,-1
576,567,571,567,21,19,20,18,1,2,2,2,9,-4,4,2,-1,2
698,693,693,693,13,14,15,13,3,2,1,1,5,0,0,-1,-1,2
365,365,365,365,20,19,18,18,2,2,1,1,0,0,0,1,1,0
431,431,426,426,20,19,18,18,1,1,1,2,0,5,0,1,1,0
506,501,501,506,18,19,18,19,2,1,1,1,5,0,-5,-1,1,-1
229,229,229,229,14,14,13,13,1,5,2,3,0,0,0,0,1,0
829,824,824,824,14,14,13,13,3,2,1,1,5,0,0,0,1,0
323,323,323,314,21,19,21,21,1,2,3,2,0,0,9,2,-2,0
1012,1007,1007,1007,13,14,15,13,1,2,1,1,5,0,0,-1,-1,2
567,557,553,553,18,19,18,18,1,1,1,3,10,4,0,-1,1,0
989,979,979,984,17,16,18,16,2,2,3,1,10,0,-5,1,-2,2
829,824,824,824,18,17,18,19,1,2,1,1,5,0,0,1,-1,-1
614,609,609,609,14,14,13,13,1,1,2,1,5,0,0,0,1,0
984,984,979,979,13,14,12,13,1,3,3,3,0,5,0,-1,2,-1
881,876,871,871,14,17,15,16,1,1,1,2,5,5,0,-3,2,-1
679,679,679,674,17,16,18,18,1,1,2,1,0,0,5,1,-2,0
515,510,515,510,18,17,18,19,1,1,2,1,5,-5,5,1,-1,-1
426,421,426,417,13,16,15,16,1,2,2,2,5,-5,9,-3,1,-1
323,318,318,318,14,14,15,13,1,3,2,1,5,0,0,0,-1,2
590,581,562,576,18,17,18,18,1,1,2,1,9,19,-14,1,-1,0
201,192,201,196,14,17,15,16,3,2,2,1,9,-9,5,-3,2,-1
1050,1050,1045,1045,17,19,18,18,1,1,1,2,0,5,0,-2,1,0
492,473,478,482,14,14,15,13,3,2,1,1,19,-5,-4,0,-1,2
300,300,300,295,14,14,13,13,1,3,1,2,0,0,5,0,1,0
389,384,379,374,20,19,20,21,2,1,1,4,5,5,5,1,-1,-1
286,281,286,281,21,19,20,19,3,1,1,1,5,-5,5,2,-1,1
182,1073,1078,1073,14,14,13,13,1,2,1,2,-891,-5,5,0,1,0
754,750,750,750,20,19,18,18,3,2,1,2,4,0,0,1,1,0
436,436,436,436,20,19,20,21,1,4,3,1,0,0,0,1,-1,-1
539,539,534,539,14,14,13,13,2,1,1,1,0,5,-5,0,1,0
674,670,670,670,17,16,15,16,1,4,1,1,4,0,0,1,1,-1
384,374,365,360,20,19,20,21,4,1,1,2,10,9,5,1,-1,-1
829,815,810,806,14,14,15,13,3,2,2,1,14,5,4,0,-1,2
506,506,506,506,18,17,18,16,2,2,1,2,0,0,0,1,-1,2
379,365,360,360,17,16,18,16,2,3,1,1,14,5,0,1,-2,2
586,581,576,581,18,19,18,19,1,3,1,1,5,5,-5,-1,1,-1
220,220,220,220,18,19,18,19,2,1,2,1,0,0,0,-1,1,-1
1017,1007,1012,1007,13,16,15,16,3,1,2,1,10,-5,5,-3,1,-1
764,759,759,759,13,14,12,13,2,3,3,2,5,0,0,-1,2,-1
900,900,895,890,14,17,15,16,1,1,2,1,0,5,5,-3,2,-1
323,318,323,318,21,19,21,21,1,2,1,1,5,-5,5,2,-2,0
426,426,421,417,20,19,20,21,1,2,1,2,0,5,4,1,-1,-1
1050,1045,1050,1045,20,19,20,18,1,4,3,2,5,-5,5,1,-1,2
337,337,332,332,17,16,15,16,2,1,1,1,0,5,0,1,1,-1
328,318,314,309,21,19,21,21,1,3,2,1,10,4,5,2,-2,0
801,796,796,796,14,14,15,13,3,2,1,1,5,0,0,0,-1,2
1021,1012,1017,1017,17,16,15,16,3,2,1,4,9,-5,0,1,1,-1
314,304,309,304,14,14,15,13,2,2,2,3,10,-5,5,0,-1,2
557,557,557,557,14,17,15,16,2,3,1,1,0,0,0,-3,2,-1
595,595,600,590,18,17,18,16,3,3,2,1,0,-5,10,1,-1,2
403,389,379,370,13,14,12,13,2,3,2,2,14,10,9,-1,2,-1
670,660,665,660,13,14,15,13,2,2,2,3,10,-5,5,-1,-1,2
365,351,346,351,13,14,15,13,1,2,1,3,14,5,-5,-1,-1,2
886,886,886,886,21,19,20,21,2,2,2,3,0,0,0,2,-1,-1
946,946,951,946,17,19,18,18,4,1,1,2,0,-5,5,-2,1,0
824,824,824,829,21,19,20,19,4,1,1,1,0,0,-5,2,-1,1
614,600,600,604,18,17,15,16,1,1,1,2,14,0,-4,1,2,-1
736,736,731,726,20,19,20,21,2,1,1,2,0,5,5,1,-1,-1
1007,1003,1003,1003,13,14,15,13,3,1,2,2,4,0,0,-1,-1,2
1054,1050,1045,1045,17,16,18,16,1,1,1,1,4,5,0,1,-2,2
960,960,960,960,13,16,15,16,3,2,1,1,0,0,0,-3,1,-1
379,365,365,360,13,14,12,13,2,1,3,2,14,0,5,-1,2,-1
524,520,520,515,14,14,13,13,2,3,2,1,4,0,5,0,1,0
309,300,295,290,21,19,20,19,1,4,1,2,9,5,5,2,-1,1
482,478,473,468,14,14,15,13,2,1,1,4,4,5,5,0,-1,2
571,562,562,557,14,14,15,16,3,3,2,2,9,0,5,0,-1,-1
862,862,857,862,14,17,15,16,2,2,1,2,0,5,-5,-3,2,-1
989,989,984,984,13,16,15,16,1,1,2,1,0,5,0,-3,1,-1
215,215,206,206,14,17,15,16,1,3,1,1,0,9,0,-3,2,-1
965,951,951,951,20,19,18,18,2,3,1,1,14,0,0,1,1,0
895,886,890,886,18,17,18,16,3,3,2,2,9,-4,4,1,-1,2
248,248,243,243,21,19,20,18,2,1,1,1,0,5,0,2,-1,2
267,257,262,257,18,19,18,18,1,2,1,1,10,-5,5,-1,1,0
670,660,656,656,17,16,15,16,1,1,4,2,10,4,0,1,1,-1
674,674,918,670,13,14,10,13,1,2,1,1,0,-244,248,-1,4,-3
1068,1068,1068,1068,17,16,18,18,1,1,1,2,0,0,0,1,-2,0
876,871,867,862,14,14,13,13,5,3,3,1,5,4,5,0,1,0
515,515,520,515,14,17,15,16,2,3,2,1,0,-5,5,-3,2,-1
946,932,932,932,13,16,15,16,4,1,1,1,14,0,0,-3,1,-1
707,703,698,698,17,16,18,18,2,1,1,1,4,5,0,1,-2,0
656,642,646,642,13,14,15,16,2,2,3,2,14,-4,4,-1,-1,-1
426,426,426,421,17,16,15,16,4,1,2,2,0,0,5,1,1,-1
182,1064,1054,1054,14,14,12,13,2,1,1,1,-882,10,0,0,2,-1
496,496,492,492,21,19,21,21,2,1,1,2,0,4,0,2,-2,0
736,726,731,726,20,19,20,21,2,1,2,1,10,-5,5,1,-1,-1
900,890,886,881,18,19,18,19,1,2,2,1,10,4,5,-1,1,-1
450,450,445,445,13,14,15,13,1,1,1,2,0,5,0,-1,-1,2
1007,998,1003,1003,20,19,20,21,3,2,3,1,9,-5,0,1,-1,-1
276,271,271,271,21,19,20,18,1,3,1,3,5,0,0,2,-1,2
984,979,979,979,17,16,18,18,2,5,1,1,5,0,0,1,-2,0
951,984,946,946,13,14,12,13,2,1,3,1,-33,38,0,-1,2,-1
243,229,234,234,14,17,15,16,1,3,1,3,14,-5,0,-3,2,-1
487,473,478,473,18,16,18,18,3,2,1,1,14,-5,5,2,-2,0
468,468,468,464,13,14,15,13,2,3,2,3,0,0,4,-1,-1,2
806,801,801,801,21,19,21,21,2,2,1,1,5,0,0,2,-2,0
810,801,801,796,18,17,15,16,1,2,3,2,9,0,5,1,2,-1
590,590,586,586,18,17,18,16,2,2,1,3,0,4,0,1,-1,2
206,201,201,206,14,14,13,13,2,2,1,3,5,0,-5,0,1,0
210,201,201,196,14,14,13,13,3,4,5,2,9,0,5,0,1,0
974,965,970,970,20,19,20,21,3,3,2,1,9,-5,0,1,-1,-1
215,215,220,220,18,19,18,19,2,1,2,3,0,-5,0,-1,1,-1
993,984,984,984,20,19,20,18,2,2,2,1,9,0,0,1,-1,2
590,576,571,562,14,14,13,13,2,2,1,2,14,5,9,0,1,0
239,229,557,224,18,17,20,16,3,3,1,1,10,-328,333,1,-3,4
487,487,482,482,14,14,13,13,2,1,1,1,0,5,0,0,1,0
857,853,853,857,14,14,15,13,1,2,2,1,4,0,-4,0,-1,2
370,360,360,356,13,14,15,16,1,2,2,2,10,0,4,-1,-1,-1
937,923,928,923,17,17,18,19,2,2,1,2,14,-5,5,0,-1,-1
398,389,393,393,17,16,15,16,2,2,1,1,9,-4,0,1,1,-1
539,534,529,529,18,17,18,16,3,1,1,1,5,5,0,1,-1,2
792,782,782,782,14,14,15,16,3,2,1,1,10,0,0,0,-1,-1
187,187,1078,1078,18,17,18,18,1,1,1,1,0,-891,0,1,-1,0
1017,1007,1012,1007,13,16,15,16,2,2,2,2,10,-5,5,-3,1,-1
1064,1059,1059,1054,13,14,12,13,1,3,1,2,5,0,5,-1,2,-1
834,824,829,820,14,14,13,13,1,1,3,2,10,-5,9,0,1,0
824,810,801,801,14,14,15,16,3,1,3,2,14,9,0,0,-1,-1
1068,1064,1064,1059,20,19,20,18,1,2,1,2,4,0,5,1,-1,2
871,871,871,867,14,14,13,13,1,2,2,1,0,0,4,0,1,0
286,271,271,271,18,19,18,18,3,2,1,1,15,0,0,-1,1,0
960,956,956,951,13,14,15,13,3,2,3,2,4,0,5,-1,-1,2
646,637,637,637,17,16,18,16,1,1,2,1,9,0,0,1,-2,2
379,374,374,370,20,19,20,21,3,2,1,2,5,0,4,1,-1,-1
248,248,239,239,18,19,18,18,2,3,1,2,0,9,0,-1,1,0
286,286,286,281,21,19,20,21,1,4,2,2,0,0,5,2,-1,-1
300,300,300,304,18,17,18,16,1,2,1,1,0,0,-4,1,-1,2
923,918,918,909,18,19,18,19,2,1,4,1,5,0,9,-1,1,-1
262,257,248,248,14,17,15,16,1,1,3,1,5,9,0,-3,2,-1
187,1073,1078,1073,14,14,15,16,2,2,1,2,-886,-5,5,0,-1,-1
543,553,553,548,14,17,15,16,2,3,2,1,-10,0,5,-3,2,-1
464,454,454,454,20,19,20,18,2,1,4,1,10,0,0,1,-1,2
351,342,342,351,13,14,15,16,2,2,1,1,9,0,-9,-1,-1,-1
1078,1073,1073,1073,20,19,20,18,2,1,1,1,5,0,0,1,-1,2
871,867,867,867,14,14,15,13,3,2,1,2,4,0,0,0,-1,2
436,426,417,412,13,14,15,13,4,1,1,2,10,9,5,-1,-1,2
989,984,984,979,20,19,20,21,1,1,1,1,5,0,5,1,-1,-1
337,332,337,332,17,16,15,16,3,2,2,1,5,-5,5,1,1,-1
440,436,436,436,17,19,18,18,1,4,2,3,4,0,0,-2,1,0
637,642,623,623,13,14,13,13,1,1,2,1,-5,19,0,-1,1,0
492,487,482,482,14,14,15,13,3,3,1,1,5,5,0,0,-1,2
674,670,665,665,17,16,18,18,1,2,1,2,4,5,0,1,-2,0
201,196,201,192,14,14,13,13,2,1,2,1,5,-5,9,0,1,0
595,595,595,590,18,19,18,19,3,1,1,2,0,0,5,-1,1,-1
492,492,492,492,14,14,15,13,2,2,3,3,0,0,0,0,-1,2
914,909,909,909,21,19,21,19,2,1,2,1,5,0,0,2,-2,2
782,773,768,768,14,14,12,13,1,1,2,1,9,5,0,0,2,-1
740,731,740,904,13,14,12,11,4,4,1,1,9,-9,-164,-1,2,1
1017,1012,1017,1012,13,14,15,13,1,1,1,2,5,-5,5,-1,-1,2
576,567,567,567,21,19,20,21,1,2,1,2,9,0,0,2,-1,-1
393,393,623,389,13,14,13,16,4,3,1,2,0,-230,234,-1,1,-3
393,389,389,389,20,19,20,18,1,3,2,1,4,0,0,1,-1,2
740,740,740,736,20,19,20,21,1,2,1,2,0,0,4,1,-1,-1
923,918,923,918,18,19,18,19,2,2,2,2,5,-5,5,-1,1,-1
562,548,548,553,14,14,15,13,3,3,2,1,14,0,-5,0,-1,2
370,365,370,365,17,16,15,16,1,2,1,2,5,-5,5,1,1,-1
750,745,745,740,13,14,15,13,2,3,2,1,5,0,5,-1,-1,2
895,886,881,876,18,19,18,18,1,2,3,2,9,5,5,-1,1,0
717,717,717,721,20,19,20,21,1,3,1,1,0,0,-4,1,-1,-1
745,736,736,736,20,19,20,21,2,2,1,2,9,0,0,1,-1,-1
234,229,229,224,14,14,13,13,2,1,2,2,5,0,5,0,1,0
970,970,974,970,13,14,12,13,3,3,4,1,0,-4,4,-1,2,-1
1078,1073,1073,1073,13,14,12,13,1,3,1,2,5,0,0,-1,2,-1
239,239,239,239,14,14,13,13,1,3,2,3,0,0,0,0,1,0
450,445,450,450,20,19,20,21,2,2,1,1,5,-5,0,1,-1,-1
656,646,642,642,13,14,15,13,4,4,3,2,10,4,0,-1,-1,2
281,271,276,276,21,19,20,21,2,2,2,1,10,-5,0,2,-1,-1
239,229,229,229,21,19,20,21,1,2,1,1,10,0,0,2,-1,-1
754,750,750,750,20,19,20,21,3,1,1,1,4,0,0,1,-1,-1
881,867,862,862,14,17,15,16,1,1,2,1,14,5,0,-3,2,-1
239,224,224,224,14,14,13,13,3,3,2,2,15,0,0,0,1,0
187,187,182,182,14,14,15,13,2,3,1,1,0,5,0,0,-1,2
267,253,257,257,18,17,18,16,6,2,1,1,14,-4,0,1,-1,2
623,618,618,618,18,17,18,19,2,2,1,2,5,0,0,1,-1,-1
473,473,473,473,17,16,18,18,1,1,1,1,0,0,0,1,-2,0
417,407,398,393,13,14,12,13,3,3,1,1,10,9,5,-1,2,-1
745,740,736,736,13,14,12,13,2,2,2,1,5,4,0,-1,2,-1
970,965,965,960,13,14,12,13,2,2,1,2,5,0,5,-1,2,-1
843,839,834,829,14,14,13,13,1,3,3,2,4,5,5,0,1,0
436,426,426,426,17,16,18,16,1,3,2,1,10,0,0,1,-2,2
736,731,736,736,17,16,18,16,1,2,1,1,5,-5,0,1,-2,2
956,951,951,951,17,16,15,16,1,1,1,1,5,0,0,1,1,-1
417,421,421,417,13,14,12,13,1,1,2,2,-4,0,4,-1,2,-1
356,356,356,351,20,19,20,21,1,3,2,1,0,0,5,1,-1,-1
346,346,342,337,20,19,20,18,2,1,2,1,0,4,5,1,-1,2
731,736,726,726,20,19,20,21,1,3,1,2,-5,10,0,1,-1,-1
543,534,539,534,18,19,18,18,3,2,2,1,9,-5,5,-1,1,0
365,360,403,356,20,19,20,21,2,1,1,1,5,-43,47,1,-1,-1
796,792,792,792,21,19,21,21,3,1,1,3,4,0,0,2,-2,0
1012,1012,1012,1012,13,16,15,16,1,2,1,1,0,0,0,-3,1,-1
886,876,871,871,14,14,13,13,2,3,2,3,10,5,0,0,1,0
684,679,679,674,13,14,15,13,1,2,2,1,5,0,5,-1,-1,2
332,337,337,332,17,16,18,18,1,2,2,1,-5,0,5,1,-2,0
210,206,206,206,14,14,13,13,2,2,2,1,4,0,0,0,1,0
365,360,356,360,13,14,12,13,2,2,1,3,5,4,-4,-1,2,-1
614,604,604,600,18,17,18,19,1,2,1,2,10,0,4,1,-1,-1
271,267,262,257,14,17,15,16,2,2,2,1,4,5,5,-3,2,-1
970,970,965,965,20,19,20,21,5,1,1,2,0,5,0,1,-1,-1
510,510,515,510,14,14,13,13,2,2,3,2,0,-5,5,0,1,0
253,248,253,248,14,17,15,16,4,2,2,3,5,-5,5,-3,2,-1
586,576,567,567,14,14,13,13,3,2,3,1,10,9,0,0,1,0
379,374,384,379,13,14,12,13,3,2,1,3,5,-10,5,-1,2,-1
576,581,581,581,18,17,18,16,1,1,1,3,-5,0,0,1,-1,2
768,764,764,764,20,19,18,18,1,3,1,1,4,0,0,1,1,0
234,229,224,224,21,19,20,21,2,1,1,1,5,5,0,2,-1,-1
267,262,271,271,21,19,20,18,1,1,2,1,5,-9,0,2,-1,2
693,689,684,679,13,14,15,13,2,3,2,2,4,5,5,-1,-1,2
468,468,459,464,17,16,15,16,2,1,3,1,0,9,-5,1,1,-1
1073,1064,1068,1064,17,16,18,18,2,2,2,2,9,-4,4,1,-2,0
787,773,773,773,14,16,15,16,2,3,3,2,14,0,0,-2,1,-1
571,567,557,553,14,14,15,13,1,5,2,1,4,10,4,0,-1,2
895,895,890,890,21,19,20,19,2,2,1,1,0,5,0,2,-1,1
745,740,745,745,20,19,18,18,2,3,2,2,5,-5,0,1,1,0
951,942,932,942,17,16,23,16,2,2,1,1,9,10,-10,1,-7,7
787,773,778,778,14,14,13,13,2,3,2,1,14,-5,0,0,1,0
220,215,210,210,21,19,20,21,1,1,1,1,5,5,0,2,-1,-1
731,726,721,721,13,14,12,13,2,3,1,1,5,5,0,-1,2,-1
239,239,239,239,18,19,18,18,1,2,2,1,0,0,0,-1,1,0
586,571,567,571,14,17,15,16,1,3,1,1,15,4,-4,-3,2,-1
942,937,937,932,13,14,15,13,1,2,3,1,5,0,5,-1,-1,2
768,764,764,754,20,19,20,21,2,3,2,2,4,0,10,1,-1,-1
928,374,928,918,14,16,15,16,1,1,2,1,554,-554,10,-2,1,-1
192,187,182,182,14,14,13,13,3,1,1,1,5,5,0,0,1,0
346,346,346,342,17,16,18,16,3,2,1,1,0,0,4,1,-2,2
323,314,314,318,18,19,18,19,3,2,1,4,9,0,-4,-1,1,-1
796,787,787,782,14,14,15,13,1,1,3,2,9,0,5,0,-1,2
1017,1021,1021,1017,13,16,15,16,2,3,3,2,-4,0,4,-3,1,-1
300,295,300,295,14,17,15,16,2,4,1,3,5,-5,5,-3,2,-1
1003,1003,1007,1003,13,14,15,13,3,2,1,1,0,-4,4,-1,-1,2
520,515,515,510,14,17,15,16,2,2,1,2,5,0,5,-3,2,-1
1026,286,1003,993,13,14,12,13,2,1,2,1,740,-717,10,-1,2,-1
239,239,239,234,14,17,15,16,1,2,2,1,0,0,5,-3,2,-1
689,679,684,689,13,14,12,13,1,2,3,3,10,-5,-5,-1,2,-1
290,290,290,290,14,14,15,13,3,3,2,3,0,0,0,0,-1,2
234,234,234,229,18,17,18,16,2,1,2,1,0,0,5,1,-1,2
1073,1073,1073,1068,13,14,15,13,1,2,2,2,0,0,5,-1,-1,2
942,937,932,928,20,19,18,19,2,3,1,1,5,5,4,1,1,-1
1054,1045,1045,1040,13,14,12,13,3,3,3,2,9,0,5,-1,2,-1
328,328,323,323,18,19,18,19,1,1,1,1,0,5,0,-1,1,-1
323,314,314,309,14,14,13,13,2,3,1,1,9,0,5,0,1,0
318,309,314,318,18,17,18,19,2,2,1,1,9,-5,-4,1,-1,-1
904,904,904,900,18,19,18,19,1,3,2,2,0,0,4,-1,1,-1
412,379,379,379,13,14,15,16,1,3,2,1,33,0,0,-1,-1,-1
754,754,750,745,17,16,15,16,1,3,1,2,0,4,5,1,1,-1
342,323,318,323,13,14,15,13,2,2,3,1,19,5,-5,-1,-1,2
768,764,764,759,13,14,15,13,1,2,2,1,4,0,5,-1,-1,2
1073,1073,1068,1064,13,14,15,13,2,1,2,1,0,5,4,-1,-1,2
318,309,309,309,14,14,13,13,1,3,1,1,9,0,0,0,1,0
773,764,754,750,20,19,18,18,2,1,1,1,9,10,4,1,1,0
660,656,656,651,20,19,20,21,3,3,1,3,4,0,5,1,-1,-1
890,881,876,876,14,14,13,13,1,3,3,3,9,5,0,0,1,0
590,581,581,581,18,19,18,19,3,3,2,1,9,0,0,-1,1,-1
187,187,187,187,14,17,15,16,2,3,1,1,0,0,0,-3,2,-1
248,234,229,229,14,14,13,13,3,2,1,1,14,5,0,0,1,0
684,674,670,670,13,14,12,13,2,3,1,1,10,4,0,-1,2,-1
918,923,918,918,14,14,15,13,2,3,1,2,-5,5,0,0,-1,2
210,201,196,196,14,17,15,16,1,3,1,1,9,5,0,-3,2,-1
276,271,267,257,14,14,15,16,1,1,2,2,5,4,10,0,-1,-1
946,942,946,942,20,19,20,21,3,1,5,2,4,-4,4,1,-1,-1
782,778,773,778,14,16,15,16,2,1,1,1,4,5,-5,-2,1,-1
346,337,337,342,17,16,18,16,2,2,2,1,9,0,-5,1,-2,2
614,604,609,604,21,19,21,19,1,1,1,1,10,-5,5,2,-2,2
215,215,215,220,14,17,15,16,1,3,2,1,0,0,-5,-3,2,-1
286,276,281,281,18,19,18,19,3,2,3,1,10,-5,0,-1,1,-1
210,192,192,187,14,14,15,13,5,2,1,1,18,0,5,0,-1,2
867,857,862,857,21,19,20,21,1,1,1,1,10,-5,5,2,-1,-1
510,506,506,501,18,19,18,19,1,3,3,2,4,0,5,-1,1,-1
750,745,745,750,20,19,18,18,2,2,1,1,5,0,-5,1,1,0
726,721,721,721,13,14,15,13,1,3,2,1,5,0,0,-1,-1,2
768,759,764,759,13,14,12,13,1,2,3,2,9,-5,5,-1,2,-1
900,890,900,895,14,17,15,16,3,2,2,1,10,-10,5,-3,2,-1
721,712,712,717,13,14,15,13,2,4,3,1,9,0,-5,-1,-1,2
853,853,853,857,21,19,20,18,2,2,3,1,0,0,-4,2,-1,2
843,843,843,843,18,19,18,18,2,2,1,1,0,0,0,-1,1,0
454,445,445,440,17,19,18,18,2,1,2,1,9,0,5,-2,1,0
271,262,262,262,18,17,18,16,3,2,3,1,9,0,0,1,-1,2
276,262,253,248,18,17,18,16,3,3,1,2,14,9,5,1,-1,2
740,740,736,731,20,19,20,18,2,1,3,2,0,4,5,1,-1,2
787,768,773,768,14,14,12,13,1,2,2,1,19,-5,5,0,2,-1
881,867,867,867,18,17,18,18,1,2,2,1,14,0,0,1,-1,0
468,459,464,459,20,19,20,18,2,1,1,2,9,-5,5,1,-1,2
806,801,801,796,18,17,18,19,1,2,2,1,5,0,5,1,-1,-1
773,773,773,773,13,16,15,16,1,3,1,1,0,0,0,-3,1,-1
1036,1036,1031,1031,13,14,12,13,3,3,1,1,0,5,0,-1,2,-1
1050,1045,1045,1040,17,19,18,18,3,1,2,2,5,0,5,-2,1,0
187,182,182,182,14,14,13,13,2,1,1,1,5,0,0,0,1,0
745,740,740,740,20,19,20,21,3,1,1,1,5,0,0,1,-1,-1
974,970,970,965,20,19,20,21,2,1,1,1,4,0,5,1,-1,-1
712,712,717,707,13,14,15,13,3,3,2,2,0,-5,10,-1,-1,2
529,520,524,515,18,17,18,16,3,1,2,2,9,-4,9,1,-1,2
229,229,224,224,18,17,18,19,1,3,1,1,0,5,0,1,-1,-1
501,492,501,501,14,14,15,13,2,2,1,2,9,-9,0,0,-1,2
909,904,909,904,18,17,18,16,3,2,2,4,5,-5,5,1,-1,2
848,843,848,848,21,19,20,21,1,2,1,1,5,-5,0,2,-1,-1
267,262,262,257,14,14,13,13,2,3,1,1,5,0,5,0,1,0
286,286,286,286,18,19,18,19,2,2,1,3,0,0,0,-1,1,-1
731,703,698,698,17,16,15,16,2,3,1,1,28,5,0,1,1,-1
492,492,487,487,14,14,15,13,1,1,2,1,0,5,0,0,-1,2
1064,1059,1054,1050,20,19,18,18,1,2,2,1,5,5,4,1,1,0
642,637,642,642,17,16,18,18,5,2,2,1,5,-5,0,1,-2,0
918,914,909,904,21,19,21,19,2,1,2,2,4,5,5,2,-2,2
1064,1059,436,1054,17,16,20,16,2,2,1,1,5,623,-618,1,-4,4
998,993,993,993,13,14,12,13,1,3,2,1,5,0,0,-1,2,-1
365,365,370,365,20,19,20,21,2,1,2,3,0,-5,5,1,-1,-1
970,970,965,970,20,19,20,21,1,1,3,1,0,5,-5,1,-1,-1
726,721,717,717,17,16,18,18,2,2,1,1,5,4,0,1,-2,0
862,862,862,862,18,19,18,18,4,2,1,1,0,0,0,-1,1,0
567,557,553,553,18,17,18,16,3,1,1,1,10,4,0,1,-1,2
965,960,965,960,17,16,15,16,1,1,2,2,5,-5,5,1,1,-1
356,346,346,351,13,14,15,13,1,4,2,2,10,0,-5,-1,-1,2
914,909,904,900,21,19,20,19,1,1,1,2,5,5,4,2,-1,1
806,806,801,801,21,19,21,21,2,3,1,2,0,5,0,2,-2,0
876,867,867,867,14,17,15,16,2,2,1,2,9,0,0,-3,2,-1
318,314,309,309,14,14,15,13,2,1,3,2,4,5,0,0,-1,2
436,431,426,426,17,16,18,18,2,1,1,2,5,5,0,1,-2,0
956,956,951,951,17,16,18,18,1,3,2,1,0,5,0,1,-2,0
768,768,764,759,17,16,18,16,2,1,1,2,0,4,5,1,-2,2
267,262,267,267,21,19,20,21,1,2,1,1,5,-5,0,2,-1,-1
210,206,201,201,18,17,18,19,2,4,1,3,4,5,0,1,-1,-1
389,379,379,384,13,14,15,13,2,2,1,1,10,0,-5,-1,-1,2
412,403,412,407,17,16,18,18,3,2,1,2,9,-9,5,1,-2,0
731,726,726,717,13,14,15,13,3,3,2,1,5,0,9,-1,-1,2
979,970,970,965,13,14,15,13,2,4,2,2,9,0,5,-1,-1,2
562,553,548,548,21,19,20,21,1,1,3,1,9,5,0,2,-1,-1
220,215,215,210,18,19,18,19,2,3,3,2,5,0,5,-1,1,-1
904,900,895,895,18,17,18,16,2,3,1,1,4,5,0,1,-1,2
923,923,923,923,14,14,15,13,1,3,2,1,0,0,0,0,-1,2
356,351,356,356,13,14,15,13,1,2,2,1,5,-5,0,-1,-1,2
323,323,318,318,21,19,21,21,2,2,2,1,0,5,0,2,-2,0
346,342,351,342,17,16,15,16,1,2,3,2,4,-9,9,1,1,-1
1036,1031,1012,1007,13,14,12,13,5,1,2,2,5,19,5,-1,2,-1
206,206,206,201,14,14,15,13,1,2,2,1,0,0,5,0,-1,2
1031,1031,1031,1026,17,16,18,18,2,1,2,1,0,0,5,1,-2,0
604,581,571,567,14,14,15,13,2,2,1,1,23,10,4,0,-1,2
571,553,553,562,14,14,13,13,2,1,2,3,18,0,-9,0,1,0
998,993,993,998,13,14,15,13,2,3,1,2,5,0,-5,-1,-1,2
271,262,267,267,14,17,15,16,6,4,1,3,9,-5,0,-3,2,-1
618,614,614,614,14,14,13,13,3,6,3,3,4,0,0,0,1,0
895,886,886,886,14,14,13,13,3,2,2,1,9,0,0,0,1,0
548,543,543,543,14,17,15,16,3,2,2,2,5,0,0,-3,2,-1
459,450,454,454,17,16,15,16,2,1,1,1,9,-4,0,1,1,-1
703,698,698,693,13,14,12,13,2,3,2,3,5,0,5,-1,2,-1
342,342,342,342,20,19,20,21,1,1,3,1,0,0,0,1,-1,-1
421,417,417,407,13,14,15,13,1,2,2,2,4,0,10,-1,-1,2
374,370,370,365,13,16,15,16,2,1,2,2,4,0,5,-3,1,-1
510,506,506,506,14,14,13,13,3,1,2,3,4,0,0,0,1,0
623,628,623,623,14,14,15,13,2,1,1,1,-5,5,0,0,-1,2
979,974,974,974,13,14,15,13,1,1,3,1,5,0,0,-1,-1,2
229,224,224,220,21,19,20,21,1,1,2,2,5,0,4,2,-1,-1
482,482,482,482,18,17,15,16,2,1,1,2,0,0,0,1,2,-1
548,543,548,543,21,19,20,21,3,2,2,2,5,-5,5,2,-1,-1
937,937,928,918,13,14,13,13,3,1,1,3,0,9,10,-1,1,0
187,187,187,192,21,19,21,19,2,1,1,1,0,0,-5,2,-2,2
810,801,806,801,14,14,13,13,3,2,2,2,9,-5,5,0,1,0
717,712,712,712,13,14,12,13,2,1,2,1,5,0,0,-1,2,-1
342,337,337,332,13,14,15,16,4,1,1,1,5,0,5,-1,-1,-1
510,506,506,510,14,17,15,16,1,2,2,3,4,0,-4,-3,2,-1
646,651,651,646,13,14,15,13,5,5,3,1,-5,0,5,-1,-1,2
914,914,956,909,21,19,18,19,3,1,1,2,0,-42,47,2,1,-1
848,839,834,834,14,14,15,13,2,2,1,3,9,5,0,0,-1,2
806,801,806,806,21,19,20,21,2,2,1,1,5,-5,0,2,-1,-1
1073,1068,1073,1068,13,14,12,13,1,4,1,2,5,-5,5,-1,2,-1
524,510,506,604,18,19,18,13,3,2,2,1,14,4,-98,-1,1,5
834,824,815,820,18,17,18,16,2,1,1,3,10,9,-5,1,-1,2
220,224,224,215,14,14,13,13,2,1,1,2,-4,0,9,0,1,0
459,459,459,464,17,16,15,16,3,2,2,1,0,0,-5,1,1,-1
487,473,478,473,14,14,13,13,1,2,1,2,14,-5,5,0,1,0
618,623,623,614,18,19,18,19,3,1,2,2,-5,0,9,-1,1,-1
857,848,853,848,14,17,15,16,3,2,2,1,9,-5,5,-3,2,-1
628,623,628,618,14,17,15,16,1,1,2,2,5,-5,10,-3,2,-1
768,764,754,754,17,16,18,18,2,1,3,1,4,10,0,1,-2,0
731,712,712,712,13,14,15,16,4,2,1,1,19,0,0,-1,-1,-1
759,754,750,750,17,16,18,16,3,2,1,1,5,4,0,1,-2,2
895,895,895,890,14,17,15,16,2,2,3,1,0,0,5,-3,2,-1
576,571,571,571,21,19,20,18,1,2,1,1,5,0,0,2,-1,2
243,239,234,234,14,14,15,13,1,3,1,2,4,5,0,0,-1,2
187,187,187,187,14,14,15,16,2,4,3,3,0,0,0,0,-1,-1
342,337,337,337,20,19,20,21,1,1,1,1,5,0,0,1,-1,-1
586,590,586,590,14,17,15,16,2,1,7,1,-4,4,-4,-3,2,-1
721,717,717,721,13,16,15,16,4,3,1,3,4,0,-4,-3,1,-1
576,571,571,571,14,14,15,13,1,3,1,2,5,0,0,0,-1,2
267,248,262,271,14,14,13,13,1,1,2,1,19,-14,-9,0,1,0
417,421,417,417,13,14,15,13,1,1,2,3,-4,4,0,-1,-1,2
628,609,609,614,18,17,18,19,1,1,1,1,19,0,-5,1,-1,-1
581,576,567,567,14,14,15,13,1,2,2,2,5,9,0,0,-1,2
1068,1059,1054,1054,13,16,15,16,1,1,1,1,9,5,0,-3,1,-1
220,220,220,215,18,19,18,19,3,2,1,2,0,0,5,-1,1,-1
389,389,393,389,20,19,20,18,1,1,2,1,0,-4,4,1,-1,2
768,759,764,764,20,19,20,21,2,1,1,3,9,-5,0,1,-1,-1
290,290,286,290,18,19,18,19,1,1,3,1,0,4,-4,-1,1,-1
360,356,360,356,17,19,18,18,2,1,2,1,4,-4,4,-2,1,0
792,787,787,787,14,14,15,13,1,2,1,1,5,0,0,0,-1,2
745,736,736,740,17,16,15,16,2,6,1,1,9,0,-4,1,1,-1
393,389,384,389,20,19,20,18,1,1,1,1,4,5,-5,1,-1,2
286,271,337,271,14,14,15,13,3,2,1,2,15,-66,66,0,-1,2
539,539,539,534,21,19,20,21,3,2,2,3,0,0,5,2,-1,-1
1050,1040,1036,1031,20,19,20,18,2,2,1,3,10,4,5,1,-1,2
492,487,492,487,21,19,21,21,2,1,1,2,5,-5,5,2,-2,0
632,632,637,632,13,14,15,16,1,1,2,1,0,-5,5,-1,-1,-1
557,539,534,534,14,17,15,16,2,6,2,2,18,5,0,-3,2,-1
871,871,867,867,14,14,13,13,3,1,1,2,0,4,0,0,1,0
740,754,731,731,20,19,20,21,1,2,1,1,-14,23,0,1,-1,-1
431,417,412,407,17,19,18,18,2,3,2,1,14,5,5,-2,1,0
857,853,857,848,14,14,15,13,3,3,2,1,4,-4,9,0,-1,2
234,234,224,224,18,19,18,19,1,3,3,1,0,10,0,-1,1,-1
342,332,323,323,13,16,15,16,2,1,3,1,10,9,0,-3,1,-1
1059,1054,1054,1054,17,16,18,18,1,2,3,2,5,0,0,1,-2,0
487,473,473,478,18,19,18,18,1,2,1,1,14,0,-5,-1,1,0
450,445,445,450,20,19,18,18,3,5,1,1,5,0,-5,1,1,0
478,473,468,464,20,19,20,21,1,1,1,2,5,5,4,1,-1,-1
356,346,356,351,13,14,12,13,1,2,1,1,10,-10,5,-1,2,-1
487,487,487,482,14,14,15,13,4,3,2,1,0,0,5,0,-1,2
890,881,886,886,14,14,15,13,1,2,1,1,9,-5,0,0,-1,2
951,951,951,951,13,14,12,13,3,1,2,3,0,0,0,-1,2,-1
918,914,918,914,21,19,21,21,1,2,1,1,4,-4,4,2,-2,0
351,351,351,351,13,14,15,16,1,2,1,1,0,0,0,-1,-1,-1
871,857,862,862,14,17,15,16,1,1,2,1,14,-5,0,-3,2,-1
834,839,829,829,18,19,18,19,4,3,3,1,-5,10,0,-1,1,-1
524,520,520,520,18,17,18,16,1,3,1,2,4,0,0,1,-1,2
323,309,309,304,18,19,18,19,1,2,1,2,14,0,5,-1,1,-1
510,506,515,510,21,19,20,21,2,2,1,1,4,-9,5,2,-1,-1
318,300,290,281,14,17,15,16,3,2,2,2,18,10,9,-3,2,-1
337,332,332,337,17,19,18,18,3,2,1,1,5,0,-5,-2,1,0
974,974,970,970,17,16,15,16,3,2,1,3,0,4,0,1,1,-1
192,1073,1068,1068,18,16,18,18,1,1,2,1,-881,5,0,2,-2,0
515,510,510,506,18,19,18,19,2,3,4,1,5,0,4,-1,1,-1
754,750,750,750,20,19,20,18,1,2,1,1,4,0,0,1,-1,2
900,890,895,895,14,14,15,13,2,2,1,1,10,-5,0,0,-1,2
421,412,412,412,17,16,18,18,1,1,2,1,9,0,0,1,-2,0
215,210,210,206,18,17,18,16,2,3,2,1,5,0,4,1,-1,2
271,267,267,262,14,14,15,13,2,2,2,2,4,0,5,0,-1,2
604,600,600,595,14,17,15,16,1,2,3,2,4,0,5,-3,2,-1
890,857,857,857,14,17,15,16,3,3,1,1,33,0,0,-3,2,-1
286,271,271,281,14,14,15,13,1,1,2,3,15,0,-10,0,-1,2
328,323,314,304,14,14,13,13,1,3,2,2,5,9,10,0,1,0
436,426,426,426,13,16,15,16,2,1,1,2,10,0,0,-3,1,-1
900,895,900,895,21,19,20,19,2,2,2,1,5,-5,5,2,-1,1
346,342,342,342,13,16,15,16,1,1,2,2,4,0,0,-3,1,-1
234,220,220,215,14,14,13,13,3,1,1,1,14,0,5,0,1,0
778,768,768,764,20,19,18,18,2,1,2,2,10,0,4,1,1,0
450,454,450,445,13,14,12,13,2,1,1,3,-4,4,5,-1,2,-1
1068,1064,1064,1064,20,19,18,18,3,1,2,1,4,0,0,1,1,0
998,998,998,998,17,16,15,16,1,2,1,3,0,0,0,1,1,-1
304,295,295,290,18,17,18,16,1,3,2,2,9,0,5,1,-1,2
679,679,726,670,20,19,18,18,1,3,1,1,0,-47,56,1,1,0
267,262,262,262,21,19,20,18,3,1,1,2,5,0,0,2,-1,2
215,196,192,182,14,14,15,16,2,1,2,2,19,4,10,0,-1,-1
600,604,600,604,21,19,20,19,2,3,1,1,-4,4,-4,2,-1,1
440,431,431,431,13,14,12,13,2,3,2,1,9,0,0,-1,2,-1
942,937,923,928,17,16,15,16,3,1,1,1,5,14,-5,1,1,-1
974,970,970,965,13,14,12,13,1,1,1,1,4,0,5,-1,2,-1
210,206,206,206,21,19,20,21,1,1,1,1,4,0,0,2,-1,-1
412,407,403,403,13,14,12,13,1,5,1,1,5,4,0,-1,2,-1
520,515,515,520,14,14,13,13,2,2,3,1,5,0,-5,0,1,0
721,721,721,717,13,14,12,13,2,2,4,3,0,0,4,-1,2,-1
642,628,628,628,20,19,18,19,2,1,1,1,14,0,0,1,1,-1
356,356,351,351,13,14,12,13,1,1,2,1,0,5,0,-1,2,-1
248,243,243,239,14,17,15,16,3,3,1,1,5,0,4,-3,2,-1
459,445,445,445,13,14,12,13,1,2,1,1,14,0,0,-1,2,-1
576,576,576,576,14,17,15,16,2,3,2,1,0,0,0,-3,2,-1
314,314,304,318,14,14,13,13,1,3,1,1,0,10,-14,0,1,0
1026,1026,1026,1026,17,16,18,18,1,2,2,1,0,0,0,1,-2,0
637,623,628,628,20,19,18,19,2,2,1,1,14,-5,0,1,1,-1
487,478,478,482,14,14,13,13,1,1,1,1,9,0,-4,0,1,0
581,576,581,576,14,14,15,13,4,2,2,3,5,-5,5,0,-1,2
768,759,764,759,13,14,12,13,2,2,2,3,9,-5,5,-1,2,-1
182,182,1078,1078,18,19,18,18,1,1,1,1,0,-896,0,-1,1,0
318,323,309,309,14,14,13,13,1,1,2,2,-5,14,0,0,1,0
674,670,674,670,20,19,20,18,1,1,1,2,4,-4,4,1,-1,2
323,314,318,314,14,17,15,16,3,2,2,1,9,-4,4,-3,2,-1
1064,1050,1054,1050,17,16,15,16,2,2,1,1,14,-4,4,1,1,-1
487,482,478,478,14,17,15,16,2,1,1,1,5,4,0,-3,2,-1
942,942,942,937,13,14,12,13,1,2,2,2,0,0,5,-1,2,-1
436,426,431,426,13,14,12,13,1,2,2,1,10,-5,5,-1,2,-1
182,1073,1073,1068,21,19,20,21,1,1,3,1,-891,0,5,2,-1,-1
346,323,323,323,17,17,18,19,2,1,2,3,23,0,0,0,-1,-1
398,379,384,389,20,19,20,18,4,2,1,2,19,-5,-5,1,-1,2
468,464,464,464,17,16,18,16,1,1,1,1,4,0,0,1,-2,2
965,960,960,960,20,19,20,21,1,2,1,3,5,0,0,1,-1,-1
196,187,192,187,14,14,13,13,1,1,3,2,9,-5,5,0,1,0
1078,1073,1078,182,20,19,18,19,1,1,1,1,5,-5,896,1,1,-1
923,914,914,914,14,14,15,13,1,2,3,1,9,0,0,0,-1,2
543,534,539,539,18,17,18,18,2,2,2,1,9,-5,0,1,-1,0
609,604,604,604,14,17,15,16,1,1,1,1,5,0,0,-3,2,-1
646,642,637,637,13,14,12,13,1,3,1,4,4,5,0,-1,2,-1
590,586,590,586,18,19,18,19,2,2,1,2,4,-4,4,-1,1,-1
417,417,459,417,20,19,18,18,1,3,1,1,0,-42,42,1,1,0
886,881,886,881,21,19,20,19,1,1,1,1,5,-5,5,2,-1,1
271,267,267,262,14,17,15,16,2,3,2,2,4,0,5,-3,2,-1
454,445,450,445,20,19,18,18,3,2,3,1,9,-5,5,1,1,0
707,693,689,689,13,14,15,13,2,2,2,3,14,4,0,-1,-1,2
773,773,768,768,20,19,18,18,3,1,3,1,0,5,0,1,1,0
946,942,937,932,20,19,20,18,2,1,2,2,4,5,5,1,-1,2
951,937,942,937,13,14,15,13,2,2,1,2,14,-5,5,-1,-1,2
679,674,670,674,13,14,15,13,1,3,3,1,5,4,-4,-1,-1,2
693,693,689,689,20,19,20,18,1,1,1,1,0,4,0,1,-1,2
689,679,679,679,20,19,20,21,1,6,2,1,10,0,0,1,-1,-1
750,745,745,745,13,14,15,13,2,3,1,2,5,0,0,-1,-1,2
787,782,782,787,18,19,18,19,3,1,1,1,5,0,-5,-1,1,-1
928,918,928,928,21,19,21,21,1,2,1,1,10,-10,0,2,-2,0
745,740,736,736,17,16,15,16,2,2,1,3,5,4,0,1,1,-1
492,482,478,473,14,14,15,13,3,1,2,2,10,4,5,0,-1,2
684,674,660,651,20,19,20,18,3,2,1,1,10,14,9,1,-1,2
684,679,679,674,13,14,12,13,1,2,3,1,5,0,5,-1,2,-1
886,876,871,871,14,17,15,16,1,3,1,2,10,5,0,-3,2,-1
1017,979,998,993,13,14,12,13,2,2,1,3,38,-19,5,-1,2,-1
909,904,904,909,14,14,13,13,2,2,2,1,5,0,-5,0,1,0
778,768,764,806,13,14,15,16,2,2,2,1,10,4,-42,-1,-1,-1
689,679,674,674,13,14,12,13,2,1,4,3,10,5,0,-1,2,-1
946,942,942,942,13,14,15,13,2,2,2,1,4,0,0,-1,-1,2
820,810,815,857,21,19,20,18,1,2,2,1,10,-5,-42,2,-1,2
764,750,754,759,13,14,12,13,3,2,1,2,14,-4,-5,-1,2,-1
290,286,276,276,14,14,13,13,1,3,1,1,4,10,0,0,1,0
974,974,970,974,13,16,15,16,1,2,1,1,0,4,-4,-3,1,-1
351,351,346,342,20,19,20,18,1,1,1,2,0,5,4,1,-1,2
890,876,886,881,18,17,18,19,1,4,2,2,14,-10,5,1,-1,-1
384,389,389,389,17,16,15,16,3,4,2,1,-5,0,0,1,1,-1
192,182,1073,1073,14,14,12,13,1,1,3,1,10,-891,0,0,2,-1
318,318,323,318,14,17,15,16,2,2,1,3,0,-5,5,-3,2,-1
665,660,656,656,20,19,20,21,2,3,1,3,5,4,0,1,-1,-1
914,904,909,909,14,14,13,13,1,1,1,1,10,-5,0,0,1,0
946,937,942,942,20,19,18,18,3,2,1,1,9,-5,0,1,1,0
993,989,984,979,13,14,15,16,1,2,1,2,4,5,5,-1,-1,-1
731,721,731,726,13,14,15,16,3,4,2,1,10,-10,5,-1,-1,-1
900,900,900,895,14,14,15,13,4,2,4,2,0,0,5,0,-1,2
224,220,220,220,14,14,13,13,1,2,2,1,4,0,0,0,1,0
1050,1045,1040,1040,13,14,12,13,1,3,1,2,5,5,0,-1,2,-1
801,796,801,796,14,14,15,13,3,3,2,2,5,-5,5,0,-1,2
271,262,253,253,14,14,15,13,1,1,1,1,9,9,0,0,-1,2
1054,1054,1059,1054,13,14,12,13,2,2,2,2,0,-5,5,-1,2,-1
806,801,801,801,14,14,13,13,3,2,5,2,5,0,0,0,1,0
801,796,796,801,14,14,13,13,1,1,1,1,5,0,-5,0,1,0
351,346,351,346,17,16,18,18,1,6,2,1,5,-5,5,1,-2,0
637,637,637,637,13,14,12,13,3,4,1,1,0,0,0,-1,2,-1
567,562,557,557,14,14,15,13,1,2,3,3,5,5,0,0,-1,2
1040,1036,1031,1045,17,16,18,11,1,2,1,1,4,5,-14,1,-2,7
1040,1040,1031,1036,13,14,20,13,1,3,1,2,0,9,-5,-1,-6,7
473,468,473,468,20,19,20,21,3,2,2,2,5,-5,5,1,-1,-1
295,290,290,281,14,14,15,16,1,4,2,2,5,0,9,0,-1,-1
1050,1045,1045,1040,13,14,12,13,3,2,1,2,5,0,5,-1,2,-1
909,900,895,895,14,14,13,13,1,1,1,3,9,5,0,0,1,0
1026,1017,1017,1012,13,14,12,13,4,1,1,1,9,0,5,-1,2,-1
300,304,300,300,14,17,15,16,2,1,3,1,-4,4,0,-3,2,-1
524,515,510,510,18,19,18,19,2,1,3,2,9,5,0,-1,1,-1
1045,1036,1036,1040,17,16,18,18,3,1,1,3,9,0,-4,1,-2,0
773,768,764,768,17,16,18,18,2,1,1,1,5,4,-4,1,-2,0
712,707,707,703,13,14,12,13,4,2,3,2,5,0,4,-1,2,-1
867,867,867,867,14,14,15,13,3,1,1,1,0,0,0,0,-1,2
220,215,182,210,18,17,18,16,1,1,1,1,5,33,-28,1,-1,2
1050,1050,1050,1040,13,14,15,13,3,3,2,2,0,0,10,-1,-1,2
909,909,904,900,14,17,15,16,1,3,1,2,0,5,4,-3,2,-1
787,773,796,773,14,14,15,13,2,2,2,2,14,-23,23,0,-1,2
300,276,271,271,14,14,13,13,3,2,2,3,24,5,0,0,1,0
796,796,792,787,18,19,18,19,2,1,2,1,0,4,5,-1,1,-1
524,529,529,524,18,19,18,19,2,3,2,2,-5,0,5,-1,1,-1
257,253,248,248,14,17,15,16,1,3,3,2,4,5,0,-3,2,-1
689,679,684,689,17,16,18,18,2,2,2,3,10,-5,-5,1,-2,0
1050,1045,403,1036,13,14,15,13,3,3,1,2,5,642,-633,-1,-1,2
1054,1045,1050,1050,20,19,20,18,3,1,1,1,9,-5,0,1,-1,2
220,215,220,220,21,19,20,21,1,2,3,3,5,-5,0,2,-1,-1
224,215,220,215,18,19,18,19,1,2,4,2,9,-5,5,-1,1,-1
937,932,928,928,17,16,15,16,1,1,2,1,5,4,0,1,1,-1
229,215,215,215,21,19,20,21,2,2,1,1,14,0,0,2,-1,-1
810,792,792,796,21,19,21,21,3,1,1,1,18,0,-4,2,-2,0
890,881,496,876,18,17,23,16,2,3,1,2,9,385,-380,1,-6,7
679,674,674,674,13,14,12,13,2,2,2,1,5,0,0,-1,2,-1
834,824,960,824,18,19,15,19,2,2,1,1,10,-136,136,-1,4,-4
393,389,384,384,13,14,12,13,4,2,3,3,4,5,0,-1,2,-1
656,660,656,646,17,19,18,18,1,1,3,2,-4,4,10,-2,1,0
928,923,928,918,14,14,13,13,1,1,2,2,5,-5,10,0,1,0
1064,1050,1050,1045,13,14,12,13,2,2,1,2,14,0,5,-1,2,-1
974,965,970,960,20,19,18,18,2,1,2,1,9,-5,10,1,1,0
923,914,918,918,14,14,13,13,2,2,5,3,9,-4,0,0,1,0
824,824,824,820,14,17,15,16,2,4,2,3,0,0,4,-3,2,-1
229,224,224,224,18,19,20,19,2,3,2,1,5,0,0,-1,-1,1
342,332,323,318,20,19,18,19,3,2,1,1,10,9,5,1,1,-1
586,586,581,576,18,19,18,18,5,1,1,2,0,5,5,-1,1,0
1050,1045,1054,1064,13,14,15,13,2,3,1,1,5,-9,-10,-1,-1,2
867,857,857,862,18,19,18,18,1,1,5,1,10,0,-5,-1,1,0
281,271,271,267,14,14,15,16,4,3,2,1,10,0,4,0,-1,-1
454,459,459,454,13,14,15,13,1,3,2,2,-5,0,5,-1,-1,2
717,712,712,707,17,16,18,16,2,1,2,2,5,0,5,1,-2,2
459,450,454,454,20,19,20,21,1,2,1,2,9,-4,0,1,-1,-1
553,539,553,557,21,19,20,18,1,2,1,1,14,-14,-4,2,-1,2
876,881,871,871,14,14,15,13,1,1,2,2,-5,10,0,0,-1,2
731,731,731,726,13,16,15,16,1,2,2,1,0,0,5,-3,1,-1
1073,1073,1073,1073,17,16,18,16,1,2,1,2,0,0,0,1,-2,2
510,487,478,473,14,14,15,13,2,2,2,1,23,9,5,0,-1,2
951,946,942,946,13,14,15,16,2,1,2,1,5,4,-4,-1,-1,-1
431,421,431,431,17,16,18,18,1,2,1,1,10,-10,0,1,-2,0
332,332,332,332,17,16,18,18,1,1,1,1,0,0,0,1,-2,0
970,956,965,960,20,19,20,18,1,2,2,2,14,-9,5,1,-1,2
815,815,806,806,14,14,13,13,2,3,1,3,0,9,0,0,1,0
318,318,318,318,18,17,18,19,1,1,2,3,0,0,0,1,-1,-1
674,665,674,674,20,19,20,21,1,1,1,3,9,-9,0,1,-1,-1
571,567,562,567,21,19,20,18,1,5,1,1,4,5,-5,2,-1,2
1068,1059,1059,1054,13,14,12,13,2,2,1,2,9,0,5,-1,2,-1
998,993,998,989,20,19,18,18,1,1,2,4,5,-5,9,1,1,0
534,520,524,520,14,14,15,13,1,2,1,1,14,-4,4,0,-1,2
600,590,595,590,18,19,18,19,2,4,2,4,10,-5,5,-1,1,-1
182,1073,1078,1073,14,16,15,16,2,2,1,3,-891,-5,5,-2,1,-1
539,520,524,524,14,14,15,13,3,2,1,1,19,-4,0,0,-1,2
393,389,384,379,17,16,18,16,2,2,1,1,4,5,5,1,-2,2
220,215,215,210,14,14,15,13,1,6,1,2,5,0,5,0,-1,2
360,351,356,360,17,16,15,16,3,2,1,1,9,-5,-4,1,1,-1
801,796,801,796,18,19,18,19,3,1,2,1,5,-5,5,-1,1,-1
1003,993,993,998,17,16,18,18,1,1,2,1,10,0,-5,1,-2,0
707,703,707,707,13,14,12,13,1,2,3,2,4,-4,0,-1,2,-1
529,524,534,534,14,17,15,16,2,1,1,1,5,-10,0,-3,2,-1
623,623,623,623,21,19,21,21,2,3,1,2,0,0,0,2,-2,0
660,651,642,637,17,16,15,16,2,1,1,1,9,9,5,1,1,-1
239,224,224,220,14,14,15,13,1,2,2,1,15,0,4,0,-1,2
567,567,571,567,14,14,13,13,3,2,3,2,0,-4,4,0,1,0
365,356,365,370,20,19,20,18,1,3,1,1,9,-9,-5,1,-1,2
665,656,660,656,17,16,18,18,2,1,2,1,9,-4,4,1,-2,0
557,548,548,543,14,14,15,13,1,3,2,1,9,0,5,0,-1,2
314,309,314,309,14,14,13,13,1,2,3,1,5,-5,5,0,1,0
1021,1021,1021,1021,13,14,15,13,1,3,2,1,0,0,0,-1,-1,2
276,192,187,192,21,19,21,19,1,1,1,1,84,5,-5,2,-2,2
426,426,426,426,13,14,15,13,1,1,3,1,0,0,0,-1,-1,2
806,787,773,768,14,14,15,13,2,2,1,2,19,14,5,0,-1,2
900,895,900,904,18,17,18,19,1,4,1,1,5,-5,-4,1,-1,-1
398,393,389,393,13,14,15,13,1,3,3,3,5,4,-4,-1,-1,2
1045,1040,1031,1031,20,19,18,18,2,1,4,2,5,9,0,1,1,0
379,374,370,370,17,16,18,18,1,2,1,2,5,4,0,1,-2,0
1007,1003,1007,1003,17,16,18,18,2,2,1,2,4,-4,4,1,-2,0
801,787,787,787,14,14,15,13,1,1,2,1,14,0,0,0,-1,2
824,815,820,815,18,17,18,16,1,2,3,2,9,-5,5,1,-1,2
815,810,810,810,14,17,15,16,6,2,2,1,5,0,0,-3,2,-1
510,501,506,506,18,19,18,19,2,1,1,1,9,-5,0,-1,1,-1
642,637,637,881,20,19,18,21,1,1,3,1,5,0,-244,1,1,-3
440,440,440,436,17,19,18,18,1,3,1,3,0,0,4,-2,1,0
323,318,318,314,14,14,13,13,2,1,3,2,5,0,4,0,1,0
1031,1031,1026,1026,13,14,15,13,3,3,2,1,0,5,0,-1,-1,2
431,426,426,417,17,16,15,16,1,3,2,1,5,0,9,1,1,-1
787,787,782,787,14,17,15,16,3,3,1,1,0,5,-5,-3,2,-1
524,520,520,529,18,17,18,19,1,1,1,1,4,0,-9,1,-1,-1
689,693,689,693,17,16,15,16,1,3,1,1,-4,4,-4,1,1,-1
436,421,412,421,13,14,12,13,1,4,3,1,15,9,-9,-1,2,-1
942,942,937,937,13,14,15,16,1,3,2,1,0,5,0,-1,-1,-1
956,951,942,946,20,19,20,18,3,1,1,1,5,9,-4,1,-1,2
262,257,262,257,14,17,15,16,2,1,2,1,5,-5,5,-3,2,-1
342,342,342,342,13,14,12,13,1,1,2,1,0,0,0,-1,2,-1
1012,1003,1007,998,20,19,18,18,2,2,2,4,9,-4,9,1,1,0
201,192,192,192,18,17,18,19,2,2,1,1,9,0,0,1,-1,-1
510,501,496,501,18,17,18,16,3,3,1,1,9,5,-5,1,-1,2
459,454,464,454,20,19,20,18,2,3,1,1,5,-10,10,1,-1,2
524,524,946,520,21,19,20,19,1,2,1,1,0,-422,426,2,-1,1
398,389,393,389,13,14,15,16,2,2,2,3,9,-4,4,-1,-1,-1
904,895,900,895,14,14,15,13,3,2,3,2,9,-5,5,0,-1,2
515,510,510,510,14,17,15,16,3,3,1,2,5,0,0,-3,2,-1
890,886,886,886,18,17,18,19,2,2,1,1,4,0,0,1,-1,-1
674,674,670,670,20,19,18,18,3,2,2,1,0,4,0,1,1,0
740,736,736,736,13,16,15,16,2,3,2,1,4,0,0,-3,1,-1
829,820,815,810,14,17,15,16,1,2,1,1,9,5,5,-3,2,-1
356,351,346,351,17,16,15,16,2,1,3,1,5,5,-5,1,1,-1
220,215,210,210,14,17,15,16,1,1,3,2,5,5,0,-3,2,-1
328,323,318,318,18,17,18,16,1,1,1,1,5,5,0,1,-1,2
909,900,904,904,18,17,18,16,1,2,2,3,9,-4,0,1,-1,2
590,586,586,581,18,19,18,19,1,3,2,1,4,0,5,-1,1,-1
689,684,684,684,13,14,15,13,1,1,2,1,5,0,0,-1,-1,2
712,717,712,707,17,19,18,18,3,2,2,1,-5,5,5,-2,1,0
1026,1021,1021,1021,13,16,15,16,3,1,2,1,5,0,0,-3,1,-1
937,932,928,923,20,19,21,19,2,2,1,2,5,4,5,1,-2,2
792,792,787,787,18,17,18,19,2,3,1,1,0,5,0,1,-1,-1
923,918,914,914,21,19,21,21,2,1,1,3,5,4,0,2,-2,0
829,815,815,815,14,17,15,16,1,3,1,4,14,0,0,-3,2,-1
224,220,215,215,18,19,18,19,2,1,2,1,4,5,0,-1,1,-1
468,464,468,459,20,19,18,18,1,2,2,2,4,-4,9,1,1,0
782,773,778,778,14,16,15,16,2,2,1,1,9,-5,0,-2,1,-1
304,300,314,309,14,14,15,16,4,2,2,3,4,-14,5,0,-1,-1
590,586,581,576,21,19,20,21,3,4,1,3,4,5,5,2,-1,-1
989,979,979,979,13,14,15,13,3,2,1,1,10,0,0,-1,-1,2
398,393,412,412,20,19,20,18,1,1,2,2,5,-19,0,1,-1,2
253,248,248,248,14,17,15,16,2,2,2,3,5,0,0,-3,2,-1
393,389,393,389,13,14,12,13,1,1,2,1,4,-4,4,-1,2,-1
600,595,595,590,18,17,18,16,1,2,1,2,5,0,5,1,-1,2
820,824,824,820,18,17,18,19,3,1,2,1,-4,0,4,1,-1,-1
468,464,464,464,13,14,12,13,1,3,1,1,4,0,0,-1,2,-1
210,206,206,201,14,14,15,16,1,1,1,3,4,0,5,0,-1,-1
937,932,923,923,13,16,15,16,1,1,1,1,5,9,0,-3,1,-1
562,557,553,553,14,17,15,16,1,2,3,1,5,4,0,-3,2,-1
820,815,824,815,21,19,20,21,2,2,2,1,5,-9,9,2,-1,-1
806,796,801,801,14,14,13,13,3,1,1,2,10,-5,0,0,1,0
393,384,389,389,13,14,15,13,3,4,1,1,9,-5,0,-1,-1,2
1036,1036,1036,1031,13,14,15,13,1,3,1,2,0,0,5,-1,-1,2
646,637,637,637,13,14,15,13,2,2,2,1,9,0,0,-1,-1,2
567,557,553,548,14,17,15,16,1,3,1,2,10,4,5,-3,2,-1
862,862,862,867,14,14,15,16,2,3,2,3,0,0,-5,0,-1,-1
1059,1050,1045,1045,17,16,15,16,1,1,1,2,9,5,0,1,1,-1
768,754,740,740,13,14,12,13,1,1,1,3,14,14,0,-1,2,-1
989,989,989,989,20,19,20,18,1,1,2,3,0,0,0,1,-1,2
1045,1031,1031,1026,13,14,12,13,1,2,2,2,14,0,5,-1,2,-1
384,384,384,384,13,16,15,16,2,3,2,1,0,0,0,-3,1,-1
557,548,548,543,18,17,18,16,2,2,1,1,9,0,5,1,-1,2
318,318,318,318,14,14,15,16,4,3,3,2,0,0,0,0,-1,-1
370,360,360,365,17,16,18,16,2,2,1,1,10,0,-5,1,-2,2
1003,1003,1003,993,20,19,20,21,1,2,1,1,0,0,10,1,-1,-1
782,782,782,782,14,17,15,16,2,2,1,1,0,0,0,-3,2,-1
370,365,365,365,13,16,15,16,3,3,1,3,5,0,0,-3,1,-1
464,454,450,454,20,19,18,18,1,2,1,1,10,4,-4,1,1,0
839,834,834,829,18,19,18,19,3,1,2,2,5,0,5,-1,1,-1
900,900,895,890,18,19,18,19,1,4,2,1,0,5,5,-1,1,-1
206,201,201,201,18,19,18,19,2,3,1,2,5,0,0,-1,1,-1
614,614,614,609,14,14,13,13,2,2,1,1,0,0,5,0,1,0
314,304,304,304,14,14,15,16,1,3,2,1,10,0,0,0,-1,-1
871,867,862,867,14,14,15,13,2,2,1,2,4,5,-5,0,-1,2
473,464,468,468,20,19,18,18,2,2,2,3,9,-4,0,1,1,0
754,745,745,745,13,14,15,13,3,1,1,1,9,0,0,-1,-1,2
778,768,764,764,17,16,15,16,2,3,1,1,10,4,0,1,1,-1
468,464,454,459,13,14,12,13,1,1,2,1,4,10,-5,-1,2,-1
562,553,553,553,14,17,15,16,1,1,2,3,9,0,0,-3,2,-1
604,595,595,595,18,17,18,16,1,2,3,1,9,0,0,1,-1,2
632,637,628,628,13,14,15,13,1,1,1,1,-5,9,0,-1,-1,2
436,426,426,421,17,19,18,18,2,1,2,2,10,0,5,-2,1,0
337,323,323,318,13,14,13,13,2,2,3,1,14,0,5,-1,1,0
543,543,548,543,14,14,13,13,2,1,1,1,0,-5,5,0,1,0
721,717,717,721,13,14,12,13,2,2,1,3,4,0,-4,-1,2,-1
628,623,623,623,18,17,18,16,1,2,1,1,5,0,0,1,-1,2
979,974,970,979,13,16,15,16,1,2,1,3,5,4,-9,-3,1,-1
979,974,1007,1031,20,19,18,18,2,2,1,1,5,-33,-24,1,1,0
1036,1031,1040,1036,13,14,12,13,1,2,2,1,5,-9,4,-1,2,-1
679,679,674,670,13,14,15,13,2,3,1,2,0,5,4,-1,-1,2
286,281,281,281,18,17,18,19,1,1,2,2,5,0,0,1,-1,-1
267,262,267,262,14,14,13,13,2,3,2,1,5,-5,5,0,1,0
239,234,234,224,18,17,18,19,2,3,2,2,5,0,10,1,-1,-1
886,881,881,881,21,19,20,21,1,1,1,3,5,0,0,2,-1,-1
304,290,276,290,14,14,13,13,1,1,2,1,14,14,-14,0,1,0
764,754,754,754,20,19,20,18,2,2,2,2,10,0,0,1,-1,2
646,632,637,637,20,19,20,18,2,2,1,2,14,-5,0,1,-1,2
886,876,876,881,18,19,18,19,1,2,2,1,10,0,-5,-1,1,-1
918,909,909,904,14,14,13,13,2,2,3,2,9,0,5,0,1,0
468,459,464,459,17,16,15,16,2,2,2,1,9,-5,5,1,1,-1
314,300,304,304,21,19,20,19,2,2,1,1,14,-4,0,2,-1,1
257,248,253,248,14,14,15,13,2,2,1,2,9,-5,5,0,-1,2
1040,1036,1040,1040,17,19,18,18,3,2,5,1,4,-4,0,-2,1,0
510,515,506,501,21,19,20,21,1,2,1,2,-5,9,5,2,-1,-1
314,304,304,300,18,17,18,16,3,2,2,2,10,0,4,1,-1,2
492,482,478,473,18,17,18,18,1,1,1,2,10,4,5,1,-1,0
642,637,642,642,20,19,20,21,1,2,1,1,5,-5,0,1,-1,-1
590,590,586,586,21,19,20,21,1,1,1,3,0,4,0,2,-1,-1
323,323,328,318,18,17,18,19,2,2,2,2,0,-5,10,1,-1,-1
267,257,257,257,21,19,20,21,2,2,1,3,10,0,0,2,-1,-1
487,473,468,468,18,19,18,18,3,1,3,2,14,5,0,-1,1,0
229,224,220,215,18,17,18,16,3,3,1,2,5,4,5,1,-1,2
942,946,942,937,20,19,20,21,1,1,2,1,-4,4,5,1,-1,-1
524,520,520,520,18,17,18,19,3,1,1,1,4,0,0,1,-1,-1
843,839,834,839,14,14,15,16,1,3,1,3,4,5,-5,0,-1,-1
1007,998,1003,998,17,16,18,18,4,1,2,3,9,-5,5,1,-2,0
318,318,318,318,14,14,13,13,2,2,1,1,0,0,0,0,1,0
857,857,857,857,18,19,18,18,2,1,2,2,0,0,0,-1,1,0
989,984,989,989,17,19,18,18,1,3,1,1,5,-5,0,-2,1,0
684,679,674,674,13,14,12,13,1,1,2,3,5,5,0,-1,2,-1
450,431,436,431,13,14,12,13,4,2,2,1,19,-5,5,-1,2,-1
942,937,937,932,13,16,15,16,4,1,2,2,5,0,5,-3,1,-1
224,206,206,206,14,14,13,13,1,1,2,2,18,0,0,0,1,0
876,867,862,853,21,19,20,21,2,2,2,2,9,5,9,2,-1,-1
440,431,440,436,20,19,20,21,2,2,2,1,9,-9,4,1,-1,-1
942,937,932,923,20,19,20,19,4,3,1,2,5,5,9,1,-1,1
210,210,210,210,21,19,20,21,2,2,1,2,0,0,0,2,-1,-1
721,717,712,712,20,19,20,21,1,3,1,1,4,5,0,1,-1,-1
740,740,740,740,13,14,15,13,3,2,6,2,0,0,0,-1,-1,2
1050,1050,1045,1045,13,14,12,13,5,3,1,1,0,5,0,-1,2,-1
393,393,389,389,13,16,15,16,3,1,2,3,0,4,0,-3,1,-1
1059,1045,1050,1050,13,14,12,13,2,1,3,1,14,-5,0,-1,2,-1
618,614,614,614,18,19,18,19,1,1,1,3,4,0,0,-1,1,-1
370,365,365,374,20,19,20,21,1,3,1,1,5,0,-9,1,-1,-1
660,660,660,656,20,19,20,18,3,1,2,1,0,0,4,1,-1,2
909,904,904,904,21,19,20,21,2,1,1,1,5,0,0,2,-1,-1
829,820,824,820,18,17,18,19,1,2,2,2,9,-4,4,1,-1,-1
286,286,286,286,18,19,18,19,4,1,2,1,0,0,0,-1,1,-1
1073,1068,1059,1064,13,14,15,13,2,1,1,1,5,9,-5,-1,-1,2
1054,1050,1054,1045,20,19,18,18,2,3,2,1,4,-4,9,1,1,0
248,243,239,239,18,17,18,18,1,3,1,1,5,4,0,1,-1,0
323,314,309,309,14,14,15,13,3,3,1,3,9,5,0,0,-1,2
993,989,984,984,13,16,15,16,3,2,3,1,4,5,0,-3,1,-1
989,984,989,989,13,14,12,13,1,2,1,1,5,-5,0,-1,2,-1
398,389,393,384,13,14,12,13,2,1,2,2,9,-4,9,-1,2,-1
271,262,267,267,14,14,15,16,1,1,2,1,9,-5,0,0,-1,-1
224,224,220,220,18,17,18,19,2,3,2,1,0,4,0,1,-1,-1
328,318,304,309,14,14,15,16,1,1,1,3,10,14,-5,0,-1,-1
820,815,810,810,18,17,18,19,3,3,1,1,5,5,0,1,-1,-1
342,323,323,318,13,14,13,13,2,3,2,3,19,0,5,-1,1,0
871,867,867,862,14,14,15,16,1,2,1,2,4,0,5,0,-1,-1
398,389,384,384,13,14,15,13,2,2,2,1,9,5,0,-1,-1,2
848,843,843,839,18,17,18,18,2,2,1,1,5,0,4,1,-1,0
468,459,464,459,17,16,18,16,2,3,2,2,9,-5,5,1,-2,2
960,1078,956,960,13,16,12,13,1,1,2,2,-118,122,-4,-3,4,-1
792,782,782,787,18,19,18,19,3,2,1,1,10,0,-5,-1,1,-1
417,412,412,412,17,16,15,16,1,2,1,3,5,0,0,1,1,-1
881,881,881,881,18,19,18,19,2,2,1,1,0,0,0,-1,1,-1
534,534,529,529,18,19,18,19,2,1,1,1,0,5,0,-1,1,-1
900,886,881,886,14,14,13,13,1,3,1,3,14,5,-5,0,1,0
665,656,660,656,17,16,18,18,1,2,1,1,9,-4,4,1,-2,0
257,248,248,253,21,19,20,21,1,2,1,1,9,0,-5,2,-1,-1
267,253,243,243,14,14,13,13,1,3,3,1,14,10,0,0,1,0
801,796,796,796,18,19,18,19,3,2,1,3,5,0,0,-1,1,-1
740,731,736,726,20,19,20,18,1,1,2,2,9,-5,10,1,-1,2
309,300,300,300,14,14,13,13,1,1,2,1,9,0,0,0,1,0
360,356,356,356,20,19,20,18,2,1,1,1,4,0,0,1,-1,2
510,496,487,482,14,14,13,13,2,1,3,2,14,9,5,0,1,0
684,674,674,674,13,14,12,13,3,2,1,1,10,0,0,-1,2,-1
871,867,862,867,18,19,18,18,1,1,1,1,4,5,-5,-1,1,0
731,717,717,717,13,14,12,13,3,1,2,1,14,0,0,-1,2,-1
1031,1026,1026,1021,13,14,15,13,2,1,1,2,5,0,5,-1,-1,2
464,459,459,459,13,16,15,16,5,1,1,3,5,0,0,-3,1,-1
370,356,360,356,13,14,15,13,1,1,2,1,14,-4,4,-1,-1,2
548,543,548,543,21,19,20,18,2,1,1,1,5,-5,5,2,-1,2
1064,1059,1064,1059,20,19,20,18,2,2,3,2,5,-5,5,1,-1,2
970,965,965,960,17,19,18,18,3,1,2,2,5,0,5,-2,1,0
998,993,993,993,20,19,20,21,2,1,1,3,5,0,0,1,-1,-1
262,257,257,253,14,17,15,16,2,2,2,1,5,0,4,-3,2,-1
267,253,253,248,14,14,15,13,2,2,2,2,14,0,5,0,-1,2
586,581,581,576,21,19,20,18,1,1,2,1,5,0,5,2,-1,2
520,515,510,506,14,14,15,16,1,1,2,1,5,5,4,0,-1,-1
956,946,951,946,17,19,18,18,2,2,1,2,10,-5,5,-2,1,0
543,539,534,534,18,17,18,16,2,2,1,2,4,5,0,1,-1,2
417,417,417,417,13,14,12,13,2,3,1,1,0,0,0,-1,2,-1
965,965,960,960,17,16,18,18,1,1,1,1,0,5,0,1,-2,0
436,426,426,426,17,16,15,16,1,2,2,1,10,0,0,1,1,-1
323,318,318,318,21,19,21,21,2,2,1,1,5,0,0,2,-2,0
482,482,482,487,18,17,18,16,1,1,1,1,0,0,-5,1,-1,2
337,332,337,332,20,19,20,18,2,2,2,1,5,-5,5,1,-1,2
342,332,332,337,20,19,20,21,2,2,1,1,10,0,-5,1,-1,-1
768,768,764,764,20,19,18,18,1,1,2,1,0,4,0,1,1,0
937,932,928,928,20,19,18,19,2,1,1,1,5,4,0,1,1,-1
740,736,736,731,17,16,18,18,2,1,2,1,4,0,5,1,-2,0
337,332,337,337,20,19,20,18,3,2,1,1,5,-5,0,1,-1,2
923,923,918,923,14,17,15,16,3,2,1,3,0,5,-5,-3,2,-1
290,309,304,309,21,19,20,19,4,2,1,1,-19,5,-5,2,-1,1
515,515,520,515,18,19,18,19,5,2,2,4,0,-5,5,-1,1,-1
604,595,595,595,14,14,15,13,1,3,2,1,9,0,0,0,-1,2
689,684,679,679,13,14,12,13,2,2,1,2,5,5,0,-1,2,-1
286,286,281,281,18,19,18,19,1,1,1,1,0,5,0,-1,1,-1
1040,1036,1036,1036,17,16,15,16,3,3,2,3,4,0,0,1,1,-1
614,609,609,614,18,19,18,19,2,1,1,1,5,0,-5,-1,1,-1
740,736,736,731,20,19,18,18,2,3,2,1,4,0,5,1,1,0
782,773,773,778,14,14,12,13,1,2,1,1,9,0,-5,0,2,-1
796,792,787,787,18,17,18,19,2,1,1,1,4,5,0,1,-1,-1
642,637,637,632,17,16,18,18,1,1,2,1,5,0,5,1,-2,0
979,974,970,974,17,16,15,16,2,3,1,1,5,4,-4,1,1,-1
468,464,459,459,13,14,15,13,2,1,3,1,4,5,0,-1,-1,2
886,881,886,881,21,19,20,19,1,2,2,2,5,-5,5,2,-1,1
665,665,665,660,13,14,12,13,1,2,2,3,0,0,5,-1,2,-1
726,726,726,726,17,16,18,18,1,1,1,1,0,0,0,1,-2,0
674,670,665,665,13,16,15,16,2,3,1,1,4,5,0,-3,1,-1
646,637,637,632,20,19,18,18,1,2,2,2,9,0,5,1,1,0
323,318,318,318,18,17,18,19,2,2,1,1,5,0,0,1,-1,-1
815,810,810,810,21,19,20,21,3,1,1,1,5,0,0,2,-1,-1
614,600,604,600,14,14,15,13,3,3,2,3,14,-4,4,0,-1,2
810,806,801,806,21,19,21,19,1,1,1,3,4,5,-5,2,-2,2
389,389,384,384,20,19,18,18,1,1,2,1,0,5,0,1,1,0
736,736,726,731,20,19,20,18,3,1,1,1,0,10,-5,1,-1,2
534,524,524,520,18,19,18,19,1,2,3,2,10,0,4,-1,1,-1
726,721,726,726,13,14,15,13,2,2,2,1,5,-5,0,-1,-1,2
815,806,810,806,14,14,15,16,3,2,2,1,9,-4,4,0,-1,-1
534,529,534,524,18,19,18,19,2,2,4,2,5,-5,10,-1,1,-1
492,482,478,478,14,14,13,13,3,2,2,1,10,4,0,0,1,0
473,468,478,468,13,14,13,13,2,2,2,3,5,-10,10,-1,1,0
810,534,787,792,14,19,15,16,1,1,2,1,276,-253,-5,-5,4,-1
951,946,946,946,20,19,20,21,3,1,2,2,5,0,0,1,-1,-1
450,450,450,445,17,16,15,16,3,2,2,1,0,0,5,1,1,-1
224,215,229,229,18,19,18,19,2,2,1,1,9,-14,0,-1,1,-1
407,403,651,407,17,16,15,16,1,3,1,2,4,-248,244,1,1,-1
656,642,637,637,13,14,12,13,2,2,3,2,14,5,0,-1,2,-1
529,524,524,524,18,17,18,16,1,3,1,1,5,0,0,1,-1,2
843,843,843,843,18,17,18,18,2,3,1,1,0,0,0,1,-1,0
515,510,515,510,14,14,13,13,5,1,2,1,5,-5,5,0,1,0
187,182,187,182,21,19,21,19,3,1,2,1,5,-5,5,2,-2,2
1068,1064,1059,1059,13,16,15,16,2,2,1,1,4,5,0,-3,1,-1
698,698,703,689,17,16,18,16,3,3,2,2,0,-5,14,1,-2,2
956,951,942,942,13,14,12,13,2,3,1,1,5,9,0,-1,2,-1
515,515,515,515,18,17,18,16,3,1,3,1,0,0,0,1,-1,2
890,886,886,881,14,14,13,13,3,3,2,3,4,0,5,0,1,0
740,736,736,731,13,14,12,13,2,3,2,1,4,0,5,-1,2,-1
440,440,445,440,17,19,18,18,3,2,1,2,0,-5,5,-2,1,0
534,529,524,520,14,14,15,13,2,1,1,2,5,5,4,0,-1,2
759,754,759,754,17,16,18,16,2,3,4,1,5,-5,5,1,-2,2
243,239,234,234,14,17,15,16,6,1,1,2,4,5,0,-3,2,-1
660,646,646,646,13,14,12,13,2,3,1,3,14,0,0,-1,2,-1
487,482,478,473,14,14,15,13,2,2,1,2,5,4,5,0,-1,2
656,646,646,642,13,14,15,13,1,1,1,1,10,0,4,-1,-1,2
1031,1021,1007,998,17,16,18,16,1,3,2,2,10,14,9,1,-2,2
764,759,759,759,17,16,18,18,3,2,1,1,5,0,0,1,-2,0
398,398,398,398,13,14,12,13,1,3,3,3,0,0,0,-1,2,-1
370,370,370,370,17,16,15,16,3,2,1,1,0,0,0,1,1,-1
187,182,1078,1078,14,14,15,13,2,1,2,1,5,-896,0,0,-1,2
604,600,590,590,18,17,18,19,1,1,3,1,4,10,0,1,-1,-1
787,787,787,787,18,17,18,19,1,1,2,1,0,0,0,1,-1,-1
318,309,318,318,18,17,18,19,2,2,2,1,9,-9,0,1,-1,-1
407,398,398,393,20,19,18,18,2,2,1,1,9,0,5,1,1,0
314,314,309,309,14,14,15,13,2,5,1,1,0,5,0,0,-1,2
965,956,951,951,13,14,15,13,3,2,1,1,9,5,0,-1,-1,2
909,890,890,890,14,14,15,16,2,2,1,4,19,0,0,0,-1,-1
1031,1021,1021,1021,13,14,15,16,4,1,2,1,10,0,0,-1,-1,-1
876,867,862,857,14,14,13,13,3,1,1,1,9,5,5,0,1,0
403,403,403,403,17,16,15,16,2,1,1,1,0,0,0,1,1,-1
759,750,750,750,13,16,15,16,1,2,1,1,9,0,0,-3,1,-1
543,534,543,534,14,14,13,13,3,2,2,2,9,-9,9,0,1,0
309,304,304,304,18,19,18,19,2,1,1,1,5,0,0,-1,1,-1
332,332,328,328,13,16,15,16,1,1,2,1,0,4,0,-3,1,-1
600,600,595,595,14,14,15,16,1,1,2,1,0,5,0,0,-1,-1
379,374,374,370,17,16,15,16,1,2,2,2,5,0,4,1,1,-1
520,520,506,506,18,17,18,16,2,2,3,3,0,14,0,1,-1,2
787,787,782,787,18,17,18,19,2,3,1,1,0,5,-5,1,-1,-1
454,450,450,445,20,19,20,18,1,2,1,2,4,0,5,1,-1,2
468,468,450,445,17,16,18,18,3,2,1,2,0,18,5,1,-2,0
642,637,623,623,13,14,15,13,3,2,1,2,5,14,0,-1,-1,2
810,806,806,801,18,17,18,19,1,3,2,1,4,0,5,1,-1,-1
820,806,806,806,14,14,13,13,1,2,3,1,14,0,0,0,1,0
215,210,206,206,14,14,15,13,2,3,1,1,5,4,0,0,-1,2
224,224,229,220,18,19,18,19,2,4,2,2,0,-5,9,-1,1,-1
440,440,436,436,17,16,18,18,3,1,1,2,0,4,0,1,-2,0
937,937,937,937,20,19,20,21,3,1,2,1,0,0,0,1,-1,-1
623,628,623,623,18,17,18,16,2,1,1,3,-5,5,0,1,-1,2
393,384,384,379,13,14,12,13,2,2,2,1,9,0,5,-1,2,-1
431,421,412,412,17,16,15,16,1,2,3,1,10,9,0,1,1,-1
960,946,951,951,20,19,20,18,2,2,3,2,14,-5,0,1,-1,2
1003,1007,1003,1003,20,19,20,18,3,1,1,1,-4,4,0,1,-1,2
243,239,239,229,14,14,13,13,3,2,4,2,4,0,10,0,1,0
496,492,492,492,21,19,21,21,3,5,1,1,4,0,0,2,-2,0
815,806,801,806,14,14,13,13,1,2,2,1,9,5,-5,0,1,0
1017,1012,1012,1012,17,16,15,16,2,1,1,1,5,0,0,1,1,-1
946,942,942,942,20,19,20,21,3,2,1,1,4,0,0,1,-1,-1
707,703,693,693,17,16,18,18,2,3,4,1,4,10,0,1,-2,0
492,492,487,487,14,14,15,13,1,3,2,2,0,5,0,0,-1,2
590,586,590,590,18,17,18,19,1,3,2,1,4,-4,0,1,-1,-1
665,665,660,665,13,14,12,13,3,3,1,1,0,5,-5,-1,2,-1
736,726,726,717,13,14,12,13,1,1,2,2,10,0,9,-1,2,-1
557,562,557,557,14,14,15,13,4,3,3,2,-5,5,0,0,-1,2
984,979,974,970,20,19,20,18,2,1,2,2,5,5,4,1,-1,2
853,843,839,839,14,17,15,16,1,1,1,1,10,4,0,-3,2,-1
890,876,881,881,14,17,15,16,3,2,1,1,14,-5,0,-3,2,-1
332,332,328,328,20,19,18,19,1,1,1,1,0,4,0,1,1,-1
346,342,346,342,20,19,18,18,1,2,2,1,4,-4,4,1,1,0
829,820,820,820,14,14,15,13,1,2,3,2,9,0,0,0,-1,2
379,374,374,374,13,14,15,13,2,3,3,1,5,0,0,-1,-1,2
318,318,318,314,14,14,15,13,1,3,2,2,0,0,4,0,-1,2
374,370,365,360,20,19,20,18,1,2,1,1,4,5,5,1,-1,2
656,646,651,651,20,19,20,21,1,1,2,1,10,-5,0,1,-1,-1
1040,1036,1031,1031,13,14,12,13,1,3,2,2,4,5,0,-1,2,-1
351,346,346,346,13,14,15,13,1,3,3,3,5,0,0,-1,-1,2
224,220,215,215,18,19,18,19,1,2,4,3,4,5,0,-1,1,-1
923,918,918,914,18,19,18,19,1,1,2,1,5,0,4,-1,1,-1
721,721,717,721,17,16,18,18,1,1,2,1,0,4,-4,1,-2,0
586,581,581,571,14,14,13,13,1,3,4,2,5,0,10,0,1,0
665,670,665,656,13,14,15,13,1,3,2,5,-5,5,9,-1,-1,2
754,754,754,750,20,19,18,18,1,1,2,3,0,0,4,1,1,0
1026,1017,1026,1021,13,14,12,13,3,2,2,2,9,-9,5,-1,2,-1
567,562,562,562,14,17,15,16,1,2,2,1,5,0,0,-3,2,-1
239,234,229,224,18,17,18,19,1,1,1,2,5,5,5,1,-1,-1
1026,1021,1021,1021,17,16,18,18,1,2,1,1,5,0,0,1,-2,0
843,829,824,820,14,14,15,13,2,2,2,2,14,5,4,0,-1,2
590,586,586,581,18,17,18,16,1,1,2,1,4,0,5,1,-1,2
192,182,192,187,14,14,13,13,1,2,1,3,10,-10,5,0,1,0
196,196,192,192,14,17,15,16,2,2,3,2,0,4,0,-3,2,-1
918,914,904,904,18,19,18,19,1,1,1,1,4,10,0,-1,1,-1
993,993,993,989,13,14,12,13,3,3,1,2,0,0,4,-1,2,-1
960,956,956,960,13,14,15,16,1,2,3,1,4,0,-4,-1,-1,-1
679,679,679,679,20,19,18,18,1,3,2,1,0,0,0,1,1,0
951,946,946,937,13,14,12,13,1,3,1,2,5,0,9,-1,2,-1
759,759,759,759,13,14,15,16,2,1,1,1,0,0,0,-1,-1,-1
764,759,759,759,20,19,20,21,1,2,1,1,5,0,0,1,-1,-1
600,595,595,595,14,14,15,13,3,2,1,1,5,0,0,0,-1,2
515,510,506,510,21,19,20,21,2,3,1,1,5,4,-4,2,-1,-1
703,698,698,698,20,19,18,18,3,1,1,1,5,0,0,1,1,0
196,192,192,187,14,17,15,16,1,3,2,1,4,0,5,-3,2,-1
482,478,468,478,14,14,12,13,1,1,1,1,4,10,-10,0,2,-1
534,524,524,524,18,17,18,16,3,2,1,2,10,0,0,1,-1,2
993,993,989,989,17,16,15,16,2,1,2,1,0,4,0,1,1,-1
501,501,496,496,21,19,21,19,2,1,1,1,0,5,0,2,-2,2
876,871,867,862,14,14,13,13,1,3,2,2,5,4,5,0,1,0
257,243,239,234,14,14,15,16,1,1,2,1,14,4,5,0,-1,-1
839,839,839,839,18,19,18,18,1,1,4,1,0,0,0,-1,1,0
576,571,571,567,18,19,18,18,1,1,2,1,5,0,4,-1,1,0
239,234,239,234,21,19,20,21,1,2,2,3,5,-5,5,2,-1,-1
337,323,332,337,17,17,15,16,3,2,1,1,14,-9,-5,0,2,-1
900,900,900,895,14,14,13,13,2,1,1,2,0,0,5,0,1,0
342,332,328,328,17,19,18,19,3,1,1,1,10,4,0,-2,1,-1
670,665,674,670,13,14,15,13,1,2,1,3,5,-9,4,-1,-1,2
698,698,693,689,17,19,18,18,1,1,1,2,0,5,4,-2,1,0
1003,1003,998,998,13,14,15,13,1,1,1,1,0,5,0,-1,-1,2
534,529,529,524,18,17,18,19,2,2,2,2,5,0,5,1,-1,-1
604,600,600,600,21,19,20,19,2,2,1,1,4,0,0,2,-1,1
374,370,370,360,13,16,15,16,1,2,2,2,4,0,10,-3,1,-1
900,890,886,886,14,14,13,13,2,3,1,2,10,4,0,0,1,0
487,492,482,482,14,14,15,16,2,1,1,1,-5,10,0,0,-1,-1
323,314,314,309,14,17,15,16,1,2,1,2,9,0,5,-3,2,-1
1050,1045,1040,1036,13,14,12,13,2,3,3,2,5,5,4,-1,2,-1
534,539,534,534,18,19,18,18,1,1,1,1,-5,5,0,-1,1,0
768,764,768,768,13,14,12,13,1,2,3,1,4,-4,0,-1,2,-1
548,543,543,543,18,19,18,18,1,2,1,1,5,0,0,-1,1,0
501,501,496,496,14,14,15,13,2,1,2,2,0,5,0,0,-1,2
881,876,876,876,14,14,13,13,3,2,2,3,5,0,0,0,1,0
951,946,951,951,13,14,12,13,1,2,3,1,5,-5,0,-1,2,-1
1021,1007,1012,1017,17,16,15,16,2,2,1,1,14,-5,-5,1,1,-1
286,286,281,286,14,14,13,13,3,3,1,3,0,5,-5,0,1,0
951,946,946,937,13,14,15,13,2,3,1,2,5,0,9,-1,-1,2
820,810,815,820,18,17,18,16,1,2,1,4,10,-5,-5,1,-1,2
370,436,436,436,17,19,20,21,1,1,1,2,-66,0,0,-2,-1,-1
346,337,342,342,20,19,20,21,1,2,4,1,9,-5,0,1,-1,-1
403,393,389,393,20,19,18,18,2,2,2,1,10,4,-4,1,1,0
1073,1064,1068,1064,20,19,18,18,2,2,2,3,9,-4,4,1,1,0
557,548,543,543,14,14,15,16,1,1,1,2,9,5,0,0,-1,-1
586,571,571,567,21,19,20,21,1,2,1,1,15,0,4,2,-1,-1
215,215,215,210,21,19,20,19,2,3,1,2,0,0,5,2,-1,1
951,942,942,946,13,14,15,13,3,2,3,1,9,0,-4,-1,-1,2
384,374,379,389,17,16,18,18,1,3,1,1,10,-5,-10,1,-2,0
665,656,660,656,20,19,20,21,2,3,2,1,9,-4,4,1,-1,-1
684,679,679,674,13,14,15,13,6,3,1,5,5,0,5,-1,-1,2
501,487,492,487,18,17,18,16,1,3,4,2,14,-5,5,1,-1,2
201,192,192,187,18,19,18,19,2,1,2,3,9,0,5,-1,1,-1
862,857,862,862,18,17,18,18,3,2,1,1,5,-5,0,1,-1,0
707,703,698,698,17,16,18,18,1,2,1,1,4,5,0,1,-2,0
571,562,562,557,21,19,20,18,1,1,1,1,9,0,5,2,-1,2
609,600,604,600,14,17,15,16,1,2,2,2,9,-4,4,-3,2,-1
965,965,956,960,20,19,20,18,1,3,1,1,0,9,-4,1,-1,2
618,618,614,614,21,19,21,19,2,1,1,2,0,4,0,2,-2,2
276,271,267,267,14,14,13,13,3,3,3,3,5,4,0,0,1,0
450,445,440,440,17,16,18,16,2,1,1,1,5,5,0,1,-2,2
862,857,857,857,21,19,20,21,4,2,1,1,5,0,0,2,-1,-1
637,623,618,614,17,17,18,19,2,2,1,1,14,5,4,0,-1,-1
1012,1007,1007,1003,17,16,18,18,2,1,2,1,5,0,4,1,-2,0
750,731,726,731,13,14,15,13,3,2,1,2,19,5,-5,-1,-1,2
253,248,253,253,18,17,15,16,3,3,2,3,5,-5,0,1,2,-1
796,792,792,796,21,19,21,21,2,2,1,1,4,0,-4,2,-2,0
946,937,937,932,20,19,20,21,2,3,2,1,9,0,5,1,-1,-1
421,417,417,417,13,14,15,13,1,2,3,1,4,0,0,-1,-1,2
506,496,496,492,14,14,13,13,1,1,1,3,10,0,4,0,1,0
937,937,937,937,20,19,20,21,1,2,1,1,0,0,0,1,-1,-1
468,464,459,454,13,14,15,13,2,1,3,2,4,5,5,-1,-1,2
660,656,651,651,17,16,15,16,1,3,2,1,4,5,0,1,1,-1
1007,998,993,998,13,14,12,13,2,2,1,3,9,5,-5,-1,2,-1
496,501,496,492,14,17,15,16,3,3,2,2,-5,5,4,-3,2,-1
834,834,829,834,14,17,15,16,2,2,1,1,0,5,-5,-3,2,-1
1068,1064,1064,1064,20,19,20,21,1,2,2,1,4,0,0,1,-1,-1
187,1073,1078,1078,14,14,15,13,1,2,1,1,-886,-5,0,0,-1,2
365,360,365,356,20,19,20,21,3,2,2,1,5,-5,9,1,-1,-1
703,693,684,684,17,19,18,18,1,1,1,2,10,9,0,-2,1,0
1007,1007,1003,998,13,14,12,13,1,3,1,4,0,4,5,-1,2,-1
834,820,820,824,21,19,20,19,2,4,2,1,14,0,-4,2,-1,1
1007,998,993,993,17,16,18,18,2,2,2,1,9,5,0,1,-2,0
581,571,571,571,18,19,18,18,1,2,3,1,10,0,0,-1,1,0
510,492,496,492,14,14,13,13,1,2,1,1,18,-4,4,0,1,0
304,300,295,300,14,14,13,13,3,3,1,1,4,5,-5,0,1,0
914,914,914,909,21,19,21,21,1,1,2,2,0,0,5,2,-2,0
206,201,201,201,14,14,13,13,3,2,1,1,5,0,0,0,1,0
857,853,848,848,14,17,15,16,1,3,1,3,4,5,0,-3,2,-1
501,487,492,487,18,17,18,16,1,2,3,1,14,-5,5,1,-1,2
426,421,421,417,13,14,12,13,1,4,2,1,5,0,4,-1,2,-1
496,492,492,492,21,19,21,21,1,2,1,1,4,0,0,2,-2,0
286,271,281,276,14,14,15,13,3,2,2,3,15,-10,5,0,-1,2
670,660,665,660,17,16,15,16,3,2,2,1,10,-5,5,1,1,-1
478,487,468,468,20,19,20,18,2,2,1,2,-9,19,0,1,-1,2
1012,1007,1007,1003,13,16,15,16,1,1,1,2,5,0,4,-3,1,-1
300,295,290,286,14,17,15,16,3,2,1,2,5,5,4,-3,2,-1
182,1073,1078,1073,21,19,20,18,2,2,1,2,-891,-5,5,2,-1,2
609,600,600,600,18,19,18,19,2,3,2,1,9,0,0,-1,1,-1
1054,1050,1054,1054,13,14,15,13,1,1,1,1,4,-4,0,-1,-1,2
276,271,267,267,14,14,13,13,3,1,1,2,5,4,0,0,1,0
473,459,454,454,17,16,15,16,1,2,1,2,14,5,0,1,1,-1
820,820,820,820,14,17,15,16,2,1,2,3,0,0,0,-3,2,-1
309,295,295,295,14,14,13,13,1,2,1,1,14,0,0,0,1,0
496,496,492,492,21,19,21,19,4,3,1,1,0,4,0,2,-2,2
1078,1078,1073,1073,17,16,15,16,1,1,2,1,0,5,0,1,1,-1
267,257,257,257,14,17,15,16,2,3,1,2,10,0,0,-3,2,-1
782,778,773,773,21,19,20,21,2,1,3,1,4,5,0,2,-1,-1
257,248,243,267,14,14,13,11,2,2,1,2,9,5,-24,0,1,2
923,914,914,909,14,17,15,16,2,3,1,3,9,0,5,-3,2,-1
262,201,492,201,14,17,23,16,2,2,1,1,61,-291,291,-3,-6,7
468,464,464,459,17,16,18,16,1,3,2,1,4,0,5,1,-2,2
548,524,534,529,14,14,13,13,2,2,2,1,24,-10,5,0,1,0
923,914,918,923,14,14,15,16,2,2,1,1,9,-4,-5,0,-1,-1
637,623,618,618,13,14,13,13,1,2,1,2,14,5,0,-1,1,0
595,576,567,571,14,17,15,16,1,1,3,2,19,9,-4,-3,2,-1
206,206,196,196,14,17,15,16,2,1,1,1,0,10,0,-3,2,-1
815,806,810,806,18,17,18,16,2,3,2,1,9,-4,4,1,-1,2
459,459,454,450,17,16,18,16,2,1,1,2,0,5,4,1,-2,2
290,356,356,356,14,14,15,13,2,2,3,1,-66,0,0,0,-1,2
524,529,524,524,18,17,18,19,2,1,1,1,-5,5,0,1,-1,-1
684,684,679,674,20,19,20,21,3,1,2,1,0,5,5,1,-1,-1
384,370,374,374,17,16,18,18,2,2,3,1,14,-4,0,1,-2,0
1059,1054,1064,1050,13,14,15,13,3,3,2,2,5,-10,14,-1,-1,2
192,187,187,182,18,17,18,19,1,3,2,1,5,0,5,1,-1,-1
562,562,562,557,14,14,13,13,2,1,2,1,0,0,5,0,1,0
351,346,342,342,17,16,18,16,4,3,1,2,5,4,0,1,-2,2
271,257,262,262,14,17,15,16,3,2,2,1,14,-5,0,-3,2,-1
674,674,670,665,13,16,15,16,1,1,1,2,0,4,5,-3,1,-1
900,900,900,900,18,19,18,19,3,1,1,1,0,0,0,-1,1,-1
787,787,792,792,21,19,21,21,2,2,2,1,0,-5,0,2,-2,0
239,234,234,234,18,17,18,18,2,2,3,2,5,0,0,1,-1,0
674,670,670,665,17,16,18,16,2,3,2,2,4,0,5,1,-2,2
923,928,918,918,14,17,15,16,2,1,5,4,-5,10,0,-3,2,-1
768,773,773,773,20,19,18,18,1,1,1,1,-5,0,0,1,1,0
309,304,309,309,21,19,21,21,1,2,6,1,5,-5,0,2,-2,0
754,750,750,750,20,19,20,21,2,1,1,3,4,0,0,1,-1,-1
1050,1050,1050,1050,13,14,15,16,3,2,2,1,0,0,0,-1,-1,-1
220,215,215,215,21,19,20,19,1,1,2,1,5,0,0,2,-1,1
1073,1068,1068,1068,17,19,18,18,2,1,1,1,5,0,0,-2,1,0
248,248,248,243,14,14,13,13,4,3,2,2,0,0,5,0,1,0
520,445,473,487,14,14,12,13,2,2,2,1,75,-28,-14,0,2,-1
1017,1007,1003,998,13,14,15,13,1,2,2,1,10,4,5,-1,-1,2
553,553,557,553,18,17,18,16,2,1,4,2,0,-4,4,1,-1,2
1059,1054,1054,1054,13,14,12,13,1,1,1,1,5,0,0,-1,2,-1
843,839,829,829,18,19,20,19,1,1,1,1,4,10,0,-1,-1,1
365,360,360,360,17,19,18,18,3,2,1,1,5,0,0,-2,1,0
201,196,196,196,14,14,15,16,2,2,2,3,5,0,0,0,-1,-1
956,951,951,951,17,16,18,16,1,2,1,3,5,0,0,1,-2,2
1068,1059,1054,1054,20,19,20,21,2,3,1,2,9,5,0,1,-1,-1
356,346,351,351,20,19,20,18,1,2,1,1,10,-5,0,1,-1,2
436,431,431,431,13,14,12,13,1,2,3,2,5,0,0,-1,2,-1
524,520,520,520,14,14,15,13,2,2,2,1,4,0,0,0,-1,2
806,806,806,806,14,14,15,13,2,1,1,1,0,0,0,0,-1,2
886,886,881,886,21,19,20,21,2,1,1,1,0,5,-5,2,-1,-1
909,839,853,848,18,17,18,18,1,2,2,1,70,-14,5,1,-1,0
782,778,778,778,18,19,18,18,1,1,1,1,4,0,0,-1,1,0
1050,1050,1045,1045,20,19,20,18,3,3,1,1,0,5,0,1,-1,2
946,942,942,942,20,19,18,18,1,1,3,1,4,0,0,1,1,0
731,726,726,721,17,16,18,18,3,2,1,3,5,0,5,1,-2,0
876,871,871,871,18,17,18,18,1,1,1,1,5,0,0,1,-1,0
243,234,224,220,14,14,13,13,3,3,2,3,9,10,4,0,1,0
853,862,857,857,14,17,15,16,4,1,1,1,-9,5,0,-3,2,-1
571,562,562,562,18,19,18,18,1,2,2,1,9,0,0,-1,1,0
309,304,304,300,14,17,15,16,6,2,1,2,5,0,4,-3,2,-1
1021,1017,1017,1017,20,19,20,21,1,1,1,1,4,0,0,1,-1,-1
201,192,192,187,18,19,18,19,1,1,1,2,9,0,5,-1,1,-1
290,286,281,281,18,17,18,16,2,1,1,2,4,5,0,1,-1,2
337,323,323,328,13,14,15,13,2,1,2,1,14,0,-5,-1,-1,2
192,192,1078,187,21,19,20,19,3,1,1,1,0,-886,891,2,-1,1
318,314,314,309,14,14,15,13,3,2,2,3,4,0,5,0,-1,2
417,417,417,412,13,16,15,16,3,4,2,1,0,0,5,-3,1,-1
815,810,810,815,21,19,20,21,1,3,1,1,5,0,-5,2,-1,-1
1050,1045,1045,1045,20,19,20,18,1,1,1,1,5,0,0,1,-1,2
384,374,370,412,20,19,20,18,3,1,3,1,10,4,-42,1,-1,2
1036,1031,1026,1026,17,19,18,18,1,3,1,1,5,5,0,-2,1,0
346,332,337,332,13,14,12,13,3,2,1,2,14,-5,5,-1,2,-1
1050,1045,1050,1045,20,19,20,18,1,1,1,2,5,-5,5,1,-1,2
1017,1012,1017,1012,17,16,18,18,3,1,1,2,5,-5,5,1,-2,0
459,459,459,506,13,14,12,13,2,3,1,2,0,0,-47,-1,2,-1
426,426,426,421,17,16,18,18,1,2,3,2,0,0,5,1,-2,0
374,370,365,365,17,16,15,16,3,1,6,3,4,5,0,1,1,-1
1012,1012,1017,1021,20,19,20,18,3,2,3,1,0,-5,-4,1,-1,2
876,871,876,876,14,14,13,13,3,4,2,3,5,-5,0,0,1,0
932,937,937,932,13,14,15,13,1,2,1,2,-5,0,5,-1,-1,2
243,239,239,234,14,14,15,16,1,2,1,2,4,0,5,0,-1,-1
529,520,520,524,18,17,18,16,1,2,1,3,9,0,-4,1,-1,2
501,496,501,515,18,17,18,19,2,2,1,3,5,-5,-14,1,-1,-1
918,914,914,914,21,19,21,21,1,1,1,1,4,0,0,2,-2,0
764,759,754,750,20,19,20,18,2,1,1,2,5,5,4,1,-1,2
253,248,248,243,18,19,18,18,3,1,2,3,5,0,5,-1,1,0
276,271,271,271,14,14,13,13,1,1,1,3,5,0,0,0,1,0
412,403,407,403,17,19,18,18,2,2,2,1,9,-4,4,-2,1,0
848,848,853,848,14,14,13,13,3,3,2,2,0,-5,5,0,1,0
848,834,834,834,14,14,13,13,1,2,1,3,14,0,0,0,1,0
665,665,665,660,13,14,15,16,1,3,2,1,0,0,5,-1,-1,-1
721,712,707,712,17,16,18,18,2,1,1,1,9,5,-5,1,-2,0
323,318,318,314,18,17,18,16,1,3,1,2,5,0,4,1,-1,2
534,520,510,951,14,14,13,9,1,2,3,1,14,10,-441,0,1,4
764,759,759,768,17,16,18,16,3,2,1,1,5,0,-9,1,-2,2
431,421,421,421,13,14,12,13,1,3,1,1,10,0,0,-1,2,-1
496,482,482,482,14,14,13,13,3,1,1,1,14,0,0,0,1,0
778,773,773,773,20,19,20,18,2,1,1,2,5,0,0,1,-1,2
815,820,815,810,18,17,18,16,2,1,2,2,-5,5,5,1,-1,2
703,707,698,698,13,14,12,13,1,3,3,2,-4,9,0,-1,2,-1
520,510,506,510,18,19,18,19,1,3,1,2,10,4,-4,-1,1,-1
651,642,642,637,17,16,18,18,2,1,2,2,9,0,5,1,-2,0
759,759,764,764,13,14,12,13,1,3,1,3,0,-5,0,-1,2,-1
1026,1026,1017,1021,17,16,18,18,2,1,5,2,0,9,-4,1,-2,0
196,192,192,187,18,17,18,16,1,2,3,1,4,0,5,1,-1,2
604,595,590,586,18,17,18,19,3,3,3,3,9,5,4,1,-1,-1
736,726,726,721,17,16,15,16,2,2,2,1,10,0,5,1,1,-1
342,332,332,323,20,19,20,19,1,2,1,2,10,0,9,1,-1,1
656,651,651,642,13,16,15,16,1,2,3,2,5,0,9,-3,1,-1
974,970,965,970,13,14,15,13,2,2,1,1,4,5,-5,-1,-1,2
557,539,539,539,14,14,13,13,1,1,2,1,18,0,0,0,1,0
389,389,389,389,13,14,12,13,1,1,1,3,0,0,0,-1,2,-1
253,248,253,243,14,14,15,13,2,1,1,3,5,-5,10,0,-1,2
665,665,670,660,17,16,18,18,1,2,4,1,0,-5,10,1,-2,0
656,646,651,646,17,16,18,18,2,2,2,1,10,-5,5,1,-2,0
1045,1036,1040,1040,13,14,12,13,2,3,2,1,9,-4,0,-1,2,-1
318,309,309,304,21,19,21,19,1,2,1,2,9,0,5,2,-2,2
318,318,318,314,14,14,15,16,1,2,2,2,0,0,4,0,-1,-1
562,557,557,557,18,19,18,18,3,2,5,1,5,0,0,-1,1,0
473,468,468,468,13,14,12,13,3,1,3,2,5,0,0,-1,2,-1
234,224,224,229,18,17,18,19,1,1,1,3,10,0,-5,1,-1,-1
862,857,857,862,18,19,18,18,2,2,3,1,5,0,-5,-1,1,0
389,834,389,393,20,17,20,21,2,1,2,3,-445,445,-4,3,-3,-1
450,454,445,445,13,14,12,13,3,1,2,3,-4,9,0,-1,2,-1
951,946,946,951,20,19,20,18,3,1,1,1,5,0,-5,1,-1,2
871,867,862,862,21,19,20,18,1,1,1,4,4,5,0,2,-1,2
895,890,890,886,18,17,18,16,3,1,2,2,5,0,4,1,-1,2
759,750,745,745,13,16,15,16,3,2,2,1,9,5,0,-3,1,-1
787,773,778,782,14,16,15,16,1,1,1,1,14,-5,-4,-2,1,-1
914,904,904,909,14,14,15,13,2,1,1,1,10,0,-5,0,-1,2
403,398,403,398,17,16,18,18,3,1,1,2,5,-5,5,1,-2,0
510,506,501,496,14,14,15,16,3,3,2,2,4,5,5,0,-1,-1
196,192,192,192,18,19,18,19,1,1,3,1,4,0,0,-1,1,-1
398,384,389,389,20,19,20,21,1,1,1,2,14,-5,0,1,-1,-1
628,614,614,618,18,17,18,19,1,2,3,1,14,0,-4,1,-1,-1
478,473,473,468,17,16,15,16,2,1,1,2,5,0,5,1,1,-1
267,267,267,267,18,19,18,18,1,2,1,2,0,0,0,-1,1,0
351,346,351,346,17,16,18,18,2,1,2,2,5,-5,5,1,-2,0
909,904,904,900,18,17,18,19,1,2,2,2,5,0,4,1,-1,-1
510,506,496,492,14,14,15,13,4,3,1,2,4,10,4,0,-1,2
557,553,553,548,14,14,13,13,3,2,2,2,4,0,5,0,1,0
993,998,998,989,17,16,18,16,3,1,1,2,-5,0,9,1,-2,2
960,956,998,951,13,14,12,13,3,3,1,1,4,-42,47,-1,2,-1
960,960,956,956,20,19,20,21,1,3,1,1,0,4,0,1,-1,-1
557,557,548,548,18,17,18,16,2,3,1,3,0,9,0,1,-1,2
843,829,824,824,21,19,18,19,1,1,1,1,14,5,0,2,1,-1
440,436,431,431,17,16,18,16,2,2,3,3,4,5,0,1,-2,2
1007,1003,998,998,13,14,15,13,2,3,1,2,4,5,0,-1,-1,2
717,707,707,703,13,14,12,13,2,4,2,1,10,0,4,-1,2,-1
703,707,707,707,17,16,18,18,5,3,2,1,-4,0,0,1,-2,0
717,707,712,707,13,14,12,13,1,2,2,2,10,-5,5,-1,2,-1
731,731,731,726,13,16,15,16,1,2,3,1,0,0,5,-3,1,-1
440,431,421,426,13,14,12,13,2,3,1,1,9,10,-5,-1,2,-1
595,590,586,586,14,14,15,13,3,2,1,3,5,4,0,0,-1,2
501,501,501,496,21,19,21,21,2,1,2,1,0,0,5,2,-2,0
374,370,370,365,13,14,15,13,2,3,2,1,4,0,5,-1,-1,2
576,567,567,562,18,19,18,18,3,1,2,1,9,0,5,-1,1,0
806,801,801,796,14,17,15,16,3,3,2,1,5,0,5,-3,2,-1
857,853,853,853,18,17,18,16,1,2,2,1,4,0,0,1,-1,2
862,853,853,853,18,17,18,16,1,2,3,2,9,0,0,1,-1,2
389,384,389,384,20,19,18,18,1,2,3,2,5,-5,5,1,1,0
1050,1040,1040,1040,13,14,15,16,3,1,2,1,10,0,0,-1,-1,-1
534,520,524,520,14,14,15,13,2,2,1,1,14,-4,4,0,-1,2
473,468,468,464,13,14,15,16,1,2,2,2,5,0,4,-1,-1,-1
445,445,440,431,13,14,12,13,2,1,2,2,0,5,9,-1,2,-1
496,496,496,492,18,19,18,19,1,1,2,1,0,0,4,-1,1,-1
956,951,946,946,20,19,20,18,1,1,4,2,5,5,0,1,-1,2
876,867,862,857,14,14,15,13,2,3,1,2,9,5,5,0,-1,2
548,539,539,534,18,19,18,18,1,3,3,1,9,0,5,-1,1,0
914,914,914,914,18,19,18,19,2,3,1,3,0,0,0,-1,1,-1
1036,1026,1021,1017,17,19,18,18,1,1,2,1,10,5,4,-2,1,0
876,876,871,871,14,14,15,13,1,3,2,2,0,5,0,0,-1,2
318,314,314,314,21,19,21,19,2,1,1,3,4,0,0,2,-2,2
220,215,215,215,14,14,15,16,1,1,1,3,5,0,0,0,-1,-1
787,787,787,787,14,14,13,13,3,1,2,1,0,0,0,0,1,0
595,590,590,590,21,19,20,21,1,1,2,1,5,0,0,2,-1,-1
323,314,314,309,18,17,18,19,1,2,2,2,9,0,5,1,-1,-1
529,520,520,520,14,14,13,13,3,2,3,3,9,0,0,0,1,0
276,276,271,267,21,19,20,21,2,3,1,2,0,5,4,2,-1,-1
900,890,890,890,14,14,13,13,2,2,3,3,10,0,0,0,1,0
210,192,206,206,14,17,15,16,3,1,2,4,18,-14,0,-3,2,-1
1073,1073,1068,1068,13,14,15,13,2,3,3,3,0,5,0,-1,-1,2
731,726,736,736,20,19,20,21,1,1,2,1,5,-10,0,1,-1,-1
187,187,182,182,14,14,13,13,2,1,1,2,0,5,0,0,1,0
792,787,787,787,14,14,13,13,3,1,2,1,5,0,0,0,1,0
436,421,412,417,13,14,12,13,3,3,3,2,15,9,-5,-1,2,-1
642,642,646,642,17,16,18,18,3,2,2,1,0,-4,4,1,-2,0
642,614,618,618,17,17,15,16,4,4,1,2,28,-4,0,0,2,-1
187,182,187,187,14,17,15,16,2,2,2,1,5,-5,0,-3,2,-1
656,651,646,651,13,14,15,13,3,3,1,3,5,5,-5,-1,-1,2
304,295,290,286,18,17,18,16,3,2,1,2,9,5,4,1,-1,2
810,796,801,796,18,17,18,19,3,4,2,1,14,-5,5,1,-1,-1
445,436,436,431,17,16,18,18,2,1,2,1,9,0,5,1,-2,0
553,543,543,534,14,14,13,13,1,3,2,2,10,0,9,0,1,0
876,867,867,862,14,14,15,16,1,2,5,2,9,0,5,0,-1,-1
637,623,623,628,13,14,15,13,2,2,1,1,14,0,-5,-1,-1,2
586,253,253,257,14,14,13,13,1,3,1,2,333,0,-4,0,1,0
286,281,276,276,14,14,15,13,2,2,3,2,5,5,0,0,-1,2
721,717,712,717,20,19,20,18,1,1,1,1,4,5,-5,1,-1,2
759,754,754,759,13,14,12,13,5,2,3,2,5,0,-5,-1,2,-1
796,792,796,792,14,17,15,16,1,3,1,1,4,-4,4,-3,2,-1
473,473,468,468,13,16,15,16,2,3,1,3,0,5,0,-3,1,-1
900,895,895,890,14,14,15,13,2,2,2,2,5,0,5,0,-1,2
567,562,562,557,14,17,15,16,1,1,2,2,5,0,5,-3,2,-1
365,365,365,360,13,14,12,13,2,3,2,2,0,0,5,-1,2,-1
267,253,257,257,14,17,15,16,2,2,1,2,14,-4,0,-3,2,-1
824,824,815,810,14,17,15,16,1,1,1,1,0,9,5,-3,2,-1
510,501,501,501,21,19,21,19,3,2,1,1,9,0,0,2,-2,2
384,374,370,370,17,19,18,18,2,2,1,2,10,4,0,-2,1,0
206,196,196,196,18,19,18,19,1,2,2,3,10,0,0,-1,1,-1
529,524,534,524,18,19,18,19,3,2,2,2,5,-10,10,-1,1,-1
843,839,839,839,18,17,18,16,1,3,1,1,4,0,0,1,-1,2
623,614,609,609,14,17,15,16,1,2,3,2,9,5,0,-3,2,-1
374,374,374,370,20,19,20,21,1,2,1,2,0,0,4,1,-1,-1
693,684,684,674,13,14,12,13,3,1,2,2,9,0,10,-1,2,-1
417,417,417,417,13,14,15,13,2,1,1,3,0,0,0,-1,-1,2
412,407,407,407,20,19,20,18,2,1,1,1,5,0,0,1,-1,2
1003,998,993,998,17,16,18,18,2,1,1,3,5,5,-5,1,-2,0
984,960,960,960,13,14,12,13,1,2,2,2,24,0,0,-1,2,-1
506,492,492,492,18,19,18,19,1,2,3,2,14,0,0,-1,1,-1
356,351,351,342,20,19,20,21,1,2,2,2,5,0,9,1,-1,-1
857,843,843,843,21,19,20,18,1,2,1,2,14,0,0,2,-1,2
229,220,224,224,18,17,18,19,1,2,3,1,9,-4,0,1,-1,-1
276,276,262,271,14,14,13,13,2,3,1,3,0,14,-9,0,1,0
759,754,750,754,20,19,20,21,1,2,1,1,5,4,-4,1,-1,-1
267,262,253,262,21,19,20,21,3,1,1,1,5,9,-9,2,-1,-1
534,454,459,454,14,14,15,16,1,2,2,1,80,-5,5,0,-1,-1
196,196,192,192,18,19,18,19,1,1,3,1,0,4,0,-1,1,-1
918,914,923,914,14,14,13,13,1,1,2,1,4,-9,9,0,1,0
754,750,750,750,17,16,18,18,1,2,1,1,4,0,0,1,-2,0
407,384,693,389,13,14,20,13,2,2,1,1,23,-309,304,-1,-6,7
192,187,187,182,21,19,21,21,3,2,2,1,5,0,5,2,-2,0
309,309,314,314,18,17,18,16,3,2,1,1,0,-5,0,1,-1,2
754,750,745,736,13,14,15,13,3,3,1,1,4,5,9,-1,-1,2
506,501,496,496,18,17,18,19,1,3,2,2,5,5,0,1,-1,-1
281,271,271,276,18,17,18,18,2,1,1,1,10,0,-5,1,-1,0
262,257,248,248,18,17,18,18,1,1,1,1,5,9,0,1,-1,0
234,220,224,215,14,17,15,16,1,2,2,2,14,-4,9,-3,2,-1
867,862,862,862,18,19,18,18,2,1,3,2,5,0,0,-1,1,0
342,332,332,332,17,16,15,16,1,2,1,1,10,0,0,1,1,-1
595,595,398,595,21,19,20,19,2,1,1,2,0,197,-197,2,-1,1
360,346,346,351,13,14,12,13,3,2,1,1,14,0,-5,-1,2,-1
1036,1031,1021,1026,20,19,20,18,2,3,3,1,5,10,-5,1,-1,2
224,220,234,239,21,19,20,21,1,2,1,1,4,-14,-5,2,-1,-1
356,346,351,346,20,19,18,18,1,1,1,2,10,-5,5,1,1,0
323,314,314,314,14,17,15,16,1,3,1,1,9,0,0,-3,2,-1
309,304,304,304,21,19,20,19,1,3,3,1,5,0,0,2,-1,1
314,314,314,314,18,17,18,19,2,1,5,1,0,0,0,1,-1,-1
1064,1054,1054,1054,17,16,18,16,4,2,2,1,10,0,0,1,-2,2
351,351,346,346,17,16,15,16,2,1,1,1,0,5,0,1,1,-1
192,187,192,192,21,19,21,21,1,2,1,1,5,-5,0,2,-2,0
824,810,810,806,14,14,15,16,1,1,1,1,14,0,4,0,-1,-1
243,234,239,234,21,19,20,21,1,3,2,1,9,-5,5,2,-1,-1
576,576,576,576,18,19,18,18,4,1,3,1,0,0,0,-1,1,0
567,557,557,557,18,17,15,16,3,2,1,1,10,0,0,1,2,-1
946,951,946,946,20,19,18,18,1,1,2,1,-5,5,0,1,1,0
337,328,318,318,17,17,18,19,2,1,1,2,9,10,0,0,-1,-1
356,281,281,276,17,17,15,16,1,3,1,2,75,0,5,0,2,-1
295,286,281,281,18,19,18,19,2,2,1,1,9,5,0,-1,1,-1
520,515,510,515,18,19,20,19,2,1,1,1,5,5,-5,-1,-1,1
515,510,501,501,14,14,15,16,2,3,1,1,5,9,0,0,-1,-1
229,220,215,215,18,19,18,19,5,1,1,1,9,5,0,-1,1,-1
539,529,529,529,14,14,13,13,2,2,1,1,10,0,0,0,1,0
600,600,590,595,14,17,15,16,2,1,1,3,0,10,-5,-3,2,-1
590,586,586,586,21,19,20,19,1,2,1,1,4,0,0,2,-1,1
871,871,867,857,14,17,15,16,3,1,1,4,0,4,10,-3,2,-1
782,773,764,764,18,19,18,18,1,2,1,1,9,9,0,-1,1,0
909,773,773,773,21,19,20,21,1,3,1,3,136,0,0,2,-1,-1
351,351,346,342,13,14,12,13,2,1,3,2,0,5,4,-1,2,-1
224,220,215,215,18,17,18,19,1,1,1,1,4,5,0,1,-1,-1
412,407,407,403,17,16,18,16,3,2,6,1,5,0,4,1,-2,2
557,553,553,553,14,17,15,16,1,2,2,3,4,0,0,-3,2,-1
768,764,764,759,17,16,18,18,1,1,2,1,4,0,5,1,-2,0
220,206,210,201,18,17,18,16,1,2,2,2,14,-4,9,1,-1,2
886,876,890,881,14,14,15,13,1,2,4,3,10,-14,9,0,-1,2
993,984,989,989,13,14,15,13,3,1,2,1,9,-5,0,-1,-1,2
660,660,660,660,20,19,20,18,1,3,1,1,0,0,0,1,-1,2
1036,1026,1021,1017,13,14,12,13,1,2,1,2,10,5,4,-1,2,-1
567,562,562,557,14,14,15,13,1,1,1,2,5,0,5,0,-1,2
642,646,651,646,13,14,12,13,5,3,2,1,-4,-5,5,-1,2,-1
646,637,642,637,20,19,18,18,1,2,2,1,9,-5,5,1,1,0
679,674,674,670,20,19,20,21,3,2,1,1,5,0,4,1,-1,-1
234,229,234,229,21,19,20,21,2,2,2,2,5,-5,5,2,-1,-1
782,773,778,773,18,16,18,18,1,2,1,1,9,-5,5,2,-2,0
853,843,848,839,14,17,15,16,1,2,1,2,10,-5,9,-3,2,-1
243,234,229,229,18,17,18,19,1,3,2,1,9,5,0,1,-1,-1
581,571,567,562,14,14,15,16,1,3,3,1,10,4,5,0,-1,-1
787,782,778,773,14,14,15,13,2,2,1,2,5,4,5,0,-1,2
262,257,253,253,14,17,15,16,1,1,1,1,5,4,0,-3,2,-1
407,407,403,407,13,14,15,13,3,1,1,1,0,4,-4,-1,-1,2
1078,1064,1059,1059,13,14,12,13,2,3,1,1,14,5,0,-1,2,-1
478,487,464,459,17,17,18,18,2,1,2,1,-9,23,5,0,-1,0
843,843,839,843,18,17,18,18,2,1,1,1,0,4,-4,1,-1,0
271,267,286,267,14,14,15,16,2,4,2,2,4,-19,19,0,-1,-1
618,609,604,604,18,19,18,19,3,4,2,1,9,5,0,-1,1,-1
871,862,857,857,18,19,18,18,2,2,3,2,9,5,0,-1,1,0
370,365,360,360,13,14,15,13,1,3,1,2,5,5,0,-1,-1,2
384,379,379,379,20,19,18,18,1,3,1,1,5,0,0,1,1,0
1059,1059,1054,1059,20,19,20,21,1,1,2,3,0,5,-5,1,-1,-1
192,182,187,182,21,19,21,21,3,1,2,2,10,-5,5,2,-2,0
1017,1012,1012,1007,13,14,15,16,1,3,2,1,5,0,5,-1,-1,-1
590,571,567,571,14,17,15,16,1,1,1,1,19,4,-4,-3,2,-1
740,736,736,731,17,16,18,16,1,1,1,2,4,0,5,1,-2,2
243,239,243,239,14,17,15,16,4,2,2,1,4,-4,4,-3,2,-1
670,660,660,656,20,19,20,18,2,1,2,1,10,0,4,1,-1,2
871,862,862,857,14,17,15,16,3,1,2,4,9,0,5,-3,2,-1
782,773,768,768,21,19,20,18,1,1,1,2,9,5,0,2,-1,2
595,586,586,586,14,14,13,13,2,2,3,1,9,0,0,0,1,0
557,557,548,548,18,17,18,18,3,3,3,2,0,9,0,1,-1,0
1021,1017,1017,1017,20,19,18,18,2,2,2,2,4,0,0,1,1,0
1054,1045,1050,1050,17,16,18,18,1,2,1,1,9,-5,0,1,-2,0
412,407,407,403,20,19,20,21,1,1,3,2,5,0,4,1,-1,-1
487,487,487,487,18,19,18,19,2,3,2,2,0,0,0,-1,1,-1
670,660,656,660,17,19,18,18,2,2,3,2,10,4,-4,-2,1,0
506,501,496,492,18,17,18,19,3,1,2,1,5,5,4,1,-1,-1
393,389,384,379,17,16,15,16,3,1,2,2,4,5,5,1,1,-1
304,300,290,295,14,14,15,13,3,1,8,1,4,10,-5,0,-1,2
524,520,515,520,14,14,15,16,1,2,1,1,4,5,-5,0,-1,-1
810,796,796,792,21,19,21,21,3,2,3,2,14,0,4,2,-2,0
656,646,651,651,17,16,15,16,1,2,3,1,10,-5,0,1,1,-1
890,881,876,876,14,17,15,16,1,3,1,1,9,5,0,-3,2,-1
993,989,979,974,13,16,15,16,1,5,2,1,4,10,5,-3,1,-1
314,309,309,309,14,17,15,16,3,4,1,1,5,0,0,-3,2,-1
679,674,679,679,20,19,20,21,2,2,1,2,5,-5,0,1,-1,-1
215,215,215,215,14,17,15,16,2,1,1,3,0,0,0,-3,2,-1
351,342,332,332,13,14,15,13,1,4,1,1,9,10,0,-1,-1,2
904,895,895,895,21,19,20,19,1,4,1,2,9,0,0,2,-1,1
886,881,876,876,18,17,18,16,1,1,2,1,5,5,0,1,-1,2
196,192,187,182,21,19,21,21,1,2,2,1,4,5,5,2,-2,0
300,300,295,295,21,19,20,19,2,2,1,2,0,5,0,2,-1,1
262,262,262,262,14,14,15,13,1,2,3,3,0,0,0,0,-1,2
857,853,857,843,14,14,10,13,3,1,1,1,4,-4,14,0,4,-3
703,693,693,693,20,19,18,18,1,2,1,1,10,0,0,1,1,0
923,918,918,914,21,19,21,21,3,2,1,1,5,0,4,2,-2,0
360,356,356,360,13,16,15,16,2,2,1,3,4,0,-4,-3,1,-1
764,759,764,759,17,16,15,16,2,2,2,2,5,-5,5,1,1,-1
529,496,501,496,21,19,21,19,2,1,2,1,33,-5,5,2,-2,2
248,243,243,239,18,17,18,18,2,1,3,1,5,0,4,1,-1,0
464,464,464,459,20,19,18,18,1,1,2,1,0,0,5,1,1,0
1031,1026,1036,1026,20,19,18,18,1,2,3,3,5,-10,10,1,1,0
346,346,342,342,17,19,18,18,2,3,1,1,0,4,0,-2,1,0
370,356,351,356,17,16,15,16,2,1,1,1,14,5,-5,1,1,-1
960,956,956,956,13,14,12,13,3,2,1,1,4,0,0,-1,2,-1
726,721,721,721,20,19,20,21,1,2,1,2,5,0,0,1,-1,-1
196,192,187,187,14,17,15,16,1,2,1,2,4,5,0,-3,2,-1
1007,1003,1059,998,17,16,18,16,2,1,1,2,4,-56,61,1,-2,2
421,417,421,412,13,14,12,13,2,1,4,1,4,-4,9,-1,2,-1
942,937,937,942,17,16,15,16,1,3,1,2,5,0,-5,1,1,-1
253,248,243,243,18,17,18,18,2,2,1,1,5,5,0,1,-1,0
881,881,886,881,14,14,15,16,2,2,2,1,0,-5,5,0,-1,-1
764,754,759,754,13,14,12,13,4,1,3,1,10,-5,5,-1,2,-1
600,586,590,586,14,17,15,16,2,2,2,1,14,-4,4,-3,2,-1
698,693,689,693,17,19,18,18,2,1,1,2,5,4,-4,-2,1,0
721,717,717,717,13,16,15,16,1,2,1,2,4,0,0,-3,1,-1
623,618,618,614,18,17,18,19,2,1,2,2,5,0,4,1,-1,-1
656,651,642,642,13,14,12,13,2,1,2,3,5,9,0,-1,2,-1
801,792,787,782,14,14,15,13,2,3,2,2,9,5,5,0,-1,2
253,239,243,243,14,17,15,16,1,3,2,1,14,-4,0,-3,2,-1
867,853,848,848,18,19,18,18,3,1,1,1,14,5,0,-1,1,0
707,698,703,703,20,19,20,18,1,3,2,2,9,-5,0,1,-1,2
1064,1050,1054,1054,17,16,18,16,2,2,1,1,14,-4,0,1,-2,2
721,712,703,703,13,14,12,13,2,2,3,1,9,9,0,-1,2,-1
224,224,243,215,14,17,15,16,2,3,1,1,0,-19,28,-3,2,-1
600,586,595,590,14,14,15,13,1,2,2,2,14,-9,5,0,-1,2
220,224,220,220,18,19,18,19,1,1,2,1,-4,4,0,-1,1,-1
281,271,267,262,18,19,18,18,1,3,2,2,10,4,5,-1,1,0
862,862,857,862,18,19,18,18,3,1,3,3,0,5,-5,-1,1,0
717,721,712,717,20,19,20,21,1,1,1,1,-4,9,-5,1,-1,-1
824,820,820,815,14,17,15,16,1,2,1,3,4,0,5,-3,2,-1
768,698,698,698,20,19,20,21,2,1,2,1,70,0,0,1,-1,-1
923,923,918,923,14,17,15,16,2,2,3,1,0,5,-5,-3,2,-1
276,721,271,267,18,19,18,18,1,1,2,1,-445,450,4,-1,1,0
506,501,506,496,14,17,15,16,3,2,2,2,5,-5,10,-3,2,-1
314,309,304,304,21,19,20,19,1,1,1,1,5,5,0,2,-1,1
937,923,928,923,17,17,15,16,2,2,1,2,14,-5,5,0,2,-1
257,248,239,234,18,19,18,18,2,2,2,2,9,9,5,-1,1,0
754,750,750,750,17,16,18,16,1,6,1,2,4,0,0,1,-2,2
365,360,356,356,13,14,15,16,1,3,1,1,5,4,0,-1,-1,-1
965,956,965,974,13,14,15,13,2,2,3,2,9,-9,-9,-1,-1,2
989,970,974,970,13,16,15,16,3,2,2,1,19,-4,4,-3,1,-1
970,965,965,965,13,16,15,16,3,1,1,2,5,0,0,-3,1,-1
914,914,914,914,14,14,15,13,1,3,2,1,0,0,0,0,-1,2
548,548,548,543,14,14,15,16,3,3,2,2,0,0,5,0,-1,-1
374,365,360,360,13,14,12,13,2,3,2,1,9,5,0,-1,2,-1
562,557,553,553,14,14,13,13,1,2,1,2,5,4,0,0,1,0
290,286,281,276,14,14,15,13,1,1,3,2,4,5,5,0,-1,2
445,445,440,440,20,19,20,21,1,3,1,2,0,5,0,1,-1,-1
281,271,276,276,14,14,15,13,1,2,2,4,10,-5,0,0,-1,2
431,426,426,421,20,19,18,18,3,3,3,1,5,0,5,1,1,0
984,974,974,970,20,19,18,18,2,2,2,1,10,0,4,1,1,0
492,492,492,496,14,14,13,13,3,1,1,1,0,0,-4,0,1,0
229,220,220,220,21,19,20,19,2,1,1,1,9,0,0,2,-1,1
928,918,923,918,21,19,21,21,1,2,1,1,10,-5,5,2,-2,0
693,520,515,515,13,17,15,16,1,2,1,1,173,5,0,-4,2,-1
257,257,253,253,14,14,13,13,3,2,1,3,0,4,0,0,1,0
346,342,332,337,13,14,13,13,1,3,1,2,4,10,-5,-1,1,0
192,192,187,182,14,14,13,13,3,1,2,2,0,5,5,0,1,0
665,665,665,665,13,14,15,13,1,2,1,2,0,0,0,-1,-1,2
843,834,834,820,14,17,15,16,1,1,2,4,9,0,14,-3,2,-1
754,754,750,745,20,19,18,18,2,1,2,1,0,4,5,1,1,0
1068,1064,1064,1059,20,19,20,21,1,3,1,2,4,0,5,1,-1,-1
210,201,201,201,14,14,13,13,1,3,1,1,9,0,0,0,1,0
717,712,717,712,20,19,18,18,1,1,3,2,5,-5,5,1,1,0
548,539,534,534,14,14,13,13,2,3,1,2,9,5,0,0,1,0
398,393,389,393,17,16,18,16,3,1,1,1,5,4,-4,1,-2,2
529,520,520,520,14,14,13,13,3,2,1,3,9,0,0,0,1,0
417,412,412,412,20,19,20,21,2,2,1,2,5,0,0,1,-1,-1
726,721,721,726,13,16,15,16,3,2,1,3,5,0,-5,-3,1,-1
857,853,857,853,21,19,20,18,2,2,2,2,4,-4,4,2,-1,2
286,281,281,286,18,17,18,19,2,1,1,1,5,0,-5,1,-1,-1
970,965,965,965,20,19,20,21,1,2,1,1,5,0,0,1,-1,-1
304,309,309,309,14,14,13,13,2,1,1,2,-5,0,0,0,1,0
618,618,618,623,14,17,15,16,2,2,3,1,0,0,-5,-3,2,-1
548,539,543,539,18,17,18,18,1,2,3,1,9,-4,4,1,-1,0
820,810,806,806,14,17,15,16,3,1,2,1,10,4,0,-3,2,-1
426,421,421,421,17,16,18,16,1,1,3,1,5,0,0,1,-2,2
796,792,787,787,18,19,18,19,1,3,1,1,4,5,0,-1,1,-1
543,539,543,543,21,19,20,18,1,2,2,3,4,-4,0,2,-1,2
679,679,679,674,13,14,15,13,1,3,3,2,0,0,5,-1,-1,2
848,843,839,839,18,17,18,18,1,1,1,2,5,4,0,1,-1,0
979,974,974,970,17,16,15,16,3,1,3,1,5,0,4,1,1,-1
965,965,960,960,17,16,18,16,1,1,1,2,0,5,0,1,-2,2
754,754,750,750,13,14,15,13,3,3,3,2,0,4,0,-1,-1,2
787,787,787,787,18,19,18,19,2,2,3,1,0,0,0,-1,1,-1
595,586,590,586,14,17,15,16,1,1,2,3,9,-4,4,-3,2,-1
281,276,276,276,18,19,18,18,1,2,6,1,5,0,0,-1,1,0
182,1073,1073,1073,14,14,15,13,2,1,2,2,-891,0,0,0,-1,2
224,220,224,215,14,17,15,16,3,2,3,2,4,-4,9,-3,2,-1
300,300,524,300,14,14,10,13,3,2,1,1,0,-224,224,0,4,-3
487,482,478,473,14,17,15,16,3,1,1,2,5,4,5,-3,2,-1
529,520,524,524,18,19,18,19,1,1,2,1,9,-4,0,-1,1,-1
224,220,215,215,18,19,18,19,2,1,1,1,4,5,0,-1,1,-1
665,665,665,665,20,19,20,21,3,2,2,3,0,0,0,1,-1,-1
562,557,557,557,14,17,10,16,1,2,1,2,5,0,0,-3,7,-6
726,721,721,721,13,14,12,13,3,1,2,1,5,0,0,-1,2,-1
586,576,571,571,14,17,15,16,2,1,1,1,10,5,0,-3,2,-1
314,304,300,300,18,17,18,16,2,1,2,2,10,4,0,1,-1,2
754,754,754,754,13,14,15,16,3,3,2,1,0,0,0,-1,-1,-1
1012,1007,1003,1003,17,16,15,16,2,1,1,1,5,4,0,1,1,-1
764,759,759,754,17,16,18,18,1,1,2,1,5,0,5,1,-2,0
848,839,839,839,18,17,18,16,2,2,3,2,9,0,0,1,-1,2
403,374,379,370,17,16,15,16,1,3,2,2,29,-5,9,1,1,-1
698,684,674,665,13,14,15,13,3,4,3,3,14,10,9,-1,-1,2
895,886,890,895,14,17,15,16,2,1,2,2,9,-4,-5,-3,2,-1
824,820,815,820,21,19,20,21,1,4,1,1,4,5,-5,2,-1,-1
632,632,623,618,13,14,13,13,1,1,2,2,0,9,5,-1,1,0
548,548,548,543,18,17,18,16,2,1,1,2,0,0,5,1,-1,2
365,360,360,360,20,19,18,18,2,2,3,1,5,0,0,1,1,0
576,576,571,567,18,17,18,18,1,4,2,2,0,5,4,1,-1,0
754,750,750,750,17,19,18,18,2,1,2,1,4,0,0,-2,1,0
360,356,360,360,20,19,20,21,3,2,3,1,4,-4,0,1,-1,-1
365,365,365,365,17,19,18,18,3,1,2,1,0,0,0,-2,1,0
806,801,792,787,14,14,15,13,3,3,1,2,5,9,5,0,-1,2
890,886,890,890,14,14,13,13,5,2,2,1,4,-4,0,0,1,0
824,820,815,815,14,17,15,16,1,1,1,3,4,5,0,-3,2,-1
426,426,421,421,17,16,18,18,1,1,1,2,0,5,0,1,-2,0
684,684,674,674,13,14,15,13,1,1,1,2,0,10,0,-1,-1,2
421,421,417,417,20,19,20,21,2,3,1,1,0,4,0,1,-1,-1
918,914,914,914,18,19,18,19,1,1,3,1,4,0,0,-1,1,-1
562,557,562,557,21,19,20,18,3,4,2,1,5,-5,5,2,-1,2
407,407,412,412,17,19,18,18,1,2,2,1,0,-5,0,-2,1,0
187,182,1078,1073,14,14,15,13,1,2,1,2,5,-896,5,0,-1,2
524,515,717,515,14,17,15,16,2,2,1,3,9,-202,202,-3,2,-1
810,810,810,810,18,17,18,19,2,3,1,1,0,0,0,1,-1,-1
759,759,759,754,20,19,20,18,1,1,1,1,0,0,5,1,-1,2
609,496,510,515,21,19,20,19,1,2,2,1,113,-14,-5,2,-1,1
942,942,937,942,13,14,15,13,2,3,1,3,0,5,-5,-1,-1,2
857,853,853,848,14,17,15,16,2,2,2,2,4,0,5,-3,2,-1
342,337,342,342,13,14,15,13,1,2,1,2,5,-5,0,-1,-1,2
843,843,839,834,21,19,20,21,3,3,2,1,0,4,5,2,-1,-1
210,206,201,201,21,19,21,21,1,2,1,2,4,5,0,2,-2,0
750,736,740,740,13,14,15,13,7,3,1,3,14,-4,0,-1,-1,2
1036,1036,1031,1031,20,19,18,18,1,1,1,1,0,5,0,1,1,0
243,239,234,229,14,17,15,16,1,3,3,2,4,5,5,-3,2,-1
703,698,698,698,20,19,20,18,3,3,1,1,5,0,0,1,-1,2
581,581,576,576,14,14,13,13,2,1,1,1,0,5,0,0,1,0
478,473,468,468,13,14,12,13,2,3,1,1,5,5,0,-1,2,-1
1078,1068,1068,1068,20,19,18,18,1,1,1,1,10,0,0,1,1,0
1031,1031,1031,1031,13,14,12,13,1,3,2,1,0,0,0,-1,2,-1
1012,1007,1003,1007,13,14,12,13,2,3,1,1,5,4,-4,-1,2,-1
970,965,965,965,20,19,20,21,1,2,1,3,5,0,0,1,-1,-1
543,539,539,534,18,19,18,18,2,1,2,3,4,0,5,-1,1,0
886,881,881,881,14,17,15,16,1,2,1,2,5,0,0,-3,2,-1
684,674,679,679,20,19,20,18,1,2,2,3,10,-5,0,1,-1,2
857,853,867,853,14,14,15,16,3,2,2,2,4,-14,14,0,-1,-1
600,595,590,590,18,19,18,19,1,1,1,2,5,5,0,-1,1,-1
773,768,768,768,20,19,20,21,1,2,3,2,5,0,0,1,-1,-1
262,257,253,257,18,17,18,18,2,1,1,1,5,4,-4,1,-1,0
586,581,571,581,14,14,13,13,2,3,5,1,5,10,-10,0,1,0
206,201,196,196,14,14,15,13,2,3,3,2,5,5,0,0,-1,2
778,773,764,764,20,19,20,21,1,1,1,2,5,9,0,1,-1,-1
726,721,726,726,17,16,15,16,2,5,1,1,5,-5,0,1,1,-1
492,487,487,482,14,14,13,13,1,2,2,1,5,0,5,0,1,0
646,646,642,646,17,16,18,16,1,1,1,2,0,4,-4,1,-2,2
862,862,857,857,18,19,18,18,2,1,2,1,0,5,0,-1,1,0
524,524,520,515,21,19,20,19,2,1,1,1,0,4,5,2,-1,1
960,951,956,956,13,14,12,13,1,2,1,1,9,-5,0,-1,2,-1
806,806,806,801,18,19,18,19,1,3,1,1,0,0,5,-1,1,-1
581,567,576,571,14,14,15,16,1,2,2,4,14,-9,5,0,-1,-1
482,473,478,473,21,19,20,18,2,2,1,1,9,-5,5,2,-1,2
792,787,792,787,21,19,21,19,3,2,2,2,5,-5,5,2,-2,2
942,932,928,923,13,14,15,13,2,2,1,2,10,4,5,-1,-1,2
923,923,923,923,14,17,15,16,2,1,1,1,0,0,0,-3,2,-1
571,567,562,567,14,14,15,13,2,3,2,3,4,5,-5,0,-1,2
904,895,904,914,14,14,15,13,3,3,3,1,9,-9,-10,0,-1,2
839,839,839,839,14,14,15,13,1,3,4,3,0,0,0,0,-1,2
684,618,632,632,13,17,15,16,1,2,1,2,66,-14,0,-4,2,-1
271,271,267,267,18,19,18,18,1,3,1,1,0,4,0,-1,1,0
524,520,520,520,18,19,18,19,1,5,1,1,4,0,0,-1,1,-1
801,792,792,792,14,14,13,13,2,2,3,2,9,0,0,0,1,0
754,745,745,740,17,16,15,16,3,2,2,1,9,0,5,1,1,-1
234,229,229,224,18,19,18,19,2,2,1,2,5,0,5,-1,1,-1
524,520,520,520,18,19,20,19,1,3,1,1,4,0,0,-1,-1,1
384,379,379,374,17,16,18,18,1,3,2,1,5,0,5,1,-2,0
1036,1036,1036,1031,13,14,12,13,1,2,2,2,0,0,5,-1,2,-1
295,276,262,262,18,17,18,16,3,3,1,3,19,14,0,1,-1,2
431,426,426,421,20,19,18,18,2,2,2,2,5,0,5,1,1,0
323,309,309,304,14,14,13,13,1,1,2,3,14,0,5,0,1,0
370,365,370,365,20,19,20,21,1,2,2,1,5,-5,5,1,-1,-1
468,464,464,464,20,19,20,21,4,2,2,3,4,0,0,1,-1,-1
618,618,614,614,21,19,21,21,2,1,1,1,0,4,0,2,-2,0
304,309,300,314,14,14,15,16,2,2,2,1,-5,9,-14,0,-1,-1
759,759,759,764,17,16,15,16,2,4,1,1,0,0,-5,1,1,-1
248,248,248,243,14,14,13,13,2,2,1,2,0,0,5,0,1,0
229,229,224,224,21,19,20,21,3,1,1,2,0,5,0,2,-1,-1
393,393,379,379,17,16,18,18,2,3,1,3,0,14,0,1,-2,0
337,337,337,337,13,14,15,16,1,4,1,1,0,0,0,-1,-1,-1
581,571,567,576,14,14,13,13,1,2,1,1,10,4,-9,0,1,0
206,201,196,201,14,14,15,13,2,1,3,1,5,5,-5,0,-1,2
590,590,590,586,14,17,15,16,3,3,3,3,0,0,4,-3,2,-1
956,951,960,951,17,16,18,16,1,2,3,2,5,-9,9,1,-2,2
271,262,262,257,14,17,15,16,2,2,2,2,9,0,5,-3,2,-1
932,932,928,923,17,16,15,16,1,1,1,2,0,4,5,1,1,-1
403,393,393,393,13,14,15,13,2,1,1,1,10,0,0,-1,-1,2
342,342,342,337,17,16,15,16,2,2,1,1,0,0,5,1,1,-1
651,651,646,646,20,19,20,18,1,1,1,2,0,5,0,1,-1,2
328,328,328,323,14,14,13,13,1,1,1,2,0,0,5,0,1,0
337,323,328,323,20,19,21,21,2,2,2,1,14,-5,5,1,-2,0
1045,1036,1045,1045,13,14,12,13,2,2,2,1,9,-9,0,-1,2,-1
942,937,937,937,13,14,15,13,2,3,1,1,5,0,0,-1,-1,2
370,365,365,370,20,19,20,18,3,1,1,1,5,0,-5,1,-1,2
890,881,886,886,18,19,18,19,3,2,2,3,9,-5,0,-1,1,-1
674,679,679,674,13,16,15,16,2,1,1,2,-5,0,5,-3,1,-1
201,196,196,192,14,17,15,16,2,2,1,2,5,0,4,-3,2,-1
487,487,487,487,14,14,15,16,2,1,2,1,0,0,0,0,-1,-1
426,421,426,421,20,19,20,18,3,1,2,1,5,-5,5,1,-1,2
693,689,679,679,13,14,15,13,2,1,1,2,4,10,0,-1,-1,2
614,604,604,604,18,17,18,19,1,4,3,1,10,0,0,1,-1,-1
539,534,534,534,18,17,18,16,2,2,2,3,5,0,0,1,-1,2
567,557,557,553,18,19,20,18,1,1,1,1,10,0,4,-1,-1,2
487,482,478,473,14,14,15,13,3,1,1,2,5,4,5,0,-1,2
787,778,773,768,14,16,15,16,3,1,2,2,9,5,5,-2,1,-1
867,862,862,862,18,19,18,18,2,3,3,1,5,0,0,-1,1,0
417,412,412,407,17,16,18,18,3,2,2,1,5,0,5,1,-2,0
1031,1026,1021,1021,20,19,20,18,2,3,1,1,5,5,0,1,-1,2
337,328,351,360,17,19,18,18,2,1,2,1,9,-23,-9,-2,1,0
229,224,220,220,18,17,18,19,1,1,1,1,5,4,0,1,-1,-1
918,904,900,900,21,19,20,19,1,2,2,1,14,4,0,2,-1,1
318,309,314,318,14,14,13,13,1,1,1,1,9,-5,-4,0,1,0
314,304,304,300,21,19,20,21,1,2,1,2,10,0,4,2,-1,-1
393,384,384,379,20,19,20,21,2,2,1,2,9,0,5,1,-1,-1
286,276,276,276,14,14,15,13,3,2,2,1,10,0,0,0,-1,2
1073,1064,1059,1054,13,14,12,13,2,3,1,2,9,5,5,-1,2,-1
942,928,932,923,13,14,15,13,2,1,1,1,14,-4,9,-1,-1,2
1054,1050,1050,1050,17,16,18,16,1,1,3,3,4,0,0,1,-2,2
417,412,412,407,17,16,18,18,2,1,3,1,5,0,5,1,-2,0
581,576,576,576,18,19,18,18,1,2,1,1,5,0,0,-1,1,0
215,215,210,215,14,17,15,16,2,2,3,1,0,5,-5,-3,2,-1
239,234,229,229,14,14,15,13,4,4,1,1,5,5,0,0,-1,2
721,712,707,707,13,14,15,13,1,2,1,1,9,5,0,-1,-1,2
196,187,187,187,21,19,21,19,1,1,1,1,9,0,0,2,-2,2
1012,1012,1012,1007,20,19,20,21,1,3,1,1,0,0,5,1,-1,-1
1012,1007,1007,1007,17,16,18,18,2,1,1,3,5,0,0,1,-2,0
1068,1064,1064,1059,17,16,15,16,1,1,1,1,4,0,5,1,1,-1
881,867,848,843,18,17,18,18,1,1,1,1,14,19,5,1,-1,0
196,182,187,182,14,17,15,16,2,1,2,2,14,-5,5,-3,2,-1
436,426,417,412,13,14,15,13,2,3,2,1,10,9,5,-1,-1,2
951,946,942,946,17,16,18,18,2,1,1,2,5,4,-4,1,-2,0
721,707,707,703,20,19,20,21,2,2,2,1,14,0,4,1,-1,-1
1031,1021,1021,1021,13,14,15,13,3,2,1,2,10,0,0,-1,-1,2
492,482,482,482,14,14,13,13,3,1,1,1,10,0,0,0,1,0
956,965,956,956,17,16,18,18,1,1,2,1,-9,9,0,1,-2,0
262,257,257,253,14,17,15,16,3,2,1,1,5,0,4,-3,2,-1
946,937,928,932,17,16,15,16,2,1,1,2,9,9,-4,1,1,-1
426,417,421,421,17,16,18,18,3,2,3,3,9,-4,0,1,-2,0
384,384,379,374,13,14,15,13,3,3,1,2,0,5,5,-1,-1,2
956,436,951,951,20,16,20,18,1,1,1,1,520,-515,0,4,-4,2
618,614,618,614,14,14,15,13,2,2,2,1,4,-4,4,0,-1,2
1045,1036,1040,1040,20,19,20,18,2,2,1,1,9,-4,0,1,-1,2
796,787,782,787,18,19,18,19,3,2,1,1,9,5,-5,-1,1,-1
393,393,389,389,17,19,18,18,2,3,1,2,0,4,0,-2,1,0
670,665,670,670,20,19,18,18,1,1,1,2,5,-5,0,1,1,0
623,614,614,618,18,17,18,19,1,1,3,1,9,0,-4,1,-1,-1
300,295,295,290,14,14,15,13,1,2,2,1,5,0,5,0,-1,2
229,224,224,220,21,19,20,21,1,1,1,2,5,0,4,2,-1,-1
548,534,529,524,14,14,15,13,2,3,2,2,14,5,5,0,-1,2
215,206,206,206,18,17,18,19,2,2,1,1,9,0,0,1,-1,-1
792,792,792,792,14,14,15,13,1,4,2,1,0,0,0,0,-1,2
937,928,928,923,13,14,13,13,2,1,1,2,9,0,5,-1,1,0
1003,993,989,989,13,14,12,13,5,2,1,3,10,4,0,-1,2,-1
773,773,773,768,13,14,15,13,1,3,1,2,0,0,5,-1,-1,2
304,300,300,295,18,17,18,19,1,2,3,2,4,0,5,1,-1,-1
440,436,609,436,17,16,21,16,3,1,1,1,4,-173,173,1,-5,5
464,459,459,454,13,14,15,16,2,3,2,2,5,0,5,-1,-1,-1
600,581,576,581,14,14,15,13,1,1,1,1,19,5,-5,0,-1,2
496,492,487,487,18,17,18,19,2,2,1,2,4,5,0,1,-1,-1
286,276,276,281,18,19,18,19,1,3,3,2,10,0,-5,-1,1,-1
1059,1059,1064,1059,17,19,18,18,3,1,2,1,0,-5,5,-2,1,0
201,196,192,196,14,17,15,16,1,2,1,1,5,4,-4,-3,2,-1
215,210,210,206,18,19,18,19,1,1,2,1,5,0,4,-1,1,-1
736,736,736,736,13,14,12,13,1,3,3,2,0,0,0,-1,2,-1
886,886,881,881,21,19,20,19,3,1,2,1,0,5,0,2,-1,1
215,206,196,206,14,14,13,13,1,3,3,4,9,10,-10,0,1,0
1021,1021,1017,1017,20,19,20,21,2,1,1,1,0,4,0,1,-1,-1
192,182,187,182,18,19,18,19,3,1,2,1,10,-5,5,-1,1,-1
524,510,520,515,14,17,15,16,3,2,1,4,14,-10,5,-3,2,-1
192,182,1073,1078,18,17,18,18,2,1,1,1,10,-891,-5,1,-1,0
496,496,496,492,14,17,15,16,1,2,3,2,0,0,4,-3,2,-1
342,337,328,323,17,19,18,19,1,1,1,2,5,9,5,-2,1,-1
262,257,257,253,18,17,18,16,4,1,2,2,5,0,4,1,-1,2
562,562,557,557,18,17,18,18,2,1,1,1,0,5,0,1,-1,0
1045,1036,1045,1036,20,19,20,21,2,2,2,1,9,-9,9,1,-1,-1
1007,998,998,998,17,16,18,16,2,2,3,1,9,0,0,1,-2,2
543,529,524,524,14,14,13,13,1,2,3,2,14,5,0,0,1,0
459,459,459,454,13,14,12,13,2,1,3,1,0,0,5,-1,2,-1
862,857,857,853,18,19,18,18,1,1,1,2,5,0,4,-1,1,0
257,257,257,257,14,14,15,13,2,2,2,3,0,0,0,0,-1,2
848,843,843,839,18,17,18,18,1,2,2,2,5,0,4,1,-1,0
773,764,764,764,13,16,15,16,1,2,1,1,9,0,0,-3,1,-1
403,389,393,398,13,14,12,13,2,3,3,3,14,-4,-5,-1,2,-1
970,965,965,965,13,14,15,16,2,2,2,3,5,0,0,-1,-1,-1
220,215,210,210,21,19,20,19,3,1,1,2,5,5,0,2,-1,1
253,243,243,243,21,19,20,21,1,1,1,1,10,0,0,2,-1,-1
210,206,206,201,21,19,20,21,1,3,1,1,4,0,5,2,-1,-1
1045,1040,1040,1040,13,14,12,13,2,3,2,1,5,0,0,-1,2,-1
1040,1036,1031,1031,13,14,15,16,2,2,5,2,4,5,0,-1,-1,-1
539,534,529,524,14,17,15,16,2,2,1,2,5,5,5,-3,2,-1
670,660,660,660,13,14,15,13,2,3,1,1,10,0,0,-1,-1,2
224,220,220,220,14,14,15,13,2,2,3,2,4,0,0,0,-1,2
989,989,989,984,17,16,15,16,1,2,2,3,0,0,5,1,1,-1
581,576,576,576,18,19,18,18,2,1,1,1,5,0,0,-1,1,0
300,295,295,295,18,19,18,19,3,1,1,1,5,0,0,-1,1,-1
506,496,496,496,18,17,18,16,3,2,1,1,10,0,0,1,-1,2
515,506,506,501,14,14,13,13,1,2,1,1,9,0,5,0,1,0
890,886,886,886,21,19,20,21,3,1,1,1,4,0,0,2,-1,-1
539,529,524,524,21,19,20,19,1,1,1,1,10,5,0,2,-1,1
267,267,271,262,14,14,15,13,1,2,2,3,0,-4,9,0,-1,2
562,557,557,557,14,17,15,16,1,1,2,1,5,0,0,-3,2,-1
286,281,271,281,18,17,15,16,1,2,2,1,5,10,-10,1,2,-1
787,782,778,773,14,14,13,13,1,2,1,2,5,4,5,0,1,0
815,937,801,801,21,16,18,19,2,1,2,2,-122,136,0,5,-2,-1
867,867,871,867,18,19,18,18,2,2,1,2,0,-4,4,-1,1,0
506,506,506,506,21,19,20,19,3,3,1,1,0,0,0,2,-1,1
848,834,839,834,14,17,15,16,4,2,2,3,14,-5,5,-3,2,-1
243,239,239,239,21,19,20,18,1,1,1,2,4,0,0,2,-1,2
637,632,637,637,17,16,18,18,3,1,2,1,5,-5,0,1,-2,0
586,581,586,581,21,19,20,19,3,3,2,2,5,-5,5,2,-1,1
196,192,182,192,14,17,15,16,2,2,1,1,4,10,-10,-3,2,-1
736,731,731,726,13,14,12,13,2,3,2,2,5,0,5,-1,2,-1
1045,1045,1045,1045,13,16,15,16,2,2,2,1,0,0,0,-3,1,-1
951,946,951,946,13,16,15,16,1,2,1,2,5,-5,5,-3,1,-1
262,248,253,248,14,17,15,16,1,2,2,1,14,-5,5,-3,2,-1
581,571,571,571,18,19,18,18,2,1,3,2,10,0,0,-1,1,0
581,876,571,571,21,17,20,21,1,1,1,3,-295,305,0,4,-3,-1
632,632,515,623,17,16,13,16,1,1,1,2,0,117,-108,1,3,-3
778,759,759,759,13,14,12,13,2,2,3,2,19,0,0,-1,2,-1
824,820,820,820,21,19,20,21,2,2,1,1,4,0,0,2,-1,-1
989,979,984,979,13,14,15,13,1,1,1,1,10,-5,5,-1,-1,2
951,942,942,937,13,16,15,16,1,3,2,2,9,0,5,-3,1,-1
276,271,271,271,14,14,15,13,1,3,3,1,5,0,0,0,-1,2
857,848,853,853,18,19,18,18,3,2,1,1,9,-5,0,-1,1,0
1007,993,993,984,13,14,12,13,2,1,2,2,14,0,9,-1,2,-1
407,398,398,393,13,14,15,13,2,2,2,1,9,0,5,-1,-1,2
1073,1073,1078,1073,17,16,18,18,1,2,2,2,0,-5,5,1,-2,0
459,459,454,454,13,14,12,13,3,3,1,1,0,5,0,-1,2,-1
323,304,314,318,18,17,18,16,3,2,1,1,19,-10,-4,1,-1,2
276,271,262,271,14,17,15,16,2,1,5,1,5,9,-9,-3,2,-1
403,393,398,393,20,19,20,21,1,2,2,2,10,-5,5,1,-1,-1
464,454,459,454,13,14,15,16,2,2,2,2,10,-5,5,-1,-1,-1
412,398,393,393,17,16,18,18,2,2,1,1,14,5,0,1,-2,0
187,192,192,182,14,14,13,13,2,1,2,2,-5,0,10,0,1,0
1036,1031,1026,1021,20,19,18,18,2,1,1,2,5,5,5,1,1,0
684,679,670,670,17,16,18,18,3,1,1,1,5,9,0,1,-2,0
206,201,196,196,14,14,15,13,2,3,1,2,5,5,0,0,-1,2
871,867,871,867,21,19,20,21,2,4,3,2,4,-4,4,2,-1,-1
210,210,206,206,14,14,15,16,3,3,3,1,0,4,0,0,-1,-1
890,886,881,881,14,14,15,13,3,3,1,1,4,5,0,0,-1,2
506,487,487,487,14,17,15,16,1,2,1,1,19,0,0,-3,2,-1
286,276,276,271,14,17,15,16,2,1,1,1,10,0,5,-3,2,-1
853,853,853,848,21,19,20,21,5,1,2,1,0,0,5,2,-1,-1
482,482,478,478,18,19,18,18,2,2,1,1,0,4,0,-1,1,0
356,351,351,351,13,14,12,13,1,4,1,1,5,0,0,-1,2,-1
646,642,646,637,13,14,15,13,1,2,2,2,4,-4,9,-1,-1,2
267,253,253,262,14,14,13,13,2,2,3,1,14,0,-9,0,1,0
670,670,665,665,20,19,20,21,3,2,1,1,0,5,0,1,-1,-1
360,356,356,351,17,16,18,18,1,1,2,2,4,0,5,1,-2,0
965,960,960,956,20,19,20,21,2,1,2,4,5,0,4,1,-1,-1
642,632,642,642,13,14,12,13,3,2,2,1,10,-10,0,-1,2,-1
300,290,286,290,18,17,18,16,1,1,1,1,10,4,-4,1,-1,2
923,918,923,918,14,17,15,16,2,1,2,3,5,-5,5,-3,2,-1
604,604,604,600,14,14,13,13,1,3,2,1,0,0,4,0,1,0
417,417,412,407,13,14,15,13,2,3,2,2,0,5,5,-1,-1,2
923,923,923,918,18,17,18,16,1,1,1,2,0,0,5,1,-1,2
436,431,436,431,13,14,12,13,1,2,2,2,5,-5,5,-1,2,-1
342,342,337,337,20,19,18,18,1,4,1,1,0,5,0,1,1,0
346,337,337,332,17,16,18,18,1,3,1,2,9,0,5,1,-2,0
881,871,867,867,14,14,13,13,2,1,1,1,10,4,0,0,1,0
656,646,651,651,20,19,20,21,1,2,1,1,10,-5,0,1,-1,-1
586,586,581,581,18,17,18,19,2,1,1,1,0,5,0,1,-1,-1
1064,1064,1064,1059,13,14,12,13,3,2,1,2,0,0,5,-1,2,-1
581,581,576,576,14,14,13,13,1,1,3,1,0,5,0,0,1,0
979,970,965,1050,13,14,12,13,3,3,4,1,9,5,-85,-1,2,-1
820,824,820,820,18,19,18,19,2,1,1,1,-4,4,0,-1,1,-1
253,253,253,248,14,14,13,13,2,1,3,1,0,0,5,0,1,0
937,932,928,928,17,16,18,19,2,1,1,1,5,4,0,1,-2,-1
196,187,1078,1073,21,19,20,18,3,1,2,1,9,-891,5,2,-1,2
243,234,239,234,14,14,13,13,3,3,3,1,9,-5,5,0,1,0
309,309,309,309,18,19,18,19,4,2,1,2,0,0,0,-1,1,-1
815,820,820,820,18,19,18,19,2,6,2,2,-5,0,0,-1,1,-1
281,271,276,276,18,19,18,18,2,2,2,1,10,-5,0,-1,1,0
300,290,286,286,14,14,13,13,1,2,3,3,10,4,0,0,1,0
604,604,604,604,14,17,15,16,2,2,1,1,0,0,0,-3,2,-1
1059,1045,1050,1045,13,14,12,13,2,1,2,1,14,-5,5,-1,2,-1
192,182,192,192,18,17,18,16,1,1,2,1,10,-10,0,1,-1,2
970,960,956,956,13,14,15,16,4,2,3,1,10,4,0,-1,-1,-1
810,806,806,806,14,14,15,13,1,3,1,1,4,0,0,0,-1,2
337,323,328,332,13,14,15,13,3,2,1,2,14,-5,-4,-1,-1,2
384,370,356,351,13,14,12,13,2,4,1,2,14,14,5,-1,2,-1
1059,1054,1059,1054,17,16,15,16,2,1,6,1,5,-5,5,1,1,-1
595,590,590,590,18,17,18,16,1,2,3,3,5,0,0,1,-1,2
571,562,567,562,14,14,15,16,1,2,3,2,9,-5,5,0,-1,-1
239,239,234,234,14,17,15,16,3,3,1,1,0,5,0,-3,2,-1
979,979,974,974,13,14,15,16,1,3,1,1,0,5,0,-1,-1,-1
693,684,679,674,13,14,15,13,1,1,2,1,9,5,5,-1,-1,2
510,501,506,501,21,19,20,21,1,2,1,1,9,-5,5,2,-1,-1
257,248,253,248,14,14,15,13,2,2,3,2,9,-5,5,0,-1,2
576,576,576,571,18,17,18,16,2,1,1,2,0,0,5,1,-1,2
918,909,918,914,18,17,18,19,1,4,2,1,9,-9,4,1,-1,-1
970,960,965,960,13,14,15,16,1,2,2,2,10,-5,5,-1,-1,-1
904,895,890,886,14,17,15,16,2,3,2,2,9,5,4,-3,2,-1
679,679,679,674,13,14,15,16,1,3,2,3,0,0,5,-1,-1,-1
754,754,745,745,17,16,18,18,1,1,3,1,0,9,0,1,-2,0
431,431,431,431,13,14,12,13,1,4,2,1,0,0,0,-1,2,-1
623,604,609,609,18,19,18,19,3,2,1,1,19,-5,0,-1,1,-1
862,857,857,857,18,17,18,18,1,2,1,3,5,0,0,1,-1,0
834,829,824,824,18,19,18,19,3,1,1,2,5,5,0,-1,1,-1
206,201,201,201,14,17,15,16,1,1,3,1,5,0,0,-3,2,-1
960,946,942,946,13,14,12,13,1,2,3,3,14,4,-4,-1,2,-1
637,632,628,623,13,14,13,13,3,2,1,3,5,4,5,-1,1,0
900,895,890,890,14,17,15,16,1,2,3,2,5,5,0,-3,2,-1
707,703,712,698,13,14,12,13,1,2,1,1,4,-9,14,-1,2,-1
656,656,651,651,20,19,20,18,3,1,1,3,0,5,0,1,-1,2
379,374,365,360,13,14,15,13,1,4,1,2,5,9,5,-1,-1,2
346,337,337,332,13,14,12,13,2,3,1,2,9,0,5,-1,2,-1
492,487,487,487,18,19,18,19,1,1,2,1,5,0,0,-1,1,-1
571,571,567,567,21,19,20,18,1,1,1,2,0,4,0,2,-1,2
820,810,810,810,14,17,15,16,2,1,2,3,10,0,0,-3,2,-1
239,239,239,234,14,14,15,13,3,4,3,1,0,0,5,0,-1,2
740,740,740,736,20,19,20,18,1,1,2,2,0,0,4,1,-1,2
431,421,421,417,17,16,18,18,2,2,1,2,10,0,4,1,-2,0
286,271,267,267,21,19,20,21,1,2,1,1,15,4,0,2,-1,-1
848,843,848,843,18,17,18,18,4,2,2,1,5,-5,5,1,-1,0
220,215,215,210,14,17,15,16,1,2,2,2,5,0,5,-3,2,-1
323,318,323,323,14,17,15,16,2,2,2,1,5,-5,0,-3,2,-1
520,515,515,510,14,14,15,13,1,1,2,1,5,0,5,0,-1,2
571,571,571,571,18,19,18,18,2,1,1,3,0,0,0,-1,1,0
440,436,440,436,17,16,18,16,3,2,2,3,4,-4,4,1,-2,2
646,637,637,642,17,16,18,18,2,3,3,1,9,0,-5,1,-2,0
998,979,974,974,13,14,15,13,2,1,1,1,19,5,0,-1,-1,2
993,993,989,993,13,16,15,16,3,2,1,1,0,4,-4,-3,1,-1
328,323,318,314,14,17,15,16,1,2,1,3,5,5,4,-3,2,-1
243,234,229,229,14,14,15,13,2,2,3,3,9,5,0,0,-1,2
309,300,295,300,18,19,18,19,1,2,1,3,9,5,-5,-1,1,-1
1059,1054,1050,1050,13,14,15,16,1,2,2,1,5,4,0,-1,-1,-1
239,234,234,234,14,14,15,16,1,2,2,1,5,0,0,0,-1,-1
379,379,374,370,13,14,12,13,2,1,2,1,0,5,4,-1,2,-1
1045,1036,1040,1045,13,14,12,13,2,2,1,3,9,-4,-5,-1,2,-1
843,839,829,829,14,14,15,13,5,3,1,3,4,10,0,0,-1,2
1003,993,989,989,13,14,15,13,1,1,2,2,10,4,0,-1,-1,2
923,914,914,909,14,17,15,16,2,1,2,3,9,0,5,-3,2,-1
300,295,295,295,21,19,20,19,3,1,1,2,5,0,0,2,-1,1
660,642,637,632,13,14,12,13,2,5,3,2,18,5,5,-1,2,-1
586,581,586,586,21,19,20,21,4,1,1,1,5,-5,0,2,-1,-1
300,295,304,309,14,14,15,13,3,1,1,1,5,-9,-5,0,-1,2
1007,1003,1003,1003,20,19,20,21,2,3,1,2,4,0,0,1,-1,-1
403,398,403,398,17,16,18,18,1,1,2,2,5,-5,5,1,-2,0
731,726,721,721,20,19,20,21,3,2,1,3,5,5,0,1,-1,-1
210,201,201,201,14,17,15,16,3,3,1,2,9,0,0,-3,2,-1
876,876,876,871,14,14,15,16,2,2,1,2,0,0,5,0,-1,-1
342,332,337,332,13,14,12,13,1,2,2,1,10,-5,5,-1,2,-1
1012,1012,1007,1012,20,19,18,18,1,1,1,1,0,5,-5,1,1,0
407,407,403,403,13,14,15,13,1,3,3,4,0,4,0,-1,-1,2
796,787,792,792,21,19,21,19,2,3,5,2,9,-5,0,2,-2,2
965,956,956,956,13,16,15,16,2,2,3,2,9,0,0,-3,1,-1
337,337,332,332,17,16,18,18,1,2,1,1,0,5,0,1,-2,0
571,567,567,562,14,14,15,13,1,2,1,2,4,0,5,0,-1,2
487,487,581,482,14,14,15,13,3,1,1,1,0,-94,99,0,-1,2
464,459,459,459,20,19,18,18,5,2,1,1,5,0,0,1,1,0
707,703,707,703,20,19,18,18,1,2,1,2,4,-4,4,1,1,0
787,782,778,773,18,19,18,18,3,2,1,2,5,4,5,-1,1,0
506,501,501,501,21,19,21,21,3,1,1,1,5,0,0,2,-2,0
745,740,745,740,17,19,18,18,3,2,2,1,5,-5,5,-2,1,0
1017,1012,1012,1012,20,19,18,18,2,1,1,2,5,0,0,1,1,0
290,281,281,281,14,14,13,13,1,1,1,2,9,0,0,0,1,0
801,801,796,796,14,17,15,16,2,3,2,1,0,5,0,-3,2,-1
1059,1050,1054,1050,17,16,15,16,1,2,1,1,9,-4,4,1,1,-1
960,951,956,951,20,19,20,21,3,2,1,1,9,-5,5,1,-1,-1
384,374,374,370,17,16,18,18,2,3,2,3,10,0,4,1,-2,0
450,454,454,450,13,14,15,16,2,1,3,1,-4,0,4,-1,-1,-1
965,960,965,965,20,19,18,18,1,2,1,1,5,-5,0,1,1,0
600,590,590,586,18,19,18,19,1,1,2,2,10,0,4,-1,1,-1
295,290,290,290,18,17,18,19,1,2,1,1,5,0,0,1,-1,-1
796,796,796,796,21,19,21,19,1,3,1,2,0,0,0,2,-2,2
482,482,478,478,14,14,15,13,2,1,1,1,0,4,0,0,-1,2
337,337,337,337,17,19,18,18,3,3,2,3,0,0,0,-2,1,0
304,300,300,300,14,14,15,16,1,1,2,1,4,0,0,0,-1,-1
445,436,440,436,20,19,20,18,1,2,2,2,9,-4,4,1,-1,2
989,979,984,989,13,14,12,13,1,2,1,1,10,-5,-5,-1,2,-1
942,937,942,937,17,19,18,18,3,3,2,1,5,-5,5,-2,1,0
182,1078,1078,229,18,16,18,16,1,1,1,1,-896,0,849,2,-2,2
524,520,520,520,18,19,20,19,1,1,1,1,4,0,0,-1,-1,1
693,689,689,693,20,19,18,18,2,2,3,1,4,0,-4,1,1,0
712,703,698,698,13,14,15,16,2,3,3,1,9,5,0,-1,-1,-1
750,740,740,736,20,19,20,21,2,3,1,3,10,0,4,1,-1,-1
993,993,993,998,20,19,20,21,1,1,1,3,0,0,-5,1,-1,-1
721,717,721,717,17,16,15,16,4,1,1,1,4,-4,4,1,1,-1
571,562,557,557,18,19,18,18,1,2,1,1,9,5,0,-1,1,0
224,215,215,215,14,14,13,13,1,2,1,1,9,0,0,0,1,0
586,586,581,581,21,19,20,21,3,1,1,1,0,5,0,2,-1,-1
571,567,567,567,14,17,15,16,1,3,2,1,4,0,0,-3,2,-1
421,417,421,421,20,19,20,21,1,2,1,1,4,-4,0,1,-1,-1
796,796,796,792,18,17,18,16,1,3,1,1,0,0,4,1,-1,2
712,707,707,707,13,14,15,13,2,1,2,2,5,0,0,-1,-1,2
421,421,417,421,20,19,20,21,2,1,1,2,0,4,-4,1,-1,-1
196,187,187,182,14,14,13,13,1,1,2,1,9,0,5,0,1,0
431,431,426,426,20,19,20,18,1,1,3,1,0,5,0,1,-1,2
239,229,220,220,21,19,20,19,1,1,1,1,10,9,0,2,-1,1
942,932,923,928,13,14,13,13,1,1,1,1,10,9,-5,-1,1,0
431,426,426,421,17,16,18,16,1,2,2,2,5,0,5,1,-2,2
886,881,886,876,21,19,20,21,1,1,2,2,5,-5,10,2,-1,-1
623,614,604,600,14,14,15,13,3,3,1,2,9,10,4,0,-1,2
562,553,548,548,18,19,18,18,1,2,1,1,9,5,0,-1,1,0
496,492,492,487,18,19,18,19,3,1,2,2,4,0,5,-1,1,-1
328,318,328,323,14,14,13,13,1,2,2,1,10,-10,5,0,1,0
384,379,379,379,20,19,20,21,2,1,1,1,5,0,0,1,-1,-1
815,810,810,806,14,17,15,16,1,1,2,2,5,0,4,-3,2,-1
440,440,445,445,13,14,15,13,1,2,1,1,0,-5,0,-1,-1,2
243,234,234,229,18,17,18,19,1,2,2,2,9,0,5,1,-1,-1
459,454,450,450,20,19,20,21,2,1,1,1,5,4,0,1,-1,-1
309,304,304,295,14,17,15,16,1,2,4,2,5,0,9,-3,2,-1
431,421,421,421,13,16,15,16,2,2,3,1,10,0,0,-3,1,-1
286,281,281,281,14,17,15,16,1,2,1,1,5,0,0,-3,2,-1
384,374,374,370,20,19,18,18,2,2,2,2,10,0,4,1,1,0
937,937,928,923,13,16,15,16,1,2,1,2,0,9,5,-3,1,-1
581,581,581,581,14,17,15,16,2,3,1,1,0,0,0,-3,2,-1
946,942,942,942,13,14,12,13,3,2,2,3,4,0,0,-1,2,-1
712,712,712,707,17,16,15,16,1,3,2,1,0,0,5,1,1,-1
1059,215,1059,1064,13,17,15,16,3,1,1,3,844,-844,-5,-4,2,-1
534,524,520,520,18,17,18,19,1,1,1,1,10,4,0,1,-1,-1
426,417,412,792,13,14,15,11,2,3,3,1,9,5,-380,-1,-1,4
262,257,257,257,14,14,13,13,1,4,1,2,5,0,0,0,1,0
496,496,496,496,18,17,18,19,2,4,1,1,0,0,0,1,-1,-1
871,867,867,867,18,17,18,18,1,1,2,1,4,0,0,1,-1,0
1017,1012,1012,1012,13,14,15,13,3,2,3,2,5,0,0,-1,-1,2
360,356,351,351,20,19,20,21,3,3,3,2,4,5,0,1,-1,-1
267,262,262,267,14,14,15,13,1,2,1,1,5,0,-5,0,-1,2
281,267,267,271,21,19,20,18,1,1,1,3,14,0,-4,2,-1,2
843,839,839,834,14,14,15,13,2,2,2,1,4,0,5,0,-1,2
220,220,224,224,14,14,15,13,3,5,1,2,0,-4,0,0,-1,2
1040,1031,1026,1021,13,14,15,13,1,2,3,2,9,5,5,-1,-1,2
581,571,571,571,21,19,20,21,1,2,1,1,10,0,0,2,-1,-1
257,253,257,253,14,17,15,16,1,1,2,2,4,-4,4,-3,2,-1
482,473,473,473,14,14,15,13,1,2,1,1,9,0,0,0,-1,2
717,712,712,712,13,16,15,16,2,1,1,1,5,0,0,-3,1,-1
586,576,581,576,14,17,15,16,3,2,2,1,10,-5,5,-3,2,-1
337,328,328,332,17,19,18,18,2,1,1,1,9,0,-4,-2,1,0
1050,1045,1050,1045,17,16,18,18,2,2,1,1,5,-5,5,1,-2,0
464,417,417,412,20,19,20,21,1,3,2,1,47,0,5,1,-1,-1
909,895,886,876,14,17,15,16,2,4,2,1,14,9,10,-3,2,-1
1054,1054,1054,1054,20,19,20,21,1,1,3,1,0,0,0,1,-1,-1
454,450,454,454,13,16,15,16,1,1,2,2,4,-4,0,-3,1,-1
956,956,951,951,20,19,18,18,1,1,3,1,0,5,0,1,1,0
984,979,984,979,17,16,15,16,2,1,4,3,5,-5,5,1,1,-1
712,712,712,712,17,16,15,16,3,2,1,3,0,0,0,1,1,-1
614,600,600,595,14,14,15,13,1,2,2,3,14,0,5,0,-1,2
239,229,229,234,18,19,18,18,1,2,3,3,10,0,-5,-1,1,0
187,1068,1064,1045,14,16,15,13,1,2,1,3,-881,4,19,-2,1,2
510,506,501,501,14,14,13,13,1,1,3,2,4,5,0,0,1,0
773,768,768,764,20,19,18,18,2,1,2,2,5,0,4,1,1,0
815,782,787,782,14,14,15,16,2,1,2,2,33,-5,5,0,-1,-1
862,740,740,740,18,16,18,16,1,1,3,2,122,0,0,2,-2,2
984,979,979,984,13,14,15,13,1,2,2,3,5,0,-5,-1,-1,2
548,539,539,534,18,19,18,18,1,1,2,1,9,0,5,-1,1,0
286,286,286,286,18,17,18,19,2,1,2,1,0,0,0,1,-1,-1
239,239,234,229,18,19,18,19,2,1,2,2,0,5,5,-1,1,-1
543,534,534,539,14,14,15,13,1,2,1,1,9,0,-5,0,-1,2
586,571,562,557,14,14,13,13,1,3,3,1,15,9,5,0,1,0
524,515,515,515,21,19,20,21,1,1,1,3,9,0,0,2,-1,-1
243,1007,1007,1003,14,14,15,16,2,3,3,2,-764,0,4,0,-1,-1
464,464,459,454,17,16,18,18,1,1,1,1,0,5,5,1,-2,0
651,632,637,632,13,14,12,13,1,2,2,2,19,-5,5,-1,2,-1
182,182,1078,1078,21,19,20,18,2,1,1,1,0,-896,0,2,-1,2
703,689,693,689,20,19,20,18,3,2,1,2,14,-4,4,1,-1,2
356,356,346,346,17,16,18,18,2,2,3,1,0,10,0,1,-2,0
717,707,703,703,20,19,18,18,3,2,1,1,10,4,0,1,1,0
309,300,295,295,18,17,18,16,1,1,1,2,9,5,0,1,-1,2
567,553,557,557,18,17,18,18,5,1,2,1,14,-4,0,1,-1,0
440,192,192,196,13,14,13,13,1,2,1,1,248,0,-4,-1,1,0
436,431,431,431,17,16,18,18,2,2,1,1,5,0,0,1,-2,0
314,304,304,295,14,14,13,13,1,3,2,2,10,0,9,0,1,0
918,914,862,909,14,14,13,13,4,3,1,1,4,52,-47,0,1,0
829,824,829,829,14,14,15,13,6,2,3,1,5,-5,0,0,-1,2
548,548,548,543,18,19,18,18,2,1,2,1,0,0,5,-1,1,0
417,417,417,412,13,14,15,13,1,3,2,4,0,0,5,-1,-1,2
548,553,548,548,21,19,20,18,4,2,1,2,-5,5,0,2,-1,2
684,674,674,670,20,19,18,18,4,1,2,2,10,0,4,1,1,0
412,398,403,403,17,16,15,16,2,2,3,1,14,-5,0,1,1,-1
1050,1045,1045,1040,13,14,15,13,1,1,1,2,5,0,5,-1,-1,2
857,848,853,853,14,14,13,13,2,2,2,2,9,-5,0,0,1,0
220,492,192,187,14,14,15,13,1,1,1,1,-272,300,5,0,-1,2
665,660,665,665,20,19,20,21,1,1,2,3,5,-5,0,1,-1,-1
998,984,979,979,20,19,20,18,2,1,1,2,14,5,0,1,-1,2
436,426,421,431,13,14,12,13,2,3,1,1,10,5,-10,-1,2,-1
234,229,229,224,14,14,13,13,3,3,2,2,5,0,5,0,1,0
937,923,928,932,17,17,15,16,2,2,1,1,14,-5,-4,0,2,-1
712,707,703,712,17,19,18,18,2,3,3,1,5,4,-9,-2,1,0
989,989,979,979,13,16,15,16,2,1,3,1,0,10,0,-3,1,-1
768,764,764,768,13,14,15,13,1,2,1,1,4,0,-4,-1,-1,2
703,698,721,736,13,14,12,13,2,3,1,2,5,-23,-15,-1,2,-1
215,220,220,215,18,17,18,19,2,1,3,2,-5,0,5,1,-1,-1
914,909,904,904,18,19,18,19,1,1,1,2,5,5,0,-1,1,-1
736,731,731,731,20,19,20,18,2,3,1,1,5,0,0,1,-1,2
398,393,393,393,13,14,15,13,2,2,1,3,5,0,0,-1,-1,2
778,773,773,773,20,19,18,18,1,1,3,1,5,0,0,1,1,0
271,267,271,271,18,17,18,18,2,3,2,1,4,-4,0,1,-1,0
389,389,389,562,17,16,15,16,1,1,1,1,0,0,-173,1,1,-1
510,496,501,501,21,19,21,21,3,2,1,1,14,-5,0,2,-2,0
604,595,595,590,14,14,13,13,3,1,1,1,9,0,5,0,1,0
1045,1036,1036,1031,20,19,20,21,2,1,1,2,9,0,5,1,-1,-1
815,806,801,796,14,14,13,13,2,3,1,5,9,5,5,0,1,0
384,370,365,365,17,16,18,16,2,2,1,1,14,5,0,1,-2,2
665,656,660,660,13,14,12,13,1,2,2,1,9,-4,0,-1,2,-1
989,979,979,984,13,14,15,13,2,2,2,1,10,0,-5,-1,-1,2
374,374,370,374,17,16,18,18,1,3,1,1,0,4,-4,1,-2,0
712,782,712,712,13,17,15,13,3,1,1,1,-70,70,0,-4,2,2
1050,1045,1054,1050,20,19,18,18,4,2,2,1,5,-9,4,1,1,0
524,520,520,520,18,17,18,19,1,3,1,1,4,0,0,1,-1,-1
374,365,370,370,17,16,18,16,3,1,2,1,9,-5,0,1,-2,2
674,670,679,665,20,19,20,21,2,1,2,1,4,-9,14,1,-1,-1
403,403,436,398,13,14,12,13,2,3,2,2,0,-33,38,-1,2,-1
637,632,637,632,17,19,18,18,2,2,2,1,5,-5,5,-2,1,0
623,623,623,623,18,19,18,19,2,1,4,2,0,0,0,-1,1,-1
923,918,904,904,18,19,18,19,2,4,1,1,5,14,0,-1,1,-1
553,548,543,543,21,19,20,18,1,2,1,1,5,5,0,2,-1,2
445,506,501,501,20,19,18,19,1,1,1,1,-61,5,0,1,1,-1
436,318,318,318,13,17,15,16,2,1,1,1,118,0,0,-4,2,-1
623,618,623,628,18,19,18,19,1,1,1,1,5,-5,-5,-1,1,-1
1021,1017,1021,1017,17,16,18,18,2,2,2,2,4,-4,4,1,-2,0
946,942,942,937,17,16,18,16,2,1,3,2,4,0,5,1,-2,2
384,379,374,370,17,16,18,16,2,3,1,2,5,5,4,1,-2,2
824,810,820,824,18,19,18,19,1,1,2,1,14,-10,-4,-1,1,-1
848,839,834,834,18,19,18,18,2,2,2,1,9,5,0,-1,1,0
290,286,286,286,21,19,20,19,1,1,1,1,4,0,0,2,-1,1
524,515,510,510,14,14,15,13,2,2,1,2,9,5,0,0,-1,2
646,646,646,642,13,14,15,16,1,3,2,2,0,0,4,-1,-1,-1
543,539,539,534,21,19,20,21,1,3,2,1,4,0,5,2,-1,-1
421,417,417,421,17,16,15,16,3,1,2,3,4,0,-4,1,1,-1
286,271,262,257,18,19,18,18,2,3,2,1,15,9,5,-1,1,0
951,937,937,937,13,14,12,13,3,2,2,1,14,0,0,-1,2,-1
1073,1068,1073,1073,20,19,20,18,3,2,1,3,5,-5,0,1,-1,2
529,520,520,524,18,19,18,19,2,2,2,1,9,0,-4,-1,1,-1
426,417,417,417,20,19,18,18,1,3,1,3,9,0,0,1,1,0
295,290,290,286,21,19,20,21,5,2,1,1,5,0,4,2,-1,-1
984,970,970,965,13,14,12,13,2,2,2,2,14,0,5,-1,2,-1
618,623,618,614,18,17,18,16,4,3,1,1,-5,5,4,1,-1,2
234,224,239,239,21,19,20,18,2,1,2,3,10,-15,0,2,-1,2
623,618,623,618,14,14,13,13,2,5,2,2,5,-5,5,0,1,0
600,590,590,590,14,17,15,16,3,2,4,1,10,0,0,-3,2,-1
403,407,398,398,13,14,15,13,1,3,1,1,-4,9,0,-1,-1,2
1078,1078,1073,1073,17,16,15,16,1,1,2,1,0,5,0,1,1,-1
426,431,431,426,20,19,20,21,1,1,2,1,-5,0,5,1,-1,-1
454,450,450,445,17,16,18,18,1,2,3,2,4,0,5,1,-2,0
529,524,515,520,14,14,13,13,2,3,1,2,5,9,-5,0,1,0
421,421,412,417,20,19,20,18,1,2,2,1,0,9,-5,1,-1,2
276,257,257,262,14,14,13,13,1,2,1,1,19,0,-5,0,1,0
750,745,740,745,17,16,15,16,2,1,1,1,5,5,-5,1,1,-1
618,618,614,618,18,17,18,19,1,5,1,4,0,4,-4,1,-1,-1
412,393,389,384,13,14,15,16,2,3,2,2,19,4,5,-1,-1,-1
196,187,1078,1073,14,17,15,16,3,1,2,2,9,-891,5,-3,2,-1
595,590,590,586,18,17,18,16,1,3,2,1,5,0,4,1,-1,2
787,782,778,778,14,17,15,16,1,2,1,1,5,4,0,-3,2,-1
576,567,571,571,21,19,20,21,1,2,1,1,9,-4,0,2,-1,-1
974,970,965,960,17,16,15,16,2,5,1,3,4,5,5,1,1,-1
548,534,534,534,18,19,18,18,2,2,1,1,14,0,0,-1,1,0
281,281,286,281,18,17,18,19,3,3,2,1,0,-5,5,1,-1,-1
201,192,192,192,14,14,13,13,2,2,1,2,9,0,0,0,1,0
468,464,464,459,13,14,15,13,2,3,3,3,4,0,5,-1,-1,2
745,740,740,731,17,16,18,18,2,3,2,3,5,0,9,1,-2,0
829,820,815,815,21,19,20,19,3,1,1,1,9,5,0,2,-1,1
267,262,257,257,14,14,15,13,3,1,2,1,5,5,0,0,-1,2
267,271,267,267,14,14,15,13,2,1,2,1,-4,4,0,0,-1,2
1054,1054,1045,1040,13,14,15,13,2,3,1,2,0,9,5,-1,-1,2
492,487,482,487,14,17,15,16,1,2,1,1,5,5,-5,-3,2,-1
918,909,914,918,14,14,13,13,1,2,2,1,9,-5,-4,0,1,0
586,586,581,586,14,14,15,13,3,1,4,3,0,5,-5,0,-1,2
665,660,660,656,13,14,12,13,1,3,2,2,5,0,4,-1,2,-1
642,632,623,628,17,16,18,16,1,2,1,1,10,9,-5,1,-2,2
867,857,857,853,14,14,15,13,3,1,1,2,10,0,4,0,-1,2
478,473,473,473,13,16,15,16,2,1,1,3,5,0,0,-3,1,-1
187,1073,1073,1073,14,14,15,13,1,1,3,1,-886,0,0,0,-1,2
445,440,440,440,17,16,18,16,2,2,2,1,5,0,0,1,-2,2
590,586,590,581,14,17,15,16,3,1,2,2,4,-4,9,-3,2,-1
515,515,515,515,18,19,18,19,3,3,1,1,0,0,0,-1,1,-1
229,201,201,201,21,19,21,21,1,1,1,1,28,0,0,2,-2,0
478,473,478,478,20,19,20,18,1,2,1,1,5,-5,0,1,-1,2
1045,1045,1040,1040,13,14,12,13,1,2,1,2,0,5,0,-1,2,-1
346,342,346,346,20,19,20,18,1,2,2,1,4,-4,0,1,-1,2
853,848,848,848,18,17,18,16,3,2,1,1,5,0,0,1,-1,2
707,703,707,689,13,14,15,13,2,2,1,2,4,-4,18,-1,-1,2
257,257,257,257,14,14,13,13,2,1,2,3,0,0,0,0,1,0
590,586,590,590,18,19,18,19,2,2,3,2,4,-4,0,-1,1,-1
548,548,548,543,18,17,18,18,2,1,2,1,0,0,5,1,-1,0
993,993,993,993,20,19,20,21,1,1,1,1,0,0,0,1,-1,-1
543,539,534,534,14,14,15,13,2,3,1,1,4,5,0,0,-1,2
379,365,346,351,13,14,12,13,1,3,1,4,14,19,-5,-1,2,-1
660,656,660,665,20,19,20,21,1,2,2,1,4,-4,-5,1,-1,-1
965,956,956,951,17,16,15,16,2,2,2,2,9,0,5,1,1,-1
487,473,468,464,14,14,12,13,1,2,3,2,14,5,4,0,2,-1
670,656,651,651,20,19,20,18,2,2,1,3,14,5,0,1,-1,2
1003,998,993,993,17,16,18,18,1,1,1,1,5,5,0,1,-2,0
342,337,332,323,20,19,20,19,1,3,1,2,5,5,9,1,-1,1
412,407,403,407,13,14,12,13,3,3,1,1,5,4,-4,-1,2,-1
623,618,614,618,14,14,15,16,3,1,1,1,5,4,-4,0,-1,-1
764,759,759,764,20,19,20,18,1,6,1,1,5,0,-5,1,-1,2
1054,1045,1050,1050,17,16,18,16,1,2,1,1,9,-5,0,1,-2,2
534,529,534,529,14,17,15,16,1,2,2,2,5,-5,5,-3,2,-1
524,506,506,496,14,14,15,13,3,2,3,2,18,0,10,0,-1,2
665,656,656,651,20,19,20,18,1,2,1,2,9,0,5,1,-1,2
632,623,623,628,20,19,21,21,1,2,1,1,9,0,-5,1,-2,0
398,393,389,389,20,19,20,21,2,1,1,1,5,4,0,1,-1,-1
960,951,956,951,13,14,15,13,2,4,1,2,9,-5,5,-1,-1,2
234,234,234,229,14,14,15,13,2,2,2,2,0,0,5,0,-1,2
506,501,501,501,21,19,21,19,3,2,1,2,5,0,0,2,-2,2
773,759,773,773,17,16,18,18,3,2,2,2,14,-14,0,1,-2,0
510,501,506,506,14,17,15,16,3,2,1,1,9,-5,0,-3,2,-1
646,637,637,632,17,16,15,16,1,3,2,1,9,0,5,1,1,-1
206,201,201,201,14,17,15,16,3,2,1,1,5,0,0,-3,2,-1
379,370,365,365,17,19,18,18,2,2,3,2,9,5,0,-2,1,0
871,867,862,862,14,14,13,13,2,3,1,1,4,5,0,0,1,0
839,829,824,824,18,19,18,19,1,1,1,1,10,5,0,-1,1,-1
824,824,824,820,14,17,15,16,4,1,1,1,0,0,4,-3,2,-1
651,637,628,623,13,14,13,13,5,2,1,1,14,9,5,-1,1,0
965,946,946,951,13,14,15,16,2,1,1,1,19,0,-5,-1,-1,-1
571,562,557,553,21,19,20,18,1,2,1,2,9,5,4,2,-1,2
998,993,984,984,17,16,15,16,2,2,1,2,5,9,0,1,1,-1
487,478,464,459,18,19,18,18,3,1,1,1,9,14,5,-1,1,0
323,323,323,318,18,17,18,16,3,1,2,1,0,0,5,1,-1,2
224,220,215,220,18,19,18,19,1,1,4,1,4,5,-5,-1,1,-1
1059,1054,1054,1054,17,16,18,18,3,2,1,1,5,0,0,1,-2,0
834,824,820,820,14,17,15,16,1,1,1,1,10,4,0,-3,2,-1
398,393,398,393,13,14,12,13,1,5,2,2,5,-5,5,-1,2,-1
914,914,918,909,21,19,21,19,4,1,2,1,0,-4,9,2,-2,2
201,196,192,196,21,19,21,19,4,3,1,1,5,4,-4,2,-2,2
787,787,787,782,21,19,21,19,2,1,1,1,0,0,5,2,-2,2
370,365,365,365,17,16,18,18,1,2,3,1,5,0,0,1,-2,0
290,267,257,253,14,14,15,13,3,2,2,2,23,10,4,0,-1,2
750,745,745,740,17,16,18,18,3,1,2,3,5,0,5,1,-2,0
801,787,834,853,18,17,18,18,1,2,1,2,14,-47,-19,1,-1,0
290,281,281,276,14,17,15,16,3,6,1,2,9,0,5,-3,2,-1
651,642,642,637,13,14,15,13,2,2,2,1,9,0,5,-1,-1,2
543,543,543,539,18,19,18,18,3,1,2,1,0,0,4,-1,1,0
778,736,731,731,13,16,15,16,2,3,1,1,42,5,0,-3,1,-1
717,712,717,726,17,19,18,18,1,2,1,3,5,-5,-9,-2,1,0
918,909,914,914,14,17,15,16,1,1,4,1,9,-5,0,-3,2,-1
707,698,698,703,20,19,20,18,2,1,1,1,9,0,-5,1,-1,2
478,468,468,464,20,19,18,18,2,3,2,1,10,0,4,1,1,0
271,262,262,267,14,14,15,13,1,2,3,1,9,0,-5,0,-1,2
960,951,942,946,20,19,18,18,2,1,3,1,9,9,-4,1,1,0
595,590,590,586,18,19,18,19,1,2,3,1,5,0,4,-1,1,-1
412,407,403,403,20,19,20,21,1,1,3,1,5,4,0,1,-1,-1
946,937,937,937,17,16,15,16,2,1,1,2,9,0,0,1,1,-1
740,736,731,731,17,16,15,16,1,2,1,2,4,5,0,1,1,-1
834,824,815,810,21,19,20,19,1,2,1,2,10,9,5,2,-1,1
196,196,196,196,18,17,18,16,2,2,1,1,0,0,0,1,-1,2
379,374,374,374,20,19,18,18,1,2,1,1,5,0,0,1,1,0
553,548,553,548,18,17,18,18,2,1,1,1,5,-5,5,1,-1,0
679,679,679,679,13,14,12,13,2,1,2,1,0,0,0,-1,2,-1
773,764,764,768,13,14,15,13,2,3,3,3,9,0,-4,-1,-1,2
787,778,773,773,21,19,20,18,3,1,2,1,9,5,0,2,-1,2
201,206,206,201,14,14,13,13,2,1,2,2,-5,0,5,0,1,0
829,820,820,824,18,17,18,16,1,2,1,5,9,0,-4,1,-1,2
886,886,881,881,14,14,15,13,2,1,1,1,0,5,0,0,-1,2
365,360,356,356,13,14,12,13,2,3,1,1,5,4,0,-1,2,-1
651,642,642,637,20,19,20,21,2,1,1,3,9,0,5,1,-1,-1
562,553,548,543,14,14,15,13,1,3,2,3,9,5,5,0,-1,2
492,487,487,492,18,17,18,19,3,2,1,3,5,0,-5,1,-1,-1
389,379,370,360,20,19,20,18,3,2,2,2,10,9,10,1,-1,2
290,281,281,281,14,17,15,16,3,1,2,2,9,0,0,-3,2,-1
557,548,548,548,14,17,15,16,3,3,1,3,9,0,0,-3,2,-1
553,553,548,548,18,17,18,18,3,3,2,1,0,5,0,1,-1,0
871,871,871,867,14,17,15,16,2,2,1,2,0,0,4,-3,2,-1
496,492,492,496,18,17,18,19,2,2,1,1,4,0,-4,1,-1,-1
271,276,304,276,14,14,15,13,1,3,1,3,-5,-28,28,0,-1,2
229,229,224,224,18,19,18,19,4,1,3,1,0,5,0,-1,1,-1
539,539,539,534,14,14,13,13,1,3,2,2,0,0,5,0,1,0
370,360,365,360,20,19,20,18,1,6,2,1,10,-5,5,1,-1,2
403,398,398,393,17,19,18,18,2,3,1,1,5,0,5,-2,1,0
360,356,360,356,13,14,15,16,1,2,2,3,4,-4,4,-1,-1,-1
229,215,215,220,18,19,18,19,2,3,1,2,14,0,-5,-1,1,-1
1012,1007,1007,1012,20,19,20,18,3,2,1,1,5,0,-5,1,-1,2
393,384,389,384,20,19,20,21,2,2,2,1,9,-5,5,1,-1,-1
886,876,871,876,14,14,13,13,3,3,3,1,10,5,-5,0,1,0
1017,1012,1012,1007,20,19,20,21,2,1,2,3,5,0,5,1,-1,-1
839,839,834,834,14,17,15,16,1,1,2,1,0,5,0,-3,2,-1
853,834,829,829,18,19,18,19,3,1,3,1,19,5,0,-1,1,-1
674,665,656,651,13,14,12,13,1,5,1,1,9,9,5,-1,2,-1
360,351,351,351,13,14,15,13,1,2,1,1,9,0,0,-1,-1,2
923,918,918,914,18,17,18,16,3,2,1,2,5,0,4,1,-1,2
515,506,506,506,14,17,15,16,2,1,1,3,9,0,0,-3,2,-1
820,815,810,810,18,17,18,16,1,1,1,2,5,5,0,1,-1,2
918,909,900,900,21,19,20,19,2,1,1,1,9,9,0,2,-1,1
318,323,323,323,14,17,15,16,2,2,3,2,-5,0,0,-3,2,-1
881,876,881,876,14,17,15,16,2,2,2,1,5,-5,5,-3,2,-1
843,839,829,824,14,14,15,13,3,2,2,2,4,10,5,0,-1,2
656,656,646,656,20,19,18,18,1,1,3,1,0,10,-10,1,1,0
946,942,946,942,20,19,18,18,2,2,1,1,4,-4,4,1,1,0
618,614,614,614,18,19,18,19,1,2,3,3,4,0,0,-1,1,-1
1073,1068,1064,1059,13,14,12,13,2,3,2,6,5,4,5,-1,2,-1
1036,1036,1021,1026,13,14,12,13,2,2,1,2,0,15,-5,-1,2,-1
529,529,529,520,14,14,13,13,2,2,2,2,0,0,9,0,1,0
712,707,707,707,17,19,18,18,1,1,1,1,5,0,0,-2,1,0
473,473,473,468,20,19,18,18,3,1,2,2,0,0,5,1,1,0
750,740,745,745,20,19,20,18,2,1,1,1,10,-5,0,1,-1,2
286,290,290,286,14,14,15,13,2,3,4,2,-4,0,4,0,-1,2
806,796,787,787,18,19,18,19,3,1,2,2,10,9,0,-1,1,-1
1021,1021,1017,1017,13,16,15,16,3,1,1,1,0,4,0,-3,1,-1
506,501,506,501,18,19,18,19,2,3,1,3,5,-5,5,-1,1,-1
618,614,614,614,14,14,13,13,1,3,2,3,4,0,0,0,1,0
623,618,618,614,14,14,15,13,2,1,1,2,5,0,4,0,-1,2
918,918,914,914,18,17,18,16,2,4,1,3,0,4,0,1,-1,2
600,600,595,600,18,17,18,16,2,1,3,1,0,5,-5,1,-1,2
1045,1040,1040,1040,20,19,20,18,2,2,1,1,5,0,0,1,-1,2
801,796,801,796,18,17,18,16,2,5,2,2,5,-5,5,1,-1,2
440,529,440,440,20,17,18,18,1,2,3,2,-89,89,0,3,-1,0
942,942,937,932,13,14,15,13,3,3,2,2,0,5,5,-1,-1,2
360,360,360,360,20,19,20,21,2,3,1,1,0,0,0,1,-1,-1
581,576,581,571,18,17,18,18,2,2,1,2,5,-5,10,1,-1,0
1017,1007,1007,1007,13,14,12,13,2,1,2,3,10,0,0,-1,2,-1
445,431,426,426,17,16,15,16,3,2,3,1,14,5,0,1,1,-1
810,806,810,810,18,19,18,19,2,2,1,1,4,-4,0,-1,1,-1
276,271,267,262,21,19,20,21,2,1,3,1,5,4,5,2,-1,-1
656,646,642,646,17,16,18,16,2,2,1,1,10,4,-4,1,-2,2
623,623,623,618,14,14,13,13,3,2,1,1,0,0,5,0,1,0
984,979,974,974,17,16,15,16,2,3,1,2,5,5,0,1,1,-1
623,618,614,614,21,19,21,21,1,4,1,1,5,4,0,2,-2,0
562,557,557,557,18,17,18,18,2,2,2,1,5,0,0,1,-1,0
482,473,478,478,18,19,18,18,2,2,2,1,9,-5,0,-1,1,0
576,567,567,562,18,17,18,18,3,2,2,2,9,0,5,1,-1,0
192,182,1078,1078,21,19,20,21,1,1,1,1,10,-896,0,2,-1,-1
510,510,506,506,14,17,15,16,2,2,3,1,0,4,0,-3,2,-1
815,806,806,806,14,14,15,13,1,3,2,2,9,0,0,0,-1,2
684,679,679,674,17,16,18,18,3,2,1,1,5,0,5,1,-2,0
970,970,965,960,20,19,18,18,1,3,1,5,0,5,5,1,1,0
1036,1031,1026,1031,20,19,18,18,3,1,2,1,5,5,-5,1,1,0
253,253,248,248,14,17,15,16,3,3,2,1,0,5,0,-3,2,-1
281,276,276,276,14,14,13,13,1,2,1,1,5,0,0,0,1,0
660,656,665,665,20,19,20,21,1,1,1,2,4,-9,0,1,-1,-1
445,450,450,450,20,19,20,21,3,1,1,1,-5,0,0,1,-1,-1
464,464,459,464,13,14,15,13,2,3,2,1,0,5,-5,-1,-1,2
586,581,581,581,18,17,18,19,3,2,1,3,5,0,0,1,-1,-1
778,768,778,782,20,19,20,21,1,2,2,1,10,-10,-4,1,-1,-1
468,468,464,459,17,16,15,16,2,1,2,1,0,4,5,1,1,-1
1073,1068,1068,1064,17,16,15,16,2,1,2,2,5,0,4,1,1,-1
989,984,989,979,17,16,15,16,3,3,2,1,5,-5,10,1,1,-1
731,726,726,721,13,16,15,16,2,1,2,1,5,0,5,-3,1,-1
801,796,796,796,18,19,18,19,2,1,1,1,5,0,0,-1,1,-1
286,276,276,276,18,19,18,18,1,3,2,4,10,0,0,-1,1,0
745,745,745,750,13,14,15,13,1,3,2,3,0,0,-5,-1,-1,2
267,262,257,253,21,19,20,21,1,2,1,1,5,5,4,2,-1,-1
965,960,956,956,20,19,20,18,2,2,1,3,5,4,0,1,-1,2
407,393,398,398,13,14,15,13,3,4,1,2,14,-5,0,-1,-1,2
989,979,965,965,17,16,15,16,3,3,4,2,10,14,0,1,1,-1
782,768,768,773,14,14,12,13,1,2,3,1,14,0,-5,0,2,-1
937,928,923,918,20,17,18,16,2,1,2,1,9,5,5,3,-1,2
478,468,468,459,17,16,18,18,1,1,1,4,10,0,9,1,-2,0
370,365,365,360,13,14,12,13,2,1,2,1,5,0,5,-1,2,-1
890,886,890,886,18,17,18,19,2,2,2,1,4,-4,4,1,-1,-1
740,736,736,736,17,16,15,16,2,3,1,5,4,0,0,1,1,-1
623,614,618,614,14,14,15,13,1,4,1,2,9,-4,4,0,-1,2
843,834,834,834,14,14,15,13,2,2,2,3,9,0,0,0,-1,2
876,871,871,871,14,14,15,13,2,1,1,1,5,0,0,0,-1,2
904,895,895,895,18,17,18,16,1,2,1,1,9,0,0,1,-1,2
557,543,534,539,14,14,13,13,3,1,1,1,14,9,-5,0,1,0
1031,1021,1021,1021,20,19,20,21,3,2,2,1,10,0,0,1,-1,-1
417,417,417,412,17,16,15,16,1,1,1,2,0,0,5,1,1,-1
745,736,745,754,13,14,12,13,2,3,1,2,9,-9,-9,-1,2,-1
1012,1003,998,998,13,14,15,13,2,2,1,1,9,5,0,-1,-1,2
989,979,984,979,13,16,15,16,1,2,1,3,10,-5,5,-3,1,-1
792,787,787,782,14,14,13,13,2,2,2,1,5,0,5,0,1,0
745,731,740,731,13,14,15,13,2,2,1,2,14,-9,9,-1,-1,2
993,989,989,989,17,16,18,16,2,2,1,2,4,0,0,1,-2,2
674,670,670,670,20,19,18,18,1,4,2,2,4,0,0,1,1,0
323,318,318,314,14,17,15,16,2,1,2,2,5,0,4,-3,2,-1
206,206,206,201,18,19,18,19,3,1,2,2,0,0,5,-1,1,-1
201,187,196,196,21,19,21,19,2,2,1,2,14,-9,0,2,-2,2
998,979,979,974,13,14,12,13,1,4,2,1,19,0,5,-1,2,-1
651,651,651,642,20,19,18,18,1,3,3,2,0,0,9,1,1,0
1073,1068,1064,1059,17,16,18,18,1,3,2,2,5,4,5,1,-2,0
642,637,642,637,13,14,12,13,2,3,2,3,5,-5,5,-1,2,-1
1031,1026,1021,1017,17,16,18,16,2,3,2,3,5,5,4,1,-2,2
1054,1054,1050,1050,20,19,20,21,1,1,1,3,0,4,0,1,-1,-1
407,403,403,403,20,19,20,18,2,2,3,1,4,0,0,1,-1,2
792,787,787,787,21,19,21,21,1,1,1,1,5,0,0,2,-2,0
665,665,665,665,13,14,12,13,1,1,3,1,0,0,0,-1,2,-1
895,881,876,876,14,14,13,13,1,3,2,2,14,5,0,0,1,0
1040,1036,1040,1036,13,14,12,13,1,1,2,2,4,-4,4,-1,2,-1
979,623,618,623,13,14,13,13,1,3,1,1,356,5,-5,-1,1,0
810,796,796,792,14,14,13,13,1,3,2,3,14,0,4,0,1,0
796,796,796,792,14,14,13,13,1,2,2,1,0,0,4,0,1,0
224,220,220,220,14,14,13,13,2,1,1,1,4,0,0,0,1,0
464,464,459,459,17,19,18,18,3,1,1,1,0,5,0,-2,1,0
834,829,829,829,21,19,20,21,1,1,1,1,5,0,0,2,-1,-1
773,768,773,768,13,14,12,13,1,1,1,2,5,-5,5,-1,2,-1
248,239,239,234,14,14,15,16,2,2,2,2,9,0,5,0,-1,-1
731,721,726,721,13,14,12,13,1,2,2,1,10,-5,5,-1,2,-1
492,492,487,492,14,14,13,13,1,3,1,1,0,5,-5,0,1,0
698,689,689,684,17,16,15,16,2,1,1,1,9,0,5,1,1,-1
651,651,646,646,20,19,20,21,2,1,2,1,0,5,0,1,-1,-1
815,815,810,820,18,17,18,19,2,2,4,1,0,5,-10,1,-1,-1
510,510,510,506,18,19,18,19,1,2,2,1,0,0,4,-1,1,-1
487,473,468,468,14,14,12,13,3,3,3,3,14,5,0,0,2,-1
389,389,389,389,13,14,15,13,4,1,1,1,0,0,0,-1,-1,2
412,407,407,412,20,19,18,18,3,2,1,1,5,0,-5,1,1,0
473,468,464,464,13,14,15,13,1,2,3,3,5,4,0,-1,-1,2
281,276,276,276,14,14,13,13,2,2,1,1,5,0,0,0,1,0
881,876,881,876,14,14,13,13,1,4,2,1,5,-5,5,0,1,0
848,839,839,834,14,17,15,16,2,1,2,2,9,0,5,-3,2,-1
192,182,187,182,18,17,18,16,3,2,2,1,10,-5,5,1,-1,2
459,450,445,440,17,16,15,16,2,4,1,1,9,5,5,1,1,-1
417,431,417,417,17,16,18,18,1,2,3,1,-14,14,0,1,-2,0
1007,1007,1003,998,13,14,12,13,4,1,1,2,0,4,5,-1,2,-1
309,304,304,304,21,19,20,19,2,2,1,2,5,0,0,2,-1,1
182,1073,1068,1068,21,19,20,21,1,2,1,1,-891,5,0,2,-1,-1
295,290,286,290,14,14,15,13,1,3,2,1,5,4,-4,0,-1,2
576,571,567,571,14,14,15,13,1,1,1,3,5,4,-4,0,-1,2
454,436,436,426,13,14,15,16,2,2,2,2,18,0,10,-1,-1,-1
1021,1021,1017,1017,13,14,12,13,1,2,1,1,0,4,0,-1,2,-1
1017,1017,1012,1007,20,19,20,21,1,3,1,1,0,5,5,1,-1,-1
243,234,234,234,14,14,15,13,3,2,1,1,9,0,0,0,-1,2
604,595,600,604,21,19,20,21,2,1,3,1,9,-5,-4,2,-1,-1
515,501,510,501,14,14,13,13,1,1,1,2,14,-9,9,0,1,0
548,543,543,543,18,17,18,18,2,2,1,3,5,0,0,1,-1,0
290,281,286,281,14,17,15,16,1,2,2,2,9,-5,5,-3,2,-1
1036,1031,1026,1026,17,19,18,18,1,1,3,1,5,5,0,-2,1,0
1036,1031,1031,1026,17,19,18,18,1,2,1,1,5,0,5,-2,1,0
970,965,965,960,17,16,18,16,1,1,1,1,5,0,5,1,-2,2
248,239,234,234,14,14,15,16,3,3,3,3,9,5,0,0,-1,-1
257,253,248,253,18,17,18,18,2,1,1,1,4,5,-5,1,-1,0
674,670,665,665,13,14,12,13,2,1,2,2,4,5,0,-1,2,-1
210,206,210,206,18,19,18,19,1,2,2,2,4,-4,4,-1,1,-1
979,974,974,974,20,19,20,21,1,1,1,1,5,0,0,1,-1,-1
318,318,323,318,21,19,21,19,1,3,2,2,0,-5,5,2,-2,2
609,604,600,600,21,19,20,19,1,2,2,1,5,4,0,2,-1,1
379,370,365,360,20,19,20,18,1,1,1,1,9,5,5,1,-1,2
417,417,417,412,13,14,15,13,3,3,2,2,0,0,5,-1,-1,2
501,501,501,501,14,17,15,16,4,1,4,1,0,0,0,-3,2,-1
248,239,248,239,14,17,15,16,1,2,1,2,9,-9,9,-3,2,-1
210,206,206,201,21,19,20,21,1,1,1,6,4,0,5,2,-1,-1
848,839,834,839,14,17,15,16,1,1,3,2,9,5,-5,-3,2,-1
398,389,379,379,13,14,15,13,2,3,1,2,9,10,0,-1,-1,2
698,689,693,698,17,16,18,18,2,2,3,1,9,-4,-5,1,-2,0
792,787,787,787,14,14,15,16,1,1,1,1,5,0,0,0,-1,-1
417,417,417,407,13,14,15,13,3,3,2,3,0,0,10,-1,-1,2
810,806,810,806,14,17,15,16,3,2,1,2,4,-4,4,-3,2,-1
609,604,604,604,21,19,20,19,1,2,4,1,5,0,0,2,-1,1
196,192,187,187,14,14,15,13,1,2,3,1,4,5,0,0,-1,2
234,229,229,224,14,17,15,16,2,2,2,2,5,0,5,-3,2,-1
290,290,286,286,18,19,18,19,1,3,1,1,0,4,0,-1,1,-1
1007,998,1003,440,17,16,18,18,2,2,2,1,9,-5,563,1,-2,0
304,295,295,295,14,14,15,13,1,1,2,1,9,0,0,0,-1,2
262,262,262,257,14,17,15,16,2,1,2,2,0,0,5,-3,2,-1
286,286,286,281,14,17,15,16,1,1,2,2,0,0,5,-3,2,-1
1031,1026,1031,1026,13,14,15,16,1,2,2,2,5,-5,5,-1,-1,-1
886,886,881,881,21,19,20,21,2,1,1,3,0,5,0,2,-1,-1
609,609,609,609,18,17,18,16,3,3,1,1,0,0,0,1,-1,2
1021,1017,1012,1012,20,19,18,18,1,3,3,3,4,5,0,1,1,0
557,553,553,553,18,17,18,18,2,2,1,1,4,0,0,1,-1,0
993,979,979,970,20,19,20,18,2,2,3,2,14,0,9,1,-1,2
623,604,604,609,21,19,20,19,1,2,1,2,19,0,-5,2,-1,1
637,623,614,614,13,14,15,13,2,3,1,3,14,9,0,-1,-1,2
904,900,900,900,14,14,15,13,2,3,2,1,4,0,0,0,-1,2
890,886,886,886,18,17,18,16,3,1,2,3,4,0,0,1,-1,2
253,248,248,248,14,14,15,13,1,3,3,1,5,0,0,0,-1,2
900,895,895,890,18,19,18,19,1,1,2,1,5,0,5,-1,1,-1
824,820,815,829,18,19,18,19,3,2,1,1,4,5,-14,-1,1,-1
754,750,745,740,17,19,18,18,2,2,2,1,4,5,5,-2,1,0
515,510,510,506,14,14,13,13,3,1,2,1,5,0,4,0,1,0
206,196,201,196,14,17,15,16,1,2,2,1,10,-5,5,-3,2,-1
276,271,271,271,14,14,15,13,1,2,1,2,5,0,0,0,-1,2
726,721,726,731,17,16,15,16,1,1,2,2,5,-5,-5,1,1,-1
478,473,468,468,13,14,12,13,2,3,2,1,5,5,0,-1,2,-1
886,867,857,857,18,17,18,16,1,3,1,2,19,10,0,1,-1,2
773,768,768,768,20,19,20,21,1,2,1,1,5,0,0,1,-1,-1
487,473,468,468,14,16,15,16,1,3,2,1,14,5,0,-2,1,-1
993,979,979,979,20,19,18,18,1,3,2,1,14,0,0,1,1,0
670,665,670,665,13,14,12,13,1,3,2,1,5,-5,5,-1,2,-1
412,403,595,398,17,16,15,16,2,1,1,1,9,-192,197,1,1,-1
750,740,740,745,13,14,12,13,1,2,1,1,10,0,-5,-1,2,-1
632,628,623,618,17,17,18,16,1,1,3,2,4,5,5,0,-1,2
609,609,604,604,21,19,20,21,1,5,1,1,0,5,0,2,-1,-1
867,867,862,867,14,14,13,13,3,2,3,1,0,5,-5,0,1,0
881,876,876,876,18,17,18,18,3,3,1,1,5,0,0,1,-1,0
304,300,300,295,18,17,18,19,2,2,1,2,4,0,5,1,-1,-1
768,764,768,768,13,14,12,13,1,3,3,1,4,-4,0,-1,2,-1
454,445,436,436,13,14,12,13,2,3,1,2,9,9,0,-1,2,-1
839,839,843,839,14,17,15,16,2,1,2,2,0,-4,4,-3,2,-1
450,450,450,445,17,16,15,16,3,2,1,1,0,0,5,1,1,-1
989,984,984,984,17,16,18,16,2,2,1,1,5,0,0,1,-2,2
674,670,665,660,20,19,20,18,2,1,2,1,4,5,5,1,-1,2
979,974,979,979,20,19,20,21,1,2,2,3,5,-5,0,1,-1,-1
609,600,600,600,18,19,18,19,1,1,1,1,9,0,0,-1,1,-1
346,342,342,337,13,14,12,13,1,3,1,1,4,0,5,-1,2,-1
468,459,454,454,17,19,18,18,2,1,5,3,9,5,0,-2,1,0
436,431,431,431,17,16,15,16,1,2,1,1,5,0,0,1,1,-1
839,834,834,829,14,14,15,16,1,2,1,2,5,0,5,0,-1,-1
318,304,309,304,14,14,15,16,2,3,1,1,14,-5,5,0,-1,-1
201,196,309,187,18,17,21,16,2,3,1,1,5,-113,122,1,-4,5
637,623,623,623,13,14,15,13,2,2,1,2,14,0,0,-1,-1,2
318,300,295,290,18,17,18,19,2,2,2,3,18,5,5,1,-1,-1
740,731,736,736,17,16,18,18,3,3,2,1,9,-5,0,1,-2,0
867,853,848,843,14,14,15,13,2,2,3,2,14,5,5,0,-1,2
281,276,276,271,18,19,18,18,4,2,2,1,5,0,5,-1,1,0
1036,1036,1036,1031,13,14,12,13,1,3,2,1,0,0,5,-1,2,-1
642,637,642,637,13,14,15,13,3,4,2,2,5,-5,5,-1,-1,2
609,609,604,604,18,19,18,19,2,1,1,1,0,5,0,-1,1,-1
206,201,196,206,21,19,21,21,2,2,1,1,5,5,-10,2,-2,0
623,618,618,618,18,19,18,19,2,4,1,1,5,0,0,-1,1,-1
787,787,787,782,21,19,21,19,3,2,3,1,0,0,5,2,-2,2
806,806,806,806,14,14,15,13,3,1,2,3,0,0,0,0,-1,2
946,937,932,932,13,14,15,13,3,1,1,2,9,5,0,-1,-1,2
946,918,923,923,17,17,18,19,2,3,1,1,28,-5,0,0,-1,-1
646,646,642,642,17,16,15,16,1,2,1,1,0,4,0,1,1,-1
393,384,379,384,20,19,20,21,2,2,3,1,9,5,-5,1,-1,-1
445,436,436,440,20,19,18,18,2,1,2,1,9,0,-4,1,1,0
314,304,300,300,14,14,15,13,3,4,2,4,10,4,0,0,-1,2
824,824,824,815,18,17,18,16,1,4,2,2,0,0,9,1,-1,2
323,318,318,314,14,17,15,16,1,4,2,2,5,0,4,-3,2,-1
412,412,412,407,20,19,18,18,1,1,2,1,0,0,5,1,1,0
867,862,862,862,18,19,18,18,1,2,1,1,5,0,0,-1,1,0
806,806,806,806,14,17,15,16,2,1,2,3,0,0,0,-3,2,-1
360,360,351,356,20,19,20,21,1,3,3,1,0,9,-5,1,-1,-1
853,843,843,843,14,14,13,13,3,1,1,1,10,0,0,0,1,0
1007,998,1003,998,13,14,15,16,1,1,2,2,9,-5,5,-1,-1,-1
960,960,960,960,17,16,18,16,1,2,2,1,0,0,0,1,-2,2
407,398,403,393,13,14,12,13,2,2,1,2,9,-5,10,-1,2,-1
417,407,407,403,13,14,15,16,2,3,2,1,10,0,4,-1,-1,-1
726,721,721,717,20,19,20,18,1,1,1,2,5,0,4,1,-1,2
276,262,267,271,14,17,15,16,2,1,1,3,14,-5,-4,-3,2,-1
932,932,932,932,20,19,20,18,1,1,1,1,0,0,0,1,-1,2
886,876,881,871,18,19,18,18,1,2,4,1,10,-5,10,-1,1,0
881,876,876,876,21,19,20,18,3,1,1,1,5,0,0,2,-1,2
1021,1021,1026,1021,20,19,20,21,1,2,2,2,0,-5,5,1,-1,-1
534,529,529,529,18,19,20,19,1,1,1,1,5,0,0,-1,-1,1
679,670,665,660,13,14,15,16,3,1,1,4,9,5,5,-1,-1,-1
848,839,843,843,18,19,18,18,1,3,2,1,9,-4,0,-1,1,0
539,510,529,534,18,19,18,18,2,2,3,1,29,-19,-5,-1,1,0
567,562,562,557,21,19,20,18,3,2,1,1,5,0,5,2,-1,2
281,276,271,276,18,19,18,18,2,3,1,1,5,5,-5,-1,1,0
731,726,721,726,20,19,18,18,1,3,1,1,5,5,-5,1,1,0
468,464,464,464,20,19,20,21,1,2,1,1,4,0,0,1,-1,-1
674,670,670,707,17,16,18,16,2,2,1,2,4,0,-37,1,-2,2
337,328,323,323,20,19,18,19,2,1,3,1,9,5,0,1,1,-1
309,300,304,304,18,17,18,19,4,2,2,1,9,-4,0,1,-1,-1
1021,1012,1003,1003,13,14,15,13,3,1,1,1,9,9,0,-1,-1,2
239,239,239,239,21,19,20,18,1,1,1,1,0,0,0,2,-1,2
192,187,187,187,21,19,21,21,2,3,1,1,5,0,0,2,-2,0
332,332,337,332,20,19,18,18,1,1,2,1,0,-5,5,1,1,0
1068,1064,1059,1064,13,14,12,13,3,2,3,1,4,5,-5,-1,2,-1
871,871,867,867,14,14,13,13,2,1,3,2,0,4,0,0,1,0
524,515,506,506,14,14,15,16,2,3,1,2,9,9,0,0,-1,-1
679,679,674,674,20,19,20,18,1,3,3,2,0,5,0,1,-1,2
543,534,539,548,21,19,18,18,1,3,1,1,9,-5,-9,2,1,0
923,914,914,909,18,19,18,19,1,2,1,2,9,0,5,-1,1,-1
192,1073,1068,1064,18,19,18,18,1,2,1,2,-881,5,4,-1,1,0
768,764,764,759,13,14,15,13,3,2,4,4,4,0,5,-1,-1,2
1045,1040,1036,1036,17,19,18,18,2,2,1,1,5,4,0,-2,1,0
604,595,590,590,18,17,18,19,3,2,1,1,9,5,0,1,-1,-1
820,815,815,810,18,19,18,19,2,1,1,2,5,0,5,-1,1,-1
829,824,829,824,14,17,15,16,2,3,1,2,5,-5,5,-3,2,-1
436,426,426,356,20,19,20,18,2,2,1,1,10,0,70,1,-1,2
492,492,487,487,14,17,15,16,1,1,2,3,0,5,0,-3,2,-1
862,853,848,853,18,19,18,18,2,1,1,1,9,5,-5,-1,1,0
600,590,586,586,21,19,20,19,1,1,1,2,10,4,0,2,-1,1
323,323,318,314,21,19,21,21,3,3,1,2,0,5,4,2,-2,0
187,182,182,1073,21,19,21,18,3,1,1,2,5,0,-891,2,-2,3
417,417,412,417,20,19,18,18,1,1,1,1,0,5,-5,1,1,0
417,407,403,403,13,14,15,13,1,3,1,1,10,4,0,-1,-1,2
253,248,239,239,18,17,15,16,3,1,2,1,5,9,0,1,2,-1
384,379,389,379,17,19,18,18,3,2,2,2,5,-10,10,-2,1,0
768,764,759,759,17,16,15,16,3,3,3,1,4,5,0,1,1,-1
224,215,215,215,14,17,15,16,3,3,2,1,9,0,0,-3,2,-1
1036,1026,1031,1026,13,14,12,13,2,3,2,1,10,-5,5,-1,2,-1
665,660,665,660,13,14,12,13,2,2,1,2,5,-5,5,-1,2,-1
187,187,187,187,21,19,21,19,2,1,1,3,0,0,0,2,-2,2
403,398,398,403,17,16,15,16,3,2,3,2,5,0,-5,1,1,-1
192,187,187,192,21,19,21,21,2,1,2,3,5,0,-5,2,-2,0
229,224,229,220,14,17,15,16,3,3,5,1,5,-5,9,-3,2,-1
904,890,890,895,14,14,13,13,2,2,1,2,14,0,-5,0,1,0
974,970,970,970,13,14,12,13,1,3,1,1,4,0,0,-1,2,-1
857,848,848,843,18,19,18,18,2,1,1,2,9,0,5,-1,1,0
970,970,970,965,17,16,18,16,2,1,2,1,0,0,5,1,-2,2
487,487,487,487,18,17,18,19,3,1,1,1,0,0,0,1,-1,-1
970,960,960,956,17,19,18,18,1,2,1,2,10,0,4,-2,1,0
614,618,609,609,21,19,21,21,2,1,1,1,-4,9,0,2,-2,0
543,543,539,539,21,19,20,21,3,1,1,2,0,4,0,2,-1,-1
271,267,271,271,14,14,15,13,1,3,1,2,4,-4,0,0,-1,2
717,712,707,712,13,14,15,13,3,2,1,1,5,5,-5,-1,-1,2
618,614,614,614,14,17,15,16,2,1,1,3,4,0,0,-3,2,-1
867,857,862,857,14,14,15,16,2,6,1,3,10,-5,5,0,-1,-1
468,473,464,464,17,16,18,18,3,2,1,4,-5,9,0,1,-2,0
792,792,792,792,14,17,15,16,2,1,1,1,0,0,0,-3,2,-1
360,360,356,351,17,19,18,18,3,3,1,1,0,4,5,-2,1,0
393,384,379,374,13,14,12,13,1,1,2,1,9,5,5,-1,2,-1
210,201,196,201,14,14,13,13,3,2,3,1,9,5,-5,0,1,0
886,881,876,881,18,17,18,19,2,2,1,3,5,5,-5,1,-1,-1
632,623,628,628,13,14,13,13,1,2,2,1,9,-5,0,-1,1,0
1017,1017,1012,1017,20,19,20,18,1,1,3,1,0,5,-5,1,-1,2
998,993,993,993,13,14,12,13,2,2,3,1,5,0,0,-1,2,-1
543,534,539,529,18,19,18,19,3,2,2,2,9,-5,10,-1,1,-1
1017,1012,1017,1017,20,19,20,18,1,1,1,1,5,-5,0,1,-1,2
857,853,853,853,18,17,18,16,1,2,2,3,4,0,0,1,-1,2
881,876,876,871,21,19,20,21,1,1,1,2,5,0,5,2,-1,-1
1031,1031,1031,1026,13,14,12,13,2,2,2,2,0,0,5,-1,2,-1
895,890,890,890,21,19,20,21,1,2,3,1,5,0,0,2,-1,-1
974,970,965,965,13,14,12,13,1,3,1,1,4,5,0,-1,2,-1
726,726,717,717,13,14,15,13,1,3,1,3,0,9,0,-1,-1,2
946,946,951,951,17,16,18,18,1,2,3,4,0,-5,0,1,-2,0
571,567,567,567,18,19,18,18,1,1,2,1,4,0,0,-1,1,0
736,731,731,731,13,14,12,13,1,2,1,1,5,0,0,-1,2,-1
421,407,412,412,17,16,15,16,2,2,1,3,14,-5,0,1,1,-1
496,492,492,492,21,19,21,21,1,2,1,1,4,0,0,2,-2,0
267,262,267,267,14,14,13,13,2,4,3,1,5,-5,0,0,1,0
473,421,426,421,20,19,18,18,1,1,1,2,52,-5,5,1,1,0
792,736,736,736,21,19,20,21,3,2,1,1,56,0,0,2,-1,-1
206,201,196,201,14,17,15,16,1,2,1,1,5,5,-5,-3,2,-1
281,257,257,253,14,14,15,13,3,1,1,2,24,0,4,0,-1,2
951,942,946,951,20,19,18,18,1,2,1,1,9,-4,-5,1,1,0
351,351,346,346,17,16,15,16,1,1,1,1,0,5,0,1,1,-1
454,450,450,450,17,16,18,16,2,1,1,3,4,0,0,1,-2,2
389,379,379,403,13,14,15,13,1,1,1,1,10,0,-24,-1,-1,2
843,834,829,834,14,14,15,13,2,3,1,3,9,5,-5,0,-1,2
914,900,900,895,14,14,13,13,2,2,1,3,14,0,5,0,1,0
839,839,834,834,14,14,13,13,1,2,1,2,0,5,0,0,1,0
234,234,229,224,14,14,15,16,1,3,2,2,0,5,5,0,-1,-1
506,492,492,496,18,19,18,19,1,3,1,1,14,0,-4,-1,1,-1
253,243,243,239,18,17,18,18,3,2,2,2,10,0,4,1,-1,0
792,787,792,792,21,19,21,19,1,2,2,1,5,-5,0,2,-2,2
365,365,360,360,13,14,15,13,2,1,3,1,0,5,0,-1,-1,2
810,806,806,806,14,14,15,13,2,3,2,3,4,0,0,0,-1,2
192,1073,1073,529,14,14,15,16,1,2,1,1,-881,0,544,0,-1,-1
721,712,731,740,17,16,18,16,3,2,1,2,9,-19,-9,1,-2,2
946,942,946,946,17,16,15,16,2,1,2,1,4,-4,0,1,1,-1
768,764,764,759,17,16,18,18,3,3,2,1,4,0,5,1,-2,0
881,881,876,876,18,19,18,18,1,1,1,3,0,5,0,-1,1,0
253,248,243,243,14,17,15,16,1,5,1,1,5,5,0,-3,2,-1
590,581,586,586,18,17,18,16,1,2,2,1,9,-5,0,1,-1,2
974,979,970,965,20,19,20,18,2,1,1,2,-5,9,5,1,-1,2
698,693,693,693,13,14,12,13,2,1,2,4,5,0,0,-1,2,-1
276,276,276,276,18,19,18,18,3,3,1,1,0,0,0,-1,1,0
262,253,243,243,14,17,15,16,2,3,1,2,9,10,0,-3,2,-1
314,304,300,300,14,17,15,16,3,2,1,4,10,4,0,-3,2,-1
848,843,843,839,21,19,20,18,2,3,1,2,5,0,4,2,-1,2
1012,1007,1007,1007,17,16,15,16,1,2,1,1,5,0,0,1,1,-1
618,600,586,576,14,14,13,13,1,4,3,3,18,14,10,0,1,0
895,895,895,895,18,17,18,16,2,1,1,1,0,0,0,1,-1,2
243,224,224,220,14,14,15,13,2,2,3,2,19,0,4,0,-1,2
436,436,436,431,20,19,20,18,1,1,1,2,0,0,5,1,-1,2
267,267,262,262,14,17,15,16,2,1,2,2,0,5,0,-3,2,-1
201,201,196,196,21,19,21,21,2,1,2,1,0,5,0,2,-2,0
782,782,782,782,14,17,15,16,2,2,1,1,0,0,0,-3,2,-1
529,520,524,520,14,14,13,13,1,2,2,2,9,-4,4,0,1,0
801,801,801,796,18,19,18,19,2,1,2,1,0,0,5,-1,1,-1
543,539,534,529,14,14,13,13,4,1,3,2,4,5,5,0,1,0
909,1017,1017,1017,18,19,18,18,1,1,3,1,-108,0,0,-1,1,0
567,567,562,557,14,17,15,16,1,1,3,2,0,5,5,-3,2,-1
604,600,600,600,14,14,15,16,1,2,1,1,4,0,0,0,-1,-1
492,487,487,487,21,19,21,19,2,1,1,1,5,0,0,2,-2,2
614,614,609,604,18,19,18,19,1,1,1,2,0,5,5,-1,1,-1
857,853,848,853,14,14,15,13,3,1,3,3,4,5,-5,0,-1,2
586,581,581,576,18,17,18,18,1,2,2,2,5,0,5,1,-1,0
881,867,867,862,14,17,15,16,1,2,1,3,14,0,5,-3,2,-1
792,792,787,787,14,14,13,13,2,3,2,3,0,5,0,0,1,0
609,604,595,600,21,19,20,21,3,3,1,1,5,9,-5,2,-1,-1
796,792,792,782,18,17,18,19,1,1,1,1,4,0,10,1,-1,-1
262,257,257,253,14,14,15,13,1,4,2,2,5,0,4,0,-1,2
1021,1012,1012,1012,13,14,12,13,3,2,1,1,9,0,0,-1,2,-1
370,365,370,370,17,19,18,18,2,2,2,2,5,-5,0,-2,1,0
215,210,210,206,14,17,15,16,2,1,2,3,5,0,4,-3,2,-1
923,914,909,909,21,19,21,19,2,3,1,6,9,5,0,2,-2,2
271,253,248,243,14,14,15,16,1,1,1,2,18,5,5,0,-1,-1
539,529,529,529,14,14,13,13,2,2,2,3,10,0,0,0,1,0
1003,993,993,993,20,19,18,18,2,2,1,1,10,0,0,1,1,0
210,206,206,206,14,14,15,13,2,2,1,1,4,0,0,0,-1,2
979,974,979,979,20,19,18,18,3,2,2,1,5,-5,0,1,1,0
576,571,571,571,14,17,15,16,2,2,2,1,5,0,0,-3,2,-1
665,660,665,660,17,16,18,18,1,2,2,1,5,-5,5,1,-2,0
1007,998,998,993,13,14,12,13,2,3,2,1,9,0,5,-1,2,-1
407,398,393,389,17,16,18,16,2,3,2,1,9,5,4,1,-2,2
440,436,440,440,13,14,15,13,2,3,2,1,4,-4,0,-1,-1,2
623,609,604,604,14,14,13,13,1,3,1,1,14,5,0,0,1,0
450,281,281,286,13,19,18,19,1,1,3,1,169,0,-5,-6,1,-1
314,309,309,304,21,19,21,19,2,1,1,2,5,0,5,2,-2,2
703,698,703,703,13,16,15,16,3,1,1,1,5,-5,0,-3,1,-1
478,473,473,478,17,16,15,16,2,2,2,1,5,0,-5,1,1,-1
454,454,454,454,20,19,18,18,3,1,2,2,0,0,0,1,1,0
309,300,295,295,14,17,15,16,1,2,3,1,9,5,0,-3,2,-1
614,595,586,586,14,14,13,13,3,2,2,2,19,9,0,0,1,0
614,614,609,609,18,19,18,19,3,1,1,2,0,5,0,-1,1,-1
567,539,543,539,14,17,15,16,1,3,4,3,28,-4,4,-3,2,-1
1007,1003,1003,998,13,14,15,13,3,5,2,2,4,0,5,-1,-1,2
581,581,581,581,18,19,18,19,3,1,3,3,0,0,0,-1,1,-1
614,604,609,609,14,17,15,16,2,5,1,1,10,-5,0,-3,2,-1
740,740,736,731,13,14,12,13,2,2,2,1,0,4,5,-1,2,-1
890,890,881,881,21,19,20,21,1,2,1,3,0,9,0,2,-1,-1
815,796,801,796,14,14,15,13,3,1,1,2,19,-5,5,0,-1,2
670,665,665,665,20,19,20,21,1,2,2,1,5,0,0,1,-1,-1
196,192,1078,182,14,14,13,13,2,1,1,1,4,-886,896,0,1,0
946,946,946,942,17,16,18,18,1,3,2,2,0,0,4,1,-2,0
365,360,360,356,13,14,12,13,1,3,5,2,5,0,4,-1,2,-1
234,229,224,224,14,14,13,13,4,3,1,1,5,5,0,0,1,0
895,881,881,881,21,19,20,21,1,2,1,2,14,0,0,2,-1,-1
918,909,914,914,14,14,15,16,2,2,2,1,9,-5,0,0,-1,-1
815,806,801,801,14,14,15,13,1,1,1,2,9,5,0,0,-1,2
820,815,815,810,14,17,15,16,3,1,3,3,5,0,5,-3,2,-1
937,918,923,923,13,14,15,13,2,2,3,2,19,-5,0,-1,-1,2
393,389,389,384,17,16,18,18,2,1,3,1,4,0,5,1,-2,0
253,243,243,239,18,17,18,18,1,1,1,3,10,0,4,1,-1,0
304,300,300,295,14,14,13,13,1,1,2,2,4,0,5,0,1,0
1026,1017,1017,1017,17,16,18,16,2,1,2,1,9,0,0,1,-2,2
1078,1073,1068,1068,17,19,18,18,2,1,3,1,5,5,0,-2,1,0
412,412,417,412,13,14,12,13,3,2,4,2,0,-5,5,-1,2,-1
1078,1068,1064,1059,13,14,12,13,1,2,1,4,10,4,5,-1,2,-1
553,553,557,562,18,17,18,18,1,2,2,1,0,-4,-5,1,-1,0
1064,1050,1050,1054,13,14,12,13,2,2,2,3,14,0,-4,-1,2,-1
843,824,834,834,14,14,15,13,1,2,3,2,19,-10,0,0,-1,2
857,853,857,857,18,17,18,16,2,2,1,1,4,-4,0,1,-1,2
923,923,923,923,14,17,15,16,2,1,2,1,0,0,0,-3,2,-1
886,881,886,886,14,14,15,16,2,2,1,1,5,-5,0,0,-1,-1
206,374,206,201,14,14,15,16,3,1,2,2,-168,168,5,0,-1,-1
946,946,946,946,13,14,12,13,2,5,3,1,0,0,0,-1,2,-1
1045,1040,1045,1045,13,14,15,16,5,3,1,1,5,-5,0,-1,-1,-1
473,464,459,459,13,14,15,13,2,3,2,3,9,5,0,-1,-1,2
351,351,346,351,17,16,18,18,3,1,1,3,0,5,-5,1,-2,0
618,614,614,614,14,17,15,16,2,2,1,1,4,0,0,-3,2,-1
600,586,586,590,21,19,20,21,3,2,1,1,14,0,-4,2,-1,-1
229,220,220,220,14,17,15,16,1,2,1,1,9,0,0,-3,2,-1
464,454,459,454,17,16,15,16,2,3,1,2,10,-5,5,1,1,-1
590,586,586,586,18,17,18,16,1,1,1,1,4,0,0,1,-1,2
323,314,323,318,14,14,15,13,2,4,2,2,9,-9,5,0,-1,2
304,286,445,286,14,14,10,13,3,2,1,1,18,-159,159,0,4,-3
426,417,417,412,13,14,15,13,2,3,1,2,9,0,5,-1,-1,2
586,576,576,576,14,17,15,16,1,3,1,2,10,0,0,-3,2,-1
286,276,276,276,21,19,20,18,1,2,1,1,10,0,0,2,-1,2
276,271,267,262,21,19,20,18,1,3,2,2,5,4,5,2,-1,2
759,754,754,754,13,14,12,13,1,1,2,1,5,0,0,-1,2,-1
787,768,778,782,18,19,18,19,1,2,1,1,19,-10,-4,-1,1,-1
829,820,820,820,14,14,13,13,1,2,1,1,9,0,0,0,1,0
520,520,515,520,21,19,20,19,2,1,3,2,0,5,-5,2,-1,1
450,445,445,445,17,16,18,18,1,3,1,2,5,0,0,1,-2,0
393,389,393,384,17,16,15,16,3,1,1,2,4,-4,9,1,1,-1
918,909,904,904,14,17,15,16,1,3,3,2,9,5,0,-3,2,-1
970,965,965,960,13,14,12,13,1,2,1,2,5,0,5,-1,2,-1
656,651,656,651,20,19,18,18,1,2,2,1,5,-5,5,1,1,0
1026,1017,1003,998,13,14,15,13,3,2,1,2,9,14,5,-1,-1,2
300,295,295,295,21,19,20,19,1,1,1,1,5,0,0,2,-1,1
337,332,332,337,17,16,18,16,1,1,1,1,5,0,-5,1,-2,2
703,693,689,689,20,19,18,18,2,1,3,1,10,4,0,1,1,0
867,867,867,867,18,17,18,16,2,2,1,1,0,0,0,1,-1,2
768,759,754,754,20,19,20,21,1,2,1,1,9,5,0,1,-1,-1
436,417,417,417,20,19,18,18,1,1,1,1,19,0,0,1,1,0
679,674,674,674,13,14,12,13,1,2,1,1,5,0,0,-1,2,-1
923,923,914,914,21,19,21,21,2,1,1,2,0,9,0,2,-2,0
600,600,595,595,18,17,18,19,2,1,2,2,0,5,0,1,-1,-1
665,660,665,660,13,14,12,13,3,4,2,1,5,-5,5,-1,2,-1
750,750,745,740,20,19,20,18,2,1,1,2,0,5,5,1,-1,2
965,960,965,965,20,19,20,18,2,2,2,2,5,-5,0,1,-1,2
318,318,323,323,14,17,15,16,2,2,2,1,0,-5,0,-3,2,-1
295,290,290,290,14,14,15,13,3,1,1,3,5,0,0,0,-1,2
206,215,210,210,14,14,15,13,2,1,3,1,-9,5,0,0,-1,2
609,595,590,586,21,19,20,19,1,2,1,1,14,5,4,2,-1,1
403,398,398,398,17,16,18,16,3,2,1,1,5,0,0,1,-2,2
403,403,403,403,13,14,15,16,2,3,3,1,0,0,0,-1,-1,-1
360,356,356,356,17,16,18,16,2,2,2,1,4,0,0,1,-2,2
651,642,642,642,13,14,12,13,2,1,3,2,9,0,0,-1,2,-1
1003,998,998,998,13,14,12,13,1,2,3,1,5,0,0,-1,2,-1
524,524,524,520,14,14,13,13,3,3,1,3,0,0,4,0,1,0
956,951,956,951,17,16,15,16,2,1,2,1,5,-5,5,1,1,-1
689,684,684,684,20,19,20,18,1,3,1,1,5,0,0,1,-1,2
946,946,946,946,20,19,20,21,1,1,1,3,0,0,0,1,-1,-1
834,834,834,829,18,19,18,19,2,3,2,3,0,0,5,-1,1,-1
229,220,229,229,18,17,18,19,3,2,2,1,9,-9,0,1,-1,-1
787,787,787,787,18,19,18,19,2,1,1,1,0,0,0,-1,1,-1
1045,1040,1045,1040,20,19,18,18,1,2,1,1,5,-5,5,1,1,0
618,618,604,609,14,14,15,13,3,2,4,1,0,14,-5,0,-1,2
918,909,909,909,14,14,13,13,3,2,1,3,9,0,0,0,1,0
618,618,623,618,21,19,21,21,1,3,2,2,0,-5,5,2,-2,0
515,510,515,510,21,19,20,21,2,2,3,2,5,-5,5,2,-1,-1
1078,1068,1068,1064,13,14,15,13,2,2,3,2,10,0,4,-1,-1,2
384,379,365,374,17,16,15,16,2,1,1,1,5,14,-9,1,1,-1
590,590,590,590,18,17,18,19,2,2,1,1,0,0,0,1,-1,-1
867,857,862,853,18,17,18,18,3,2,2,2,10,-5,9,1,-1,0
206,206,201,196,14,17,15,16,1,1,1,2,0,5,5,-3,2,-1
600,595,595,590,18,19,18,19,1,1,3,2,5,0,5,-1,1,-1
332,332,337,332,17,16,18,18,1,2,2,1,0,-5,5,1,-2,0
473,468,464,459,13,14,15,13,1,3,2,2,5,4,5,-1,-1,2
923,914,914,914,14,14,13,13,2,2,2,1,9,0,0,0,1,0
286,281,281,276,18,17,18,18,3,3,1,1,5,0,5,1,-1,0
318,314,309,309,14,14,15,16,3,3,1,1,4,5,0,0,-1,-1
1007,1012,1012,1012,13,14,12,13,1,3,1,1,-5,0,0,-1,2,-1
506,492,492,487,14,17,15,16,2,2,3,1,14,0,5,-3,2,-1
951,946,951,946,17,16,15,16,1,2,2,1,5,-5,5,1,1,-1
974,970,974,970,20,19,20,18,1,1,1,2,4,-4,4,1,-1,2
721,721,717,717,17,16,15,16,1,1,1,1,0,4,0,1,1,-1
515,510,506,506,18,17,18,19,1,3,1,1,5,4,0,1,-1,-1
1059,1045,1040,1036,13,14,15,13,2,1,3,2,14,5,4,-1,-1,2
843,829,824,829,14,14,15,13,1,2,1,3,14,5,-5,0,-1,2
960,956,937,937,17,16,15,16,2,1,1,2,4,19,0,1,1,-1
309,309,304,304,21,19,20,21,2,1,1,1,0,5,0,2,-1,-1
571,576,576,571,18,19,18,18,2,1,1,2,-5,0,5,-1,1,0
553,534,529,524,18,17,15,16,3,1,2,1,19,5,5,1,2,-1
473,473,468,468,17,16,18,16,3,3,3,1,0,5,0,1,-2,2
487,487,482,482,14,14,15,13,1,1,1,2,0,5,0,0,-1,2
309,300,300,295,14,17,15,16,2,2,1,2,9,0,5,-3,2,-1
1003,998,1003,998,17,16,18,18,2,1,2,1,5,-5,5,1,-2,0
346,337,337,337,17,16,15,16,1,1,2,2,9,0,0,1,1,-1
796,787,792,787,18,17,18,19,2,2,2,1,9,-5,5,1,-1,-1
426,421,421,417,20,19,18,18,3,1,1,1,5,0,4,1,1,0
389,384,379,379,17,16,18,16,1,1,1,1,5,5,0,1,-2,2
717,712,707,707,20,19,20,21,2,1,3,2,5,5,0,1,-1,-1
801,792,792,792,14,14,13,13,1,2,1,2,9,0,0,0,1,0
1007,1003,1003,1003,20,19,20,21,1,1,2,2,4,0,0,1,-1,-1
436,431,421,417,13,16,15,16,2,1,2,2,5,10,4,-3,1,-1
984,984,970,974,13,14,12,13,3,3,3,2,0,14,-4,-1,2,-1
403,403,403,398,13,14,12,13,3,1,1,2,0,0,5,-1,2,-1
867,867,871,862,14,17,15,16,1,1,2,2,0,-4,9,-3,2,-1
876,881,876,871,14,14,13,13,2,1,1,3,-5,5,5,0,1,0
543,539,534,534,21,19,18,18,1,1,1,2,4,5,0,2,1,0
342,337,337,332,13,14,15,13,3,1,2,1,5,0,5,-1,-1,2
510,510,506,506,14,14,13,13,2,3,2,2,0,4,0,0,1,0
806,801,806,801,18,19,18,19,1,2,2,1,5,-5,5,-1,1,-1
590,590,581,581,18,17,18,16,3,1,1,1,0,9,0,1,-1,2
674,670,670,665,17,16,18,18,3,3,1,2,4,0,5,1,-2,0
750,740,736,736,20,19,18,18,1,1,1,1,10,4,0,1,1,0
951,946,946,937,13,14,12,13,1,2,1,4,5,0,9,-1,2,-1
1012,1012,1017,1012,20,19,18,18,3,1,2,1,0,-5,5,1,1,0
281,262,257,253,14,17,15,16,1,2,1,2,19,5,4,-3,2,-1
496,492,492,492,18,19,18,19,1,1,1,3,4,0,0,-1,1,-1
567,567,567,562,14,17,15,16,3,1,2,1,0,0,5,-3,2,-1
370,360,360,360,13,14,12,13,1,2,2,3,10,0,0,-1,2,-1
557,553,562,553,14,14,13,13,1,2,1,2,4,-9,9,0,1,0
754,740,745,740,13,14,12,13,2,2,2,2,14,-5,5,-1,2,-1
867,862,857,862,18,17,18,18,3,1,1,1,5,5,-5,1,-1,0
290,286,286,286,21,19,20,21,1,1,1,1,4,0,0,2,-1,-1
679,674,674,674,13,14,15,16,1,2,1,2,5,0,0,-1,-1,-1
332,323,323,314,17,19,18,19,1,2,2,1,9,0,9,-2,1,-1
646,646,651,646,13,14,12,13,3,2,4,1,0,-5,5,-1,2,-1
234,229,229,224,18,19,18,19,1,1,2,2,5,0,5,-1,1,-1
623,628,618,618,14,14,15,13,2,1,2,2,-5,10,0,0,-1,2
946,942,946,937,20,19,20,18,1,1,2,2,4,-4,9,1,-1,2
951,946,942,946,20,19,20,21,3,2,1,1,5,4,-4,1,-1,-1
365,360,356,360,13,14,12,13,3,3,1,3,5,4,-4,-1,2,-1
1064,1064,1064,1064,13,16,15,16,3,2,1,1,0,0,0,-3,1,-1
736,726,721,717,13,14,15,16,1,1,2,2,10,5,4,-1,-1,-1
229,224,220,220,14,14,15,13,2,3,3,3,5,4,0,0,-1,2
623,618,623,618,21,19,21,21,1,2,2,2,5,-5,5,2,-2,0
253,239,234,224,14,14,15,13,3,3,1,2,14,5,10,0,-1,2
914,909,909,904,18,19,18,19,3,1,1,3,5,0,5,-1,1,-1
839,834,829,834,14,14,15,13,1,1,3,1,5,5,-5,0,-1,2
909,904,909,909,14,17,15,16,2,2,1,1,5,-5,0,-3,2,-1
492,501,487,487,14,17,15,16,2,1,3,1,-9,14,0,-3,2,-1
679,674,670,674,13,14,12,13,1,3,3,3,5,4,-4,-1,2,-1
721,712,703,707,13,14,15,13,2,3,3,1,9,9,-4,-1,-1,2
412,407,407,407,20,19,20,21,3,1,3,1,5,0,0,1,-1,-1
600,590,595,590,14,14,13,13,1,2,1,1,10,-5,5,0,1,0
693,684,689,679,13,14,15,13,2,2,3,2,9,-5,10,-1,-1,2
581,576,576,571,18,17,18,18,2,2,3,1,5,0,5,1,-1,0
201,187,187,1073,14,17,15,16,3,3,2,2,14,0,-886,-3,2,-1
750,736,740,736,13,14,12,13,2,2,2,2,14,-4,4,-1,2,-1
243,234,234,234,21,19,20,18,2,1,1,1,9,0,0,2,-1,2
210,201,201,196,14,14,13,13,3,2,2,1,9,0,5,0,1,0
1045,1050,1045,1045,17,16,18,18,1,1,2,3,-5,5,0,1,-2,0
492,487,487,487,14,14,15,16,3,1,3,3,5,0,0,0,-1,-1
848,843,843,839,14,14,13,13,1,2,1,1,5,0,4,0,1,0
192,192,192,192,21,19,21,19,1,2,2,1,0,0,0,2,-2,2
731,726,731,731,20,19,18,18,1,1,3,1,5,-5,0,1,1,0
890,876,876,876,21,19,20,21,1,2,1,1,14,0,0,2,-1,-1
881,871,881,881,21,19,20,19,1,3,1,2,10,-10,0,2,-1,1
478,478,473,473,20,19,18,18,2,1,1,2,0,5,0,1,1,0
201,187,192,187,14,14,15,13,2,3,3,1,14,-5,5,0,-1,2
595,590,595,595,14,17,15,16,3,2,1,2,5,-5,0,-3,2,-1
407,403,398,393,13,14,15,13,1,2,1,2,4,5,5,-1,-1,2
1031,1031,1026,1031,13,14,15,13,2,4,3,1,0,5,-5,-1,-1,2
529,520,520,520,18,17,18,19,2,2,1,1,9,0,0,1,-1,-1
534,529,529,529,14,14,15,13,5,2,2,1,5,0,0,0,-1,2
871,871,867,867,21,19,20,18,1,3,2,3,0,4,0,2,-1,2
450,445,440,440,13,14,15,13,2,2,4,2,5,5,0,-1,-1,2
942,932,928,928,17,19,18,19,2,2,2,1,10,4,0,-2,1,-1
478,468,468,464,17,16,15,16,1,2,1,1,10,0,4,1,1,-1
900,881,871,871,14,14,15,13,1,2,1,1,19,10,0,0,-1,2
660,656,646,646,17,16,18,16,1,3,1,1,4,10,0,1,-2,2
623,614,614,614,14,14,13,13,2,2,3,3,9,0,0,0,1,0
782,782,787,782,18,19,18,19,2,2,2,2,0,-5,5,-1,1,-1
1031,1026,1026,1031,13,14,12,13,2,2,2,1,5,0,-5,-1,2,-1
407,403,403,403,17,16,18,16,1,3,4,1,4,0,0,1,-2,2
243,239,243,243,21,19,20,21,1,2,1,1,4,-4,0,2,-1,-1
389,389,389,384,20,19,20,21,2,1,1,3,0,0,5,1,-1,-1
965,965,960,960,13,14,12,13,3,3,1,1,0,5,0,-1,2,-1
736,726,736,745,20,19,20,18,2,2,1,1,10,-10,-9,1,-1,2
539,543,539,539,14,14,15,16,2,1,1,1,-4,4,0,0,-1,-1
534,534,539,534,14,14,15,13,2,2,2,3,0,-5,5,0,-1,2
1026,1021,1017,1017,13,14,15,13,2,3,1,3,5,4,0,-1,-1,2
454,450,450,450,20,19,20,21,2,2,1,1,4,0,0,1,-1,-1
979,974,970,970,20,19,20,18,2,3,1,1,5,4,0,1,-1,2
834,829,834,824,18,17,18,16,1,3,3,4,5,-5,10,1,-1,2
342,332,332,337,17,16,18,16,3,2,1,1,10,0,-5,1,-2,2
806,801,806,806,18,17,18,16,1,1,2,1,5,-5,0,1,-1,2
848,834,834,834,18,17,18,18,1,2,1,1,14,0,0,1,-1,0
909,890,886,876,14,14,13,13,1,2,1,2,19,4,10,0,1,0
979,965,970,965,13,14,12,13,2,2,2,1,14,-5,5,-1,2,-1
473,459,459,454,17,16,18,16,1,1,3,1,14,0,5,1,-2,2
482,473,468,468,14,14,12,13,1,3,1,2,9,5,0,0,2,-1
403,393,393,393,17,16,18,16,3,2,1,2,10,0,0,1,-2,2
951,956,951,951,13,14,15,16,1,3,1,1,-5,5,0,-1,-1,-1
871,857,853,848,14,14,15,13,1,1,3,2,14,4,5,0,-1,2
595,590,586,586,14,17,15,16,2,3,1,2,5,4,0,-3,2,-1
609,609,604,604,14,14,13,13,2,3,1,2,0,5,0,0,1,0
815,801,792,782,14,14,13,13,2,2,2,2,14,9,10,0,1,0
623,618,628,623,18,17,18,19,2,2,2,2,5,-10,5,1,-1,-1
553,548,548,548,18,17,18,18,1,3,1,2,5,0,0,1,-1,0
515,501,506,501,14,14,13,13,3,2,3,1,14,-5,5,0,1,0
839,839,834,834,14,17,15,16,2,2,1,1,0,5,0,-3,2,-1
881,876,876,876,14,17,15,16,2,2,1,2,5,0,0,-3,2,-1
543,529,520,524,18,17,18,19,1,2,2,3,14,9,-4,1,-1,-1
295,295,295,286,18,17,18,16,1,1,2,1,0,0,9,1,-1,2
567,562,590,604,21,19,20,21,1,4,1,2,5,-28,-14,2,-1,-1
900,900,890,890,18,19,18,19,3,1,1,1,0,10,0,-1,1,-1
665,660,660,656,20,19,18,18,1,1,2,1,5,0,4,1,1,0
496,496,496,496,18,17,18,19,3,2,2,2,0,0,0,1,-1,-1
243,229,234,234,14,14,15,13,3,2,1,3,14,-5,0,0,-1,2
271,271,271,271,18,19,18,18,2,2,3,1,0,0,0,-1,1,0
281,276,271,271,14,17,15,16,2,2,1,2,5,5,0,-3,2,-1
1073,1068,1068,1064,13,16,15,16,3,2,1,2,5,0,4,-3,1,-1
323,318,323,318,21,19,21,21,2,2,1,5,5,-5,5,2,-2,0
895,890,886,886,14,14,13,13,2,1,1,2,5,4,0,0,1,0
464,459,454,454,13,14,12,13,4,3,1,1,5,5,0,-1,2,-1
543,539,539,534,14,14,15,13,3,3,2,4,4,0,5,0,-1,2
834,834,834,829,18,17,18,19,3,1,1,6,0,0,5,1,-1,-1
210,229,196,201,14,17,15,16,1,1,3,3,-19,33,-5,-3,2,-1
979,970,970,970,17,16,18,18,2,2,1,1,9,0,0,1,-2,0
900,904,900,900,18,17,18,19,3,3,1,1,-4,4,0,1,-1,-1
970,960,956,956,17,16,18,18,2,4,2,3,10,4,0,1,-2,0
721,712,717,712,13,14,15,16,2,2,2,3,9,-5,5,-1,-1,-1
295,295,290,290,18,17,18,16,2,3,1,3,0,5,0,1,-1,2
1031,1026,1021,1021,17,16,18,16,3,2,1,2,5,5,0,1,-2,2
857,862,857,853,18,19,18,18,1,1,1,2,-5,5,4,-1,1,0
468,464,464,459,13,14,15,16,1,2,2,1,4,0,5,-1,-1,-1
403,393,384,384,17,16,15,16,2,1,1,3,10,9,0,1,1,-1
436,426,426,421,13,14,15,13,1,2,1,1,10,0,5,-1,-1,2
412,407,412,407,13,16,15,16,3,2,2,1,5,-5,5,-3,1,-1
356,356,351,351,20,19,18,18,1,1,3,1,0,5,0,1,1,0
267,262,262,262,21,19,20,21,1,1,1,1,5,0,0,2,-1,-1
843,843,843,839,14,14,15,13,2,2,1,2,0,0,4,0,-1,2
557,553,553,576,14,14,15,13,1,2,3,1,4,0,-23,0,-1,2
1064,1059,1064,1059,17,16,15,16,2,2,2,3,5,-5,5,1,1,-1
909,900,895,900,14,14,15,13,3,2,1,3,9,5,-5,0,-1,2
759,750,754,759,20,19,20,18,1,2,1,3,9,-4,-5,1,-1,2
993,984,989,984,17,16,18,18,1,2,2,2,9,-5,5,1,-2,0
904,895,895,895,18,17,18,16,1,1,1,1,9,0,0,1,-1,2
960,956,951,956,13,16,15,16,2,3,1,1,4,5,-5,-3,1,-1
234,229,229,224,21,19,20,19,1,1,1,2,5,0,5,2,-1,1
965,956,956,956,13,14,12,13,3,3,2,4,9,0,0,-1,2,-1
281,281,286,286,18,19,18,19,2,2,2,1,0,-5,0,-1,1,-1
745,736,736,736,13,14,12,13,1,5,2,1,9,0,0,-1,2,-1
871,871,867,871,18,19,18,18,2,1,1,3,0,4,-4,-1,1,0
295,234,234,239,14,17,15,16,2,1,1,2,61,0,-5,-3,2,-1
810,806,806,806,14,14,15,13,1,1,2,1,4,0,0,0,-1,2
876,867,862,862,14,14,15,16,1,3,2,1,9,5,0,0,-1,-1
210,206,206,196,14,14,15,16,2,2,1,1,4,0,10,0,-1,-1
360,356,356,356,13,14,12,13,1,4,1,2,4,0,0,-1,2,-1
1059,1054,1064,1064,20,19,20,21,2,1,2,2,5,-10,0,1,-1,-1
876,867,871,862,14,14,13,13,1,2,2,3,9,-4,9,0,1,0
210,201,206,201,14,14,15,13,1,2,2,1,9,-5,5,0,-1,2
914,909,904,904,18,19,18,19,2,3,1,2,5,5,0,-1,1,-1
595,586,586,581,14,14,15,13,2,4,2,3,9,0,5,0,-1,2
436,431,431,431,13,14,15,13,3,1,4,3,5,0,0,-1,-1,2
998,984,979,984,13,14,12,13,2,1,1,1,14,5,-5,-1,2,-1
365,360,356,356,17,16,15,16,1,2,3,2,5,4,0,1,1,-1
834,824,829,820,14,17,15,16,3,1,2,2,10,-5,9,-3,2,-1
201,196,196,196,21,19,21,21,1,1,1,2,5,0,0,2,-2,0
731,721,721,717,20,19,20,21,2,2,2,2,10,0,4,1,-1,-1
543,534,534,529,14,14,13,13,1,3,2,2,9,0,5,0,1,0
445,440,440,436,20,19,18,18,2,2,1,1,5,0,4,1,1,0
970,970,965,974,20,19,20,21,3,1,1,1,0,5,-9,1,-1,-1
960,951,951,956,17,19,18,18,1,2,3,1,9,0,-5,-2,1,0
745,740,740,736,13,14,15,13,1,2,2,2,5,0,4,-1,-1,2
656,646,646,642,17,16,18,16,2,1,2,2,10,0,4,1,-2,2
187,1064,1064,1059,18,19,18,18,1,4,2,2,-877,0,5,-1,1,0
773,750,759,759,13,14,15,13,4,2,2,1,23,-9,0,-1,-1,2
304,295,290,295,14,14,13,13,1,3,1,3,9,5,-5,0,1,0
562,553,557,553,14,14,13,13,1,2,2,2,9,-4,4,0,1,0
201,196,196,201,14,14,13,13,2,3,1,1,5,0,-5,0,1,0
740,740,740,736,17,16,15,16,1,2,1,1,0,0,4,1,1,-1
862,843,839,834,14,14,13,13,1,1,1,2,19,4,5,0,1,0
215,206,206,206,14,14,13,13,1,3,2,3,9,0,0,0,1,0
370,360,365,360,13,14,12,13,1,1,2,1,10,-5,5,-1,2,-1
618,614,618,614,18,19,18,19,3,2,2,1,4,-4,4,-1,1,-1
1050,1050,1045,1040,20,19,20,18,1,1,1,1,0,5,5,1,-1,2
970,970,965,965,13,16,15,16,1,1,1,1,0,5,0,-3,1,-1
220,215,215,215,21,19,20,21,3,2,1,1,5,0,0,2,-1,-1
834,829,829,824,18,17,18,16,5,2,2,1,5,0,5,1,-1,2
829,824,824,824,14,14,13,13,2,2,2,2,5,0,0,0,1,0
220,215,215,220,14,14,15,13,1,2,1,3,5,0,-5,0,-1,2
684,679,684,684,13,14,15,16,2,1,3,3,5,-5,0,-1,-1,-1
239,239,234,229,18,17,18,19,1,1,1,1,0,5,5,1,-1,-1
923,923,918,918,21,19,21,19,1,1,2,3,0,5,0,2,-2,2
515,510,515,510,21,19,20,19,1,3,2,1,5,-5,5,2,-1,1
1050,1040,1050,1040,13,14,12,13,2,2,1,2,10,-10,10,-1,2,-1
1068,1068,1068,1064,13,14,12,13,1,3,2,3,0,0,4,-1,2,-1
1003,989,979,965,13,14,12,13,2,2,2,2,14,10,14,-1,2,-1
342,337,332,332,13,14,13,13,1,4,1,1,5,5,0,-1,1,0
539,524,515,520,18,19,18,19,2,1,1,1,15,9,-5,-1,1,-1
989,979,979,979,13,16,15,16,3,2,3,2,10,0,0,-3,1,-1
834,829,829,824,14,17,15,16,2,3,1,5,5,0,5,-3,2,-1
229,234,224,224,14,17,15,16,1,1,1,1,-5,10,0,-3,2,-1
1073,1068,1073,1064,13,14,15,13,3,3,2,1,5,-5,9,-1,-1,2
651,646,646,646,20,19,20,21,2,2,1,4,5,0,0,1,-1,-1
796,787,787,787,18,17,18,19,1,2,1,1,9,0,0,1,-1,-1
323,318,323,323,14,17,15,16,2,5,2,1,5,-5,0,-3,2,-1
824,824,820,810,18,19,18,19,1,1,2,2,0,4,10,-1,1,-1
295,290,286,281,18,19,18,19,3,2,3,2,5,4,5,-1,1,-1
576,581,571,571,18,17,18,16,1,1,1,1,-5,10,0,1,-1,2
600,595,595,595,14,17,15,16,1,1,1,2,5,0,0,-3,2,-1
496,501,496,501,21,19,21,19,3,1,1,1,-5,5,-5,2,-2,2
262,487,243,243,14,17,15,16,2,1,1,2,-225,244,0,-3,2,-1
586,581,590,581,14,14,13,13,4,4,2,2,5,-9,9,0,1,0
243,229,220,220,18,17,15,16,1,3,2,1,14,9,0,1,2,-1
309,309,309,304,14,17,15,16,2,2,1,2,0,0,5,-3,2,-1
567,557,562,557,18,19,18,18,3,2,2,2,10,-5,5,-1,1,0
267,257,262,257,18,19,18,18,3,2,2,2,10,-5,5,-1,1,0
478,478,473,468,13,16,15,16,2,1,1,2,0,5,5,-3,1,-1
979,974,974,970,17,16,15,16,1,2,2,1,5,0,4,1,1,-1
815,810,810,815,21,19,20,21,3,2,1,1,5,0,-5,2,-1,-1
824,824,829,824,21,19,20,21,1,2,2,2,0,-5,5,2,-1,-1
1078,1073,1073,1073,17,16,15,16,1,1,1,1,5,0,0,1,1,-1
393,384,389,515,17,16,15,13,3,1,2,1,9,-5,-126,1,1,2
623,614,604,604,14,14,15,13,1,3,2,1,9,10,0,0,-1,2
464,459,464,468,17,16,15,16,2,3,3,2,5,-5,-4,1,1,-1
1054,1045,1050,1045,17,16,18,18,2,2,2,1,9,-5,5,1,-2,0
632,637,637,632,13,14,15,13,1,1,2,1,-5,0,5,-1,-1,2
820,815,810,810,14,14,13,13,4,3,3,1,5,5,0,0,1,0
600,595,590,590,21,19,20,21,2,1,1,1,5,5,0,2,-1,-1
300,290,290,286,18,19,18,19,3,2,2,2,10,0,4,-1,1,-1
759,764,764,759,20,19,20,18,3,3,1,2,-5,0,5,1,-1,2
824,834,829,834,14,17,15,16,2,3,4,1,-10,5,-5,-3,2,-1
670,665,665,670,20,19,20,18,1,2,2,2,5,0,-5,1,-1,2
534,529,534,529,21,19,20,21,1,1,1,3,5,-5,5,2,-1,-1
187,1073,1073,1073,14,16,15,16,1,2,2,2,-886,0,0,-2,1,-1
900,890,886,886,14,17,15,16,3,1,1,1,10,4,0,-3,2,-1
829,829,829,824,14,14,15,13,2,1,1,1,0,0,5,0,-1,2
956,956,956,951,20,19,20,18,3,1,2,1,0,0,5,1,-1,2
989,989,984,984,17,16,15,16,1,2,2,1,0,5,0,1,1,-1
342,337,337,332,13,14,12,13,1,1,2,1,5,0,5,-1,2,-1
342,337,342,342,17,16,18,16,1,1,3,1,5,-5,0,1,-2,2
210,192,1078,1078,14,17,15,16,2,3,1,1,18,-886,0,-3,2,-1
923,918,914,914,18,19,18,19,2,3,1,1,5,4,0,-1,1,-1
1026,1021,1021,1017,20,19,20,18,2,1,1,2,5,0,4,1,-1,2
534,534,534,524,14,17,15,16,3,2,3,2,0,0,10,-3,2,-1
351,346,351,346,20,19,20,18,1,3,2,1,5,-5,5,1,-1,2
890,886,881,881,21,19,20,19,3,2,1,2,4,5,0,2,-1,1
473,468,464,464,17,16,15,16,1,1,4,1,5,4,0,1,1,-1
398,393,398,389,20,19,20,21,3,1,2,2,5,-5,9,1,-1,-1
206,201,201,206,21,19,21,21,1,1,2,3,5,0,-5,2,-2,0
510,506,501,496,18,17,18,16,3,2,1,2,4,5,5,1,-1,2
1064,1050,1050,1050,13,14,15,16,1,2,2,3,14,0,0,-1,-1,-1
562,562,557,557,14,14,13,13,2,3,1,2,0,5,0,0,1,0
210,201,201,206,14,14,13,13,1,2,1,1,9,0,-5,0,1,0
271,271,276,271,14,17,15,16,2,2,2,1,0,-5,5,-3,2,-1
407,407,393,398,13,14,12,13,2,1,1,3,0,14,-5,-1,2,-1
571,562,562,553,14,14,13,13,1,1,2,2,9,0,9,0,1,0
965,965,965,965,20,19,20,18,1,1,1,1,0,0,0,1,-1,2
736,736,736,736,13,14,12,13,1,3,2,1,0,0,0,-1,2,-1
506,501,506,506,18,19,18,19,2,2,2,1,5,-5,0,-1,1,-1
960,956,956,951,13,16,15,16,1,2,2,2,4,0,5,-3,1,-1
646,642,646,642,13,14,12,13,1,4,2,3,4,-4,4,-1,2,-1
712,707,707,707,20,19,20,18,1,1,2,1,5,0,0,1,-1,2
965,965,956,965,17,16,18,18,2,1,1,1,0,9,-9,1,-2,0
253,239,248,243,18,19,18,18,3,2,2,2,14,-9,5,-1,1,0
740,717,1078,712,13,14,10,13,2,2,1,1,23,-361,366,-1,4,-3
421,417,684,417,13,14,20,13,3,2,1,2,4,-267,267,-1,-6,7
487,473,478,482,18,16,18,16,1,2,2,1,14,-5,-4,2,-2,2
431,426,417,412,13,14,15,13,1,3,1,2,5,9,5,-1,-1,2
848,843,839,839,21,19,20,21,1,2,1,1,5,4,0,2,-1,-1
206,206,206,206,14,14,13,13,3,3,1,1,0,0,0,0,1,0
993,993,989,993,20,19,20,18,1,3,1,3,0,4,-4,1,-1,2
1040,1036,1036,1026,13,14,15,13,2,3,2,2,4,0,10,-1,-1,2
323,323,318,318,21,19,21,21,2,1,1,1,0,5,0,2,-2,0
674,665,670,670,13,14,12,13,1,2,3,2,9,-5,0,-1,2,-1
586,600,600,595,14,14,13,13,1,2,1,2,-14,0,5,0,1,0
886,881,881,876,18,19,20,18,3,1,1,1,5,0,5,-1,-1,2
623,614,618,614,14,14,13,13,1,3,2,1,9,-4,4,0,1,0
989,984,984,979,13,14,12,13,1,1,1,2,5,0,5,-1,2,-1
876,871,871,871,14,17,15,16,2,2,1,1,5,0,0,-3,2,-1
581,571,576,571,21,19,20,21,1,2,2,2,10,-5,5,2,-1,-1
646,642,642,642,17,16,18,18,1,2,1,1,4,0,0,1,-2,0
600,586,595,590,14,14,15,16,1,2,2,2,14,-9,5,0,-1,-1
1045,1040,1045,1045,17,16,18,16,2,3,2,3,5,-5,0,1,-2,2
436,436,445,707,17,16,12,13,1,2,1,1,0,-9,-262,1,4,-1
464,412,412,407,13,19,18,18,1,2,1,2,52,0,5,-6,1,0
506,501,501,501,21,19,21,19,4,5,1,1,5,0,0,2,-2,2
946,942,942,942,13,14,15,16,3,2,1,1,4,0,0,-1,-1,-1
970,965,960,960,13,14,12,13,3,2,1,1,5,5,0,-1,2,-1
417,412,412,417,17,16,18,18,1,3,1,2,5,0,-5,1,-2,0
750,740,740,745,13,14,12,13,3,2,2,3,10,0,-5,-1,2,-1
829,820,829,824,14,14,15,16,1,2,2,1,9,-9,5,0,-1,-1
229,224,229,229,18,17,18,16,2,2,1,3,5,-5,0,1,-1,2
196,187,192,182,21,19,21,19,3,1,5,2,9,-5,10,2,-2,2
524,515,510,510,21,19,20,19,1,4,1,2,9,5,0,2,-1,1
1003,998,998,998,20,19,18,18,5,2,1,3,5,0,0,1,1,0
464,459,454,450,13,14,12,13,3,3,1,2,5,5,4,-1,2,-1
886,881,881,881,14,17,15,16,1,1,1,3,5,0,0,-3,2,-1
257,253,253,253,14,14,15,13,1,3,1,1,4,0,0,0,-1,2
970,960,960,960,13,14,15,16,3,4,3,1,10,0,0,-1,-1,-1
642,637,637,632,17,16,15,16,2,3,2,2,5,0,5,1,1,-1
801,796,792,787,18,17,18,16,1,1,2,1,5,4,5,1,-1,2
239,229,234,229,14,17,15,16,1,2,1,2,10,-5,5,-3,2,-1
374,360,346,342,17,19,18,18,1,1,1,2,14,14,4,-2,1,0
571,571,567,567,14,17,15,16,1,3,3,2,0,4,0,-3,2,-1
1021,1026,1021,1021,13,16,15,16,1,1,1,3,-5,5,0,-3,1,-1
890,890,890,890,21,19,20,21,2,3,3,3,0,0,0,2,-1,-1
398,389,398,398,20,19,20,18,1,2,2,1,9,-9,0,1,-1,2
309,309,309,309,14,17,15,16,2,2,3,1,0,0,0,-3,2,-1
736,731,726,726,17,19,18,18,1,1,3,1,5,5,0,-2,1,0
1068,1064,1068,1064,17,16,18,18,2,1,2,2,4,-4,4,1,-2,0
848,843,843,843,14,17,15,16,3,2,2,1,5,0,0,-3,2,-1
787,787,787,782,21,19,21,21,2,1,1,1,0,0,5,2,-2,0
487,487,478,473,21,19,20,21,4,1,1,1,0,9,5,2,-1,-1
524,524,520,520,14,14,15,16,2,3,1,1,0,4,0,0,-1,-1
960,951,956,956,20,19,20,18,2,2,2,1,9,-5,0,1,-1,2
993,993,989,989,20,19,20,18,1,1,1,2,0,4,0,1,-1,2
839,740,740,731,14,14,12,13,1,1,4,1,99,0,9,0,2,-1
426,417,243,412,13,14,18,13,3,2,1,4,9,174,-169,-1,-4,5
384,374,379,374,17,16,15,16,2,2,2,2,10,-5,5,1,1,-1
529,524,520,534,18,17,18,16,2,2,1,1,5,4,-14,1,-1,2
1040,1036,1036,1036,20,19,20,21,2,2,1,2,4,0,0,1,-1,-1
618,609,618,614,14,14,13,13,2,2,2,1,9,-9,4,0,1,0
257,248,248,243,21,19,20,21,3,1,1,1,9,0,5,2,-1,-1
571,571,571,567,14,17,15,16,2,2,3,2,0,0,4,-3,2,-1
304,290,300,304,14,17,15,16,2,2,2,3,14,-10,-4,-3,2,-1
824,824,824,820,18,17,18,16,2,4,2,2,0,0,4,1,-1,2
328,318,318,323,14,14,13,13,1,2,2,1,10,0,-5,0,1,0
196,192,192,192,14,17,15,16,3,3,2,1,4,0,0,-3,2,-1
862,754,754,750,14,19,18,18,1,1,2,1,108,0,4,-5,1,0
496,487,492,492,21,19,21,19,2,2,1,1,9,-5,0,2,-2,2
257,257,253,253,21,19,20,18,2,3,1,3,0,4,0,2,-1,2
389,384,384,379,20,19,20,21,2,1,2,1,5,0,5,1,-1,-1
337,332,337,342,20,19,18,18,1,1,1,1,5,-5,-5,1,1,0
853,843,848,848,18,17,18,18,1,2,1,1,10,-5,0,1,-1,0
989,979,979,979,17,19,18,18,1,1,5,1,10,0,0,-2,1,0
370,379,374,370,20,19,18,18,1,3,2,1,-9,5,4,1,1,0
473,468,464,464,17,16,15,16,3,1,3,2,5,4,0,1,1,-1
482,487,487,482,14,17,15,16,1,2,2,1,-5,0,5,-3,2,-1
712,707,698,684,13,14,12,13,3,3,2,2,5,9,14,-1,2,-1
731,726,717,750,17,16,15,16,1,1,3,2,5,9,-33,1,1,-1
824,815,815,810,18,17,18,19,2,2,1,2,9,0,5,1,-1,-1
750,736,726,726,13,14,12,13,3,3,1,2,14,10,0,-1,2,-1
736,731,731,726,13,14,12,13,1,2,3,2,5,0,5,-1,2,-1
501,487,487,487,18,19,18,19,1,1,1,1,14,0,0,-1,1,-1
604,604,600,600,18,17,18,19,2,1,2,1,0,4,0,1,-1,-1
867,857,857,853,14,17,15,16,1,1,1,2,10,0,4,-3,2,-1
698,684,679,679,13,14,15,13,2,3,2,1,14,5,0,-1,-1,2
309,300,300,300,18,17,18,19,1,2,1,1,9,0,0,1,-1,-1
487,482,478,478,18,17,18,18,3,2,1,1,5,4,0,1,-1,0
262,257,257,257,18,17,18,16,2,2,1,1,5,0,0,1,-1,2
318,314,309,309,18,19,18,19,2,2,2,1,4,5,0,-1,1,-1
337,323,323,323,13,14,15,16,2,2,1,1,14,0,0,-1,-1,-1
412,403,398,398,17,16,18,16,2,3,1,1,9,5,0,1,-2,2
871,862,862,867,18,19,18,18,1,1,1,1,9,0,-5,-1,1,0
942,932,923,923,13,14,15,13,1,2,2,1,10,9,0,-1,-1,2
618,609,604,600,14,17,15,16,1,1,2,3,9,5,4,-3,2,-1
1045,1036,1045,1050,17,16,18,16,2,1,1,2,9,-9,-5,1,-2,2
979,979,974,974,17,19,18,18,1,3,1,1,0,5,0,-2,1,0
276,271,276,271,18,17,18,18,1,1,2,1,5,-5,5,1,-1,0
192,192,187,187,21,19,21,21,2,1,3,2,0,5,0,2,-2,0
1059,1059,1054,1054,17,16,18,18,2,1,1,1,0,5,0,1,-2,0
707,703,703,703,17,16,18,18,3,3,1,1,4,0,0,1,-2,0
843,834,829,829,14,17,15,16,2,3,3,1,9,5,0,-3,2,-1
187,182,182,187,18,19,18,19,3,1,1,1,5,0,-5,-1,1,-1
276,271,271,267,14,14,13,13,1,3,2,3,5,0,4,0,1,0
928,890,886,890,14,17,15,16,1,1,2,2,38,4,-4,-3,2,-1
412,407,407,403,13,14,15,13,3,1,2,1,5,0,4,-1,-1,2
993,984,984,979,13,14,12,13,4,1,2,2,9,0,5,-1,2,-1
796,787,787,792,14,14,13,13,3,2,1,2,9,0,-5,0,1,0
351,346,346,346,17,16,15,16,2,4,2,1,5,0,0,1,1,-1
281,281,281,281,21,19,20,21,2,3,1,1,0,0,0,2,-1,-1
421,417,417,412,13,14,15,13,2,2,2,2,4,0,5,-1,-1,2
300,295,295,300,14,14,15,13,3,2,3,1,5,0,-5,0,-1,2
759,750,754,754,17,16,18,16,2,2,1,1,9,-4,0,1,-2,2
445,431,436,431,13,14,15,13,1,1,1,2,14,-5,5,-1,-1,2
520,510,510,515,18,19,18,19,1,2,1,2,10,0,-5,-1,1,-1
196,192,187,182,18,17,18,19,2,1,2,2,4,5,5,1,-1,-1
337,323,323,323,13,14,15,13,2,2,1,1,14,0,0,-1,-1,2
890,886,886,886,18,17,18,16,2,1,2,1,4,0,0,1,-1,2
900,890,895,895,14,14,15,13,3,2,1,3,10,-5,0,0,-1,2
890,886,890,886,18,19,18,19,1,3,2,1,4,-4,4,-1,1,-1
436,436,436,436,17,16,15,16,2,1,1,1,0,0,0,1,1,-1
998,989,989,984,20,19,18,18,2,2,2,1,9,0,5,1,1,0
736,731,726,745,20,19,20,21,2,3,1,1,5,5,-19,1,-1,-1
571,571,571,557,21,19,20,21,1,3,2,2,0,0,14,2,-1,-1
792,787,782,782,21,19,21,21,3,1,1,1,5,5,0,2,-2,0
721,717,721,717,20,19,20,18,1,2,2,1,4,-4,4,1,-1,2
698,689,693,693,13,14,12,13,1,2,2,2,9,-4,0,-1,2,-1
1031,1031,1026,1026,20,19,20,18,1,2,1,2,0,5,0,1,-1,2
229,224,229,229,14,14,15,13,1,2,2,1,5,-5,0,0,-1,2
937,923,923,928,13,14,15,13,2,2,1,1,14,0,-5,-1,-1,2
815,810,815,815,18,17,18,19,1,2,1,1,5,-5,0,1,-1,-1
496,492,492,492,14,14,13,13,1,2,1,3,4,0,0,0,1,0
853,834,829,829,14,14,13,13,3,3,1,1,19,5,0,0,1,0
248,248,243,243,18,17,18,18,2,2,1,2,0,5,0,1,-1,0
637,623,623,623,13,14,15,13,2,2,1,2,14,0,0,-1,-1,2
365,360,360,356,13,16,15,16,2,2,2,2,5,0,4,-3,1,-1
201,201,201,196,21,19,21,19,1,2,1,1,0,0,5,2,-2,2
792,787,787,787,14,17,15,16,1,1,1,2,5,0,0,-3,2,-1
346,337,323,318,13,14,13,13,2,2,1,1,9,14,5,-1,1,0
932,932,928,918,13,14,15,13,1,1,2,1,0,4,10,-1,-1,2
276,267,257,253,14,14,15,13,2,3,2,2,9,10,4,0,-1,2
904,904,900,900,21,19,20,19,2,1,1,2,0,4,0,2,-1,1
206,196,201,201,14,14,13,13,2,2,1,2,10,-5,0,0,1,0
515,510,510,506,14,17,15,16,2,2,2,1,5,0,4,-3,2,-1
482,473,473,473,14,14,15,16,1,3,1,2,9,0,0,0,-1,-1
857,857,848,848,14,17,15,16,1,5,1,2,0,9,0,-3,2,-1
717,707,712,707,13,14,15,13,1,2,1,2,10,-5,5,-1,-1,2
829,820,824,820,14,14,13,13,1,2,2,2,9,-4,4,0,1,0
196,192,182,182,14,14,13,13,2,3,1,1,4,10,0,0,1,0
1036,1031,1036,1031,17,16,15,16,1,2,2,1,5,-5,5,1,1,-1
1026,1021,1017,1012,13,14,15,13,2,4,3,2,5,4,5,-1,-1,2
1078,1073,1068,1068,13,16,15,16,2,1,1,1,5,5,0,-3,1,-1
778,773,773,778,13,14,12,13,2,2,2,1,5,0,-5,-1,2,-1
740,736,731,731,13,14,12,13,1,2,2,3,4,5,0,-1,2,-1
473,468,468,464,20,19,20,18,2,1,1,1,5,0,4,1,-1,2
407,398,398,398,20,19,20,18,2,1,4,1,9,0,0,1,-1,2
253,248,253,253,14,17,15,16,2,3,2,4,5,-5,0,-3,2,-1
590,581,586,586,21,19,20,19,1,2,1,1,9,-5,0,2,-1,1
656,651,651,646,20,19,20,18,5,2,2,1,5,0,5,1,-1,2
914,918,914,914,14,17,15,16,4,3,3,2,-4,4,0,-3,2,-1
271,271,271,262,18,17,18,18,3,1,2,1,0,0,9,1,-1,0
754,750,750,750,17,19,18,18,2,1,2,1,4,0,0,-2,1,0
360,356,356,351,17,19,18,18,2,1,1,1,4,0,5,-2,1,0
914,909,909,904,21,19,21,21,1,1,1,2,5,0,5,2,-2,0
886,886,881,881,14,17,15,16,2,2,1,1,0,5,0,-3,2,-1
539,534,534,534,21,19,20,18,1,2,3,1,5,0,0,2,-1,2
1073,1073,1073,1073,20,19,20,21,1,2,3,1,0,0,0,1,-1,-1
1017,1017,1017,1017,13,14,15,16,1,3,1,3,0,0,0,-1,-1,-1
454,450,454,450,17,16,18,18,2,1,1,1,4,-4,4,1,-2,0
918,914,909,914,21,19,21,19,1,3,2,1,4,5,-5,2,-2,2
393,379,374,374,13,14,15,13,2,2,1,1,14,5,0,-1,-1,2
806,796,792,787,14,14,13,13,3,1,1,2,10,4,5,0,1,0
539,534,534,534,18,17,18,16,3,2,1,3,5,0,0,1,-1,2
829,824,824,820,18,19,18,19,1,3,2,2,5,0,4,-1,1,-1
1036,1026,1026,1026,13,14,12,13,1,3,1,2,10,0,0,-1,2,-1
614,604,623,604,21,19,21,21,1,2,2,1,10,-19,19,2,-2,0
679,674,674,684,17,16,15,16,3,2,3,1,5,0,-10,1,1,-1
487,473,473,473,14,16,15,16,1,2,2,1,14,0,0,-2,1,-1
951,951,956,956,17,19,18,18,1,4,1,2,0,-5,0,-2,1,0
923,923,923,923,18,17,18,16,2,2,1,3,0,0,0,1,-1,2
909,900,895,890,18,19,18,19,2,3,1,1,9,5,5,-1,1,-1
600,595,595,590,14,17,15,16,3,2,2,2,5,0,5,-3,2,-1
754,745,745,745,13,14,12,13,1,3,1,1,9,0,0,-1,2,-1
1036,1036,1031,1021,20,19,20,21,2,1,2,2,0,5,10,1,-1,-1
928,923,932,942,21,19,20,21,1,3,1,1,5,-9,-10,2,-1,-1
895,895,890,890,14,17,15,16,1,4,1,1,0,5,0,-3,2,-1
984,970,974,974,13,16,15,16,2,4,2,1,14,-4,0,-3,1,-1
665,670,665,665,20,19,18,18,1,1,1,1,-5,5,0,1,1,0
337,328,323,323,20,19,18,19,2,1,1,1,9,5,0,1,1,-1
895,895,904,890,21,19,20,21,2,1,1,2,0,-9,14,2,-1,-1
332,323,328,323,13,14,15,13,1,2,2,3,9,-5,5,-1,-1,2
595,600,604,604,14,14,13,13,2,2,1,3,-5,-4,0,0,1,0
674,670,660,665,13,14,15,13,2,2,1,1,4,10,-5,-1,-1,2
1031,1026,1026,1021,17,16,18,16,3,1,1,2,5,0,5,1,-2,2
731,726,717,717,17,16,15,16,2,3,1,3,5,9,0,1,1,-1
726,726,721,721,13,14,15,13,4,3,1,2,0,5,0,-1,-1,2
548,539,534,529,21,19,20,19,1,3,1,3,9,5,5,2,-1,1
590,576,571,576,21,19,20,21,1,2,1,3,14,5,-5,2,-1,-1
810,810,806,801,18,17,18,19,3,1,1,2,0,4,5,1,-1,-1
309,309,304,304,21,19,20,21,2,1,3,1,0,5,0,2,-1,-1
571,567,571,567,21,19,20,21,3,2,2,2,4,-4,4,2,-1,-1
248,253,248,248,14,14,15,13,2,1,1,3,-5,5,0,0,-1,2
1064,1054,1059,1059,17,16,18,16,1,2,5,1,10,-5,0,1,-2,2
656,651,656,651,20,19,20,18,1,2,2,2,5,-5,5,1,-1,2
234,234,229,229,14,14,15,13,2,2,1,1,0,5,0,0,-1,2
904,900,900,900,18,17,18,16,1,2,1,1,4,0,0,1,-1,2
248,248,248,243,14,17,15,16,3,1,2,2,0,0,5,-3,2,-1
590,581,581,581,14,17,15,16,3,2,1,2,9,0,0,-3,2,-1
1007,1003,1012,1007,17,16,15,16,1,2,2,1,4,-9,5,1,1,-1
665,660,660,665,20,19,20,18,1,2,1,1,5,0,-5,1,-1,2
281,267,262,262,14,17,15,16,3,3,3,3,14,5,0,-3,2,-1
403,403,407,403,20,19,20,18,1,1,2,1,0,-4,4,1,-1,2
370,360,356,356,13,14,15,13,3,1,1,1,10,4,0,-1,-1,2
731,721,721,721,13,14,12,13,2,5,1,1,10,0,0,-1,2,-1
295,295,295,290,18,19,18,19,2,2,1,1,0,0,5,-1,1,-1
618,609,609,604,14,14,15,16,2,3,1,1,9,0,5,0,-1,-1
1073,1068,1068,1064,17,16,15,16,3,2,1,2,5,0,4,1,1,-1
243,239,239,239,18,19,18,18,2,1,3,1,4,0,0,-1,1,0
974,970,970,970,17,19,18,18,2,2,1,1,4,0,0,-2,1,0
951,951,946,951,17,16,18,16,2,3,1,1,0,5,-5,1,-2,2
820,810,810,810,14,14,15,13,1,1,2,1,10,0,0,0,-1,2
848,839,839,839,18,19,18,18,2,2,1,1,9,0,0,-1,1,0
229,224,220,220,14,17,15,16,3,2,1,1,5,4,0,-3,2,-1
436,426,426,421,20,19,20,18,2,1,1,2,10,0,5,1,-1,2
286,281,281,276,21,19,20,21,2,1,1,2,5,0,5,2,-1,-1
946,946,946,946,13,16,15,16,3,2,2,1,0,0,0,-3,1,-1
801,796,796,787,18,19,18,19,1,1,1,2,5,0,9,-1,1,-1
623,618,614,614,14,14,15,13,2,2,1,1,5,4,0,0,-1,2
421,412,412,412,13,14,12,13,1,3,2,1,9,0,0,-1,2,-1
360,351,356,360,13,14,12,13,3,2,3,3,9,-5,-4,-1,2,-1
210,206,206,210,14,14,13,13,3,2,3,1,4,0,-4,0,1,0
337,332,337,332,13,14,15,13,2,2,2,1,5,-5,5,-1,-1,2
895,895,890,890,18,17,18,16,1,1,1,1,0,5,0,1,-1,2
229,229,234,229,14,14,13,13,2,3,1,2,0,-5,5,0,1,0
248,243,239,239,21,19,20,21,1,1,2,1,5,4,0,2,-1,-1
764,754,759,754,13,14,12,13,2,1,4,2,10,-5,5,-1,2,-1
323,328,323,318,18,17,18,19,2,1,3,4,-5,5,5,1,-1,-1
304,290,290,290,14,14,15,13,1,3,2,3,14,0,0,0,-1,2
759,750,750,750,17,16,18,18,1,2,3,2,9,0,0,1,-2,0
970,965,970,965,17,19,18,18,1,2,2,1,5,-5,5,-2,1,0
768,764,764,754,20,19,18,18,1,1,2,3,4,0,10,1,1,0
623,614,609,609,14,14,13,13,1,3,2,1,9,5,0,0,1,0
323,318,318,323,18,19,18,19,1,1,1,1,5,0,-5,-1,1,-1
600,595,590,586,14,14,13,13,1,3,1,1,5,5,4,0,1,0
853,848,843,839,14,14,13,13,3,3,2,2,5,5,4,0,1,0
660,651,651,651,20,19,18,18,3,1,3,1,9,0,0,1,1,0
389,384,379,379,20,19,20,21,2,1,2,1,5,5,0,1,-1,-1
946,946,942,942,13,14,12,13,2,3,2,1,0,4,0,-1,2,-1
689,679,679,679,13,14,12,13,2,1,2,4,10,0,0,-1,2,-1
515,506,501,501,14,14,15,13,1,3,2,2,9,5,0,0,-1,2
857,853,853,848,21,19,20,21,2,2,1,1,4,0,5,2,-1,-1
642,632,637,637,13,14,12,13,1,2,1,1,10,-5,0,-1,2,-1
932,890,886,886,13,17,15,16,1,1,1,3,42,4,0,-4,2,-1
567,553,557,557,18,19,18,18,3,2,1,1,14,-4,0,-1,1,0
553,548,548,548,14,14,15,16,2,3,2,1,5,0,0,0,-1,-1
965,960,956,956,20,19,18,18,1,1,3,2,5,4,0,1,1,0
571,571,571,571,21,19,20,18,2,2,1,1,0,0,0,2,-1,2
918,909,914,909,14,14,15,13,3,1,2,1,9,-5,5,0,-1,2
660,651,651,651,13,16,15,16,3,3,1,1,9,0,0,-3,1,-1
440,436,431,431,20,19,18,18,3,2,1,6,4,5,0,1,1,0
984,979,979,979,17,16,15,16,2,2,1,1,5,0,0,1,1,-1
731,642,637,637,20,19,20,18,1,4,3,3,89,5,0,1,-1,2
426,417,412,417,13,14,15,13,2,2,1,1,9,5,-5,-1,-1,2
1078,1073,1068,1068,13,14,12,13,2,3,1,1,5,5,0,-1,2,-1
942,942,243,937,13,14,15,13,3,1,1,2,0,699,-694,-1,-1,2
571,571,571,567,18,19,18,18,2,3,1,2,0,0,4,-1,1,0
651,646,651,646,20,19,20,21,1,2,2,2,5,-5,5,1,-1,-1
318,314,314,309,14,14,15,16,1,2,2,2,4,0,5,0,-1,-1
567,567,571,571,18,19,18,18,2,3,2,1,0,-4,0,-1,1,0
576,571,562,562,14,14,13,13,3,3,1,1,5,9,0,0,1,0
839,829,834,839,21,19,20,21,3,1,1,3,10,-5,-5,2,-1,-1
876,871,871,871,14,14,15,13,4,2,1,2,5,0,0,0,-1,2
684,670,670,670,13,14,12,13,2,2,3,1,14,0,0,-1,2,-1
750,750,754,745,13,14,15,13,1,4,2,2,0,-4,9,-1,-1,2
271,267,262,262,14,14,13,13,1,3,3,2,4,5,0,0,1,0
501,487,492,492,18,17,18,19,1,1,1,1,14,-5,0,1,-1,-1
1068,1059,1064,1064,17,16,18,18,2,2,6,1,9,-5,0,1,-2,0
609,609,609,609,14,14,15,13,4,2,2,2,0,0,0,0,-1,2
239,234,239,234,18,17,18,18,3,2,2,1,5,-5,5,1,-1,0
637,618,623,628,13,17,15,16,2,2,1,1,19,-5,-5,-4,2,-1
628,614,618,618,18,19,18,19,1,2,1,2,14,-4,0,-1,1,-1
384,379,379,379,20,19,20,18,1,2,1,1,5,0,0,1,-1,2
1012,1012,1007,1007,20,19,20,18,2,3,1,1,0,5,0,1,-1,2
956,942,946,946,17,16,18,18,2,1,1,1,14,-4,0,1,-2,0
764,750,745,750,17,16,18,18,2,1,1,1,14,5,-5,1,-2,0
914,904,904,900,14,14,15,13,1,3,2,1,10,0,4,0,-1,2
600,590,590,581,14,14,13,13,3,2,2,2,10,0,9,0,1,0
660,651,651,646,20,19,20,18,1,2,2,2,9,0,5,1,-1,2
876,876,876,876,14,14,13,13,2,1,2,2,0,0,0,0,1,0
1064,1059,1059,1059,20,19,20,18,2,2,1,3,5,0,0,1,-1,2
984,979,979,974,20,19,20,21,1,3,1,1,5,0,5,1,-1,-1
684,670,679,679,20,19,20,21,1,4,1,1,14,-9,0,1,-1,-1
407,407,403,398,13,14,15,13,3,3,2,2,0,4,5,-1,-1,2
956,946,946,946,20,19,20,21,2,1,1,1,10,0,0,1,-1,-1
374,374,374,370,17,16,18,16,2,3,2,3,0,0,4,1,-2,2
586,581,581,581,18,19,18,19,3,2,3,1,5,0,0,-1,1,-1
965,965,965,965,20,19,20,21,1,1,1,1,0,0,0,1,-1,-1
890,881,890,895,18,17,18,19,2,2,2,1,9,-9,-5,1,-1,-1
220,215,210,206,14,17,15,16,1,3,2,3,5,5,4,-3,2,-1
1036,1036,1036,1036,20,19,18,18,5,1,3,1,0,0,0,1,1,0
501,496,548,496,14,14,10,13,2,3,1,1,5,-52,52,0,4,-3
187,1068,1059,1059,14,16,15,16,1,1,1,1,-881,9,0,-2,1,-1
740,740,745,740,13,14,12,13,2,3,1,1,0,-5,5,-1,2,-1
506,492,482,482,14,17,15,16,1,1,1,1,14,10,0,-3,2,-1
548,548,548,553,18,19,18,18,2,3,1,3,0,0,-5,-1,1,0
829,820,820,857,14,14,15,16,2,3,1,1,9,0,-37,0,-1,-1
581,581,586,581,14,17,15,16,2,1,3,3,0,-5,5,-3,2,-1
1054,1054,1054,1054,20,19,20,18,1,2,1,1,0,0,0,1,-1,2
365,356,356,351,13,14,12,13,2,3,2,1,9,0,5,-1,2,-1
806,806,806,801,18,17,18,19,2,1,2,2,0,0,5,1,-1,-1
646,637,642,637,20,19,20,21,1,1,1,2,9,-5,5,1,-1,-1
871,867,867,862,18,17,18,16,1,1,3,2,4,0,5,1,-1,2
604,600,600,600,18,17,18,16,3,3,5,1,4,0,0,1,-1,2
900,900,895,886,18,17,18,16,1,1,2,1,0,5,9,1,-1,2
736,736,628,736,17,16,18,16,2,1,1,1,0,108,-108,1,-2,2
689,689,684,684,20,19,20,21,1,1,1,1,0,5,0,1,-1,-1
553,553,553,553,21,19,20,18,1,1,3,1,0,0,0,2,-1,2
721,712,712,712,20,19,20,21,1,3,1,1,9,0,0,1,-1,-1
993,993,989,984,17,16,18,18,1,1,1,2,0,4,5,1,-2,0
726,689,693,689,13,16,18,18,4,2,1,2,37,-4,4,-3,-2,0
876,867,867,867,18,19,18,18,3,3,2,1,9,0,0,-1,1,0
651,646,646,637,20,19,20,18,2,1,3,3,5,0,9,1,-1,2
187,182,187,182,14,14,13,13,3,2,2,1,5,-5,5,0,1,0
637,628,618,614,20,19,18,19,2,1,2,1,9,10,4,1,1,-1
806,801,796,815,14,14,15,13,1,3,1,3,5,5,-19,0,-1,2
473,468,464,468,20,19,20,21,1,1,1,1,5,4,-4,1,-1,-1
1036,1021,1031,1021,13,14,12,13,4,2,2,1,15,-10,10,-1,2,-1
614,609,609,618,14,14,15,13,3,2,1,1,5,0,-9,0,-1,2
886,886,886,886,18,17,18,16,1,2,3,4,0,0,0,1,-1,2
239,234,229,229,14,14,13,13,3,3,3,1,5,5,0,0,1,0
473,468,464,468,17,16,15,16,1,3,3,1,5,4,-4,1,1,-1
674,670,670,665,13,14,15,13,2,4,1,1,4,0,5,-1,-1,2
520,524,520,520,18,17,18,19,1,1,1,2,-4,4,0,1,-1,-1
286,281,286,286,14,14,15,13,1,2,2,3,5,-5,0,0,-1,2
759,754,759,754,13,16,15,16,3,2,2,1,5,-5,5,-3,1,-1
679,674,674,674,20,19,20,18,1,2,1,1,5,0,0,1,-1,2
736,740,740,736,13,14,12,13,3,1,1,1,-4,0,4,-1,2,-1
834,834,829,824,18,17,18,19,1,3,2,1,0,5,5,1,-1,-1
323,318,318,314,14,14,15,13,2,3,3,2,5,0,4,0,-1,2
637,637,623,623,13,14,13,13,2,2,1,2,0,14,0,-1,1,0
487,487,478,478,14,14,13,13,2,1,1,1,0,9,0,0,1,0
815,815,815,815,21,19,20,19,2,2,1,3,0,0,0,2,-1,1
951,946,946,946,13,14,12,13,2,1,2,3,5,0,0,-1,2,-1
234,1073,1064,1064,14,14,15,16,2,2,1,3,-839,9,0,0,-1,-1
374,370,370,365,13,14,12,13,2,3,3,1,4,0,5,-1,2,-1
426,421,417,421,20,19,18,18,2,3,1,3,5,4,-4,1,1,0
1026,1021,1021,1021,17,19,18,18,1,1,3,1,5,0,0,-2,1,0
496,487,487,487,14,17,15,16,1,1,2,1,9,0,0,-3,2,-1
450,440,450,450,17,16,18,16,3,5,3,1,10,-10,0,1,-2,2
679,674,679,674,17,16,18,18,1,2,1,1,5,-5,5,1,-2,0
210,210,210,206,18,19,18,19,2,2,3,2,0,0,4,-1,1,-1
562,557,562,562,21,19,20,18,2,3,3,1,5,-5,0,2,-1,2
436,426,426,426,17,16,18,18,1,1,2,1,10,0,0,1,-2,0
257,253,257,267,18,19,18,18,1,2,3,1,4,-4,-10,-1,1,0
1031,1026,1026,1026,17,16,18,16,2,1,2,1,5,0,0,1,-2,2
1017,1003,998,998,13,14,15,13,2,2,3,2,14,5,0,-1,-1,2
253,243,243,239,14,14,15,13,3,2,2,2,10,0,4,0,-1,2
754,745,745,736,13,14,12,13,2,2,2,2,9,0,9,-1,2,-1
834,824,820,820,21,19,20,21,1,2,1,2,10,4,0,2,-1,-1
187,182,182,182,21,19,21,21,1,1,1,1,5,0,0,2,-2,0
904,895,890,886,18,17,18,19,3,1,1,1,9,5,4,1,-1,-1
220,215,210,206,14,17,15,16,1,3,1,2,5,5,4,-3,2,-1
506,501,501,501,14,14,13,13,2,3,1,1,5,0,0,0,1,0
960,956,960,951,13,14,15,13,1,2,2,1,4,-4,9,-1,-1,2
318,314,314,314,18,19,18,19,3,1,2,2,4,0,0,-1,1,-1
782,768,778,773,14,16,15,16,1,4,1,2,14,-10,5,-2,1,-1
721,717,717,721,20,19,18,18,3,1,1,1,4,0,-4,1,1,0
740,731,731,731,20,19,18,18,2,2,1,1,9,0,0,1,1,0
192,196,196,187,14,14,13,13,3,2,1,3,-4,0,9,0,1,0
557,543,543,539,14,17,15,16,1,2,1,5,14,0,4,-3,2,-1
787,787,787,782,14,14,13,13,1,3,1,1,0,0,5,0,1,0
351,346,351,346,13,14,15,13,3,2,2,2,5,-5,5,-1,-1,2
674,665,670,670,13,14,12,13,3,2,1,1,9,-5,0,-1,2,-1
904,904,900,895,14,14,13,13,2,2,3,2,0,4,5,0,1,0
904,900,900,900,14,17,15,16,3,2,1,1,4,0,0,-3,2,-1
1012,1007,1007,1007,17,16,18,16,3,2,1,1,5,0,0,1,-2,2
745,745,745,736,17,19,18,18,1,1,1,4,0,0,9,-2,1,0
318,309,309,304,14,14,15,13,1,3,3,2,9,0,5,0,-1,2
623,609,614,604,14,14,13,13,1,2,1,3,14,-5,10,0,1,0
989,989,984,984,17,19,18,18,3,1,1,1,0,5,0,-2,1,0
454,445,445,450,20,19,20,18,2,2,1,1,9,0,-5,1,-1,2
886,881,881,876,21,19,20,21,2,2,1,1,5,0,5,2,-1,-1
974,970,970,965,13,14,15,13,1,3,2,2,4,0,5,-1,-1,2
586,581,581,581,18,17,18,16,2,2,1,1,5,0,0,1,-1,2
1059,1050,1050,1050,13,16,15,16,1,4,2,1,9,0,0,-3,1,-1
674,660,665,656,13,14,12,13,3,2,2,1,14,-5,9,-1,2,-1
271,257,253,253,14,14,13,13,2,3,2,1,14,4,0,0,1,0
670,665,665,665,17,16,18,16,1,2,3,1,5,0,0,1,-2,2
374,374,374,370,13,14,15,16,1,2,2,1,0,0,4,-1,-1,-1
1064,1054,1059,1054,17,16,18,18,2,2,1,3,10,-5,5,1,-2,0
510,510,510,506,14,14,13,13,1,3,2,2,0,0,4,0,1,0
979,979,979,979,20,19,20,18,1,2,1,2,0,0,0,1,-1,2
337,337,337,332,13,14,12,13,1,1,2,2,0,0,5,-1,2,-1
557,557,557,553,14,14,15,13,1,3,2,2,0,0,4,0,-1,2
243,229,224,224,18,17,18,19,2,4,3,1,14,5,0,1,-1,-1
993,989,989,989,17,19,18,18,2,1,1,1,4,0,0,-2,1,0
581,576,576,571,18,17,18,16,2,1,2,1,5,0,5,1,-1,2
581,562,557,557,14,17,15,16,2,2,2,1,19,5,0,-3,2,-1
243,239,239,234,21,19,20,18,3,1,2,3,4,0,5,2,-1,2
890,876,867,862,14,17,15,16,1,5,1,2,14,9,5,-3,2,-1
609,609,609,609,21,19,21,21,3,3,1,2,0,0,0,2,-2,0
726,712,707,707,13,14,12,13,2,1,2,1,14,5,0,-1,2,-1
993,984,984,979,20,19,18,18,2,1,2,1,9,0,5,1,1,0
895,890,890,890,21,19,20,19,1,3,1,1,5,0,0,2,-1,1
974,965,970,965,13,16,15,16,3,2,2,2,9,-5,5,-3,1,-1
942,932,932,937,17,19,18,18,3,1,1,1,10,0,-5,-2,1,0
220,220,215,215,18,19,18,19,3,1,3,1,0,5,0,-1,1,-1
839,829,820,820,14,17,15,16,1,2,3,1,10,9,0,-3,2,-1
426,417,412,412,13,14,15,13,4,3,3,1,9,5,0,-1,-1,2
703,698,703,698,13,14,12,13,1,2,3,2,5,-5,5,-1,2,-1
506,496,496,501,21,19,18,19,1,3,1,4,10,0,-5,2,1,-1
520,515,520,515,18,19,18,19,2,5,2,1,5,-5,5,-1,1,-1
796,787,792,792,18,19,18,19,1,2,1,1,9,-5,0,-1,1,-1
224,215,210,215,14,14,15,16,2,1,1,3,9,5,-5,0,-1,-1
332,337,332,332,13,14,13,13,1,1,1,1,-5,5,0,-1,1,0
464,450,454,450,17,16,15,16,2,1,2,1,14,-4,4,1,1,-1
871,862,867,862,18,17,18,18,1,2,2,2,9,-5,5,1,-1,0
1036,1031,1031,1031,17,16,18,18,2,2,1,1,5,0,0,1,-2,0
1036,1036,1031,1031,13,14,12,13,5,1,1,5,0,5,0,-1,2,-1
904,895,890,886,14,14,15,13,2,2,1,2,9,5,4,0,-1,2
1078,1073,1073,1073,13,14,12,13,1,1,1,2,5,0,0,-1,2,-1
651,651,651,646,13,14,12,13,1,1,2,1,0,0,5,-1,2,-1
450,445,445,445,13,14,12,13,1,2,1,3,5,0,0,-1,2,-1
942,932,932,932,13,14,15,13,1,2,1,2,10,0,0,-1,-1,2
773,768,768,768,13,14,15,13,2,1,1,1,5,0,0,-1,-1,2
206,206,206,206,21,19,20,21,1,3,1,1,0,0,0,2,-1,-1
768,768,754,754,13,14,12,13,2,1,2,2,0,14,0,-1,2,-1
426,374,379,379,20,16,18,16,2,2,2,2,52,-5,0,4,-2,2
403,407,403,398,17,16,18,18,1,4,2,2,-4,4,5,1,-2,0
553,553,548,548,14,14,15,13,2,1,1,2,0,5,0,0,-1,2
182,1073,1073,1073,14,14,15,13,1,2,1,2,-891,0,0,0,-1,2
712,707,712,707,13,16,15,16,2,2,1,2,5,-5,5,-3,1,-1
970,970,970,965,13,16,15,16,2,3,2,2,0,0,5,-3,1,-1
520,510,510,515,14,14,13,13,2,2,1,3,10,0,-5,0,1,0
440,426,426,426,13,14,15,13,3,3,3,1,14,0,0,-1,-1,2
239,239,239,239,14,14,13,13,2,2,2,2,0,0,0,0,1,0
286,276,281,276,18,17,18,18,3,4,1,2,10,-5,5,1,-1,0
459,450,450,773,13,16,15,13,2,2,1,1,9,0,-323,-3,1,2
810,806,806,810,18,17,18,19,2,2,1,1,4,0,-4,1,-1,-1
257,253,248,248,21,19,20,21,2,3,1,1,4,5,0,2,-1,-1
445,440,436,436,20,19,20,21,1,2,1,2,5,4,0,1,-1,-1
468,450,450,445,13,14,12,13,2,2,2,1,18,0,5,-1,2,-1
445,436,436,436,17,16,18,18,2,3,1,2,9,0,0,1,-2,0
515,496,731,501,14,14,20,13,1,2,1,2,19,-235,230,0,-6,7
998,993,998,993,13,14,12,13,2,3,2,1,5,-5,5,-1,2,-1
374,360,356,356,13,14,15,13,3,3,1,3,14,4,0,-1,-1,2
792,792,787,787,14,17,15,16,1,1,2,3,0,5,0,-3,2,-1
895,890,876,881,18,17,15,16,2,3,1,1,5,14,-5,1,2,-1
665,656,651,651,17,16,15,16,3,2,2,2,9,5,0,1,1,-1
679,674,674,674,17,16,15,16,2,2,1,1,5,0,0,1,1,-1
257,243,248,234,14,14,15,13,2,2,2,2,14,-5,14,0,-1,2
562,548,543,543,14,14,15,16,2,2,1,1,14,5,0,0,-1,-1
1064,1054,1054,1050,13,14,15,16,3,3,3,1,10,0,4,-1,-1,-1
548,543,543,543,21,19,20,21,1,1,2,1,5,0,0,2,-1,-1
459,440,431,426,13,14,15,13,2,2,1,1,19,9,5,-1,-1,2
839,834,829,829,14,14,15,13,2,1,1,1,5,5,0,0,-1,2
492,482,473,473,14,14,12,13,2,1,1,2,10,9,0,0,2,-1
815,810,815,815,21,19,20,19,2,2,1,1,5,-5,0,2,-1,1
262,253,248,248,21,19,20,18,3,2,2,1,9,5,0,2,-1,2
304,300,295,286,14,14,15,13,1,1,2,2,4,5,9,0,-1,2
670,796,665,665,17,19,18,18,3,1,2,1,-126,131,0,-2,1,0
618,614,618,614,21,19,21,21,2,3,2,1,4,-4,4,2,-2,0
1050,1045,1040,1040,13,14,12,13,2,2,1,3,5,5,0,-1,2,-1
895,886,881,876,21,19,20,18,2,4,1,2,9,5,5,2,-1,2
764,754,750,754,13,14,12,13,2,1,2,1,10,4,-4,-1,2,-1
1078,1073,1073,1073,13,14,12,13,1,2,2,3,5,0,0,-1,2,-1
440,436,450,431,17,16,15,16,3,2,1,2,4,-14,19,1,1,-1
1036,1031,1026,1026,13,14,15,13,3,1,1,1,5,5,0,-1,-1,2
257,253,257,257,21,19,20,21,3,4,1,1,4,-4,0,2,-1,-1
890,881,881,881,18,19,18,19,3,1,3,1,9,0,0,-1,1,-1
473,473,464,459,17,16,18,16,3,2,1,2,0,9,5,1,-2,2
281,276,276,276,21,19,20,21,1,2,1,3,5,0,0,2,-1,-1
1045,1045,1045,1045,20,19,20,18,1,2,1,1,0,0,0,1,-1,2
773,773,773,778,13,14,15,13,1,2,1,1,0,0,-5,-1,-1,2
417,417,412,417,17,16,18,18,1,1,1,3,0,5,-5,1,-2,0
918,904,904,909,14,14,15,13,1,1,1,3,14,0,-5,0,-1,2
440,436,436,431,13,14,12,13,2,1,1,2,4,0,5,-1,2,-1
782,773,778,773,18,19,18,18,1,2,1,2,9,-5,5,-1,1,0
192,187,187,187,21,19,21,21,2,1,2,3,5,0,0,2,-2,0
1017,1012,1007,1007,17,16,15,16,2,2,1,2,5,5,0,1,1,-1
932,932,937,937,13,14,15,13,1,2,3,1,0,-5,0,-1,-1,2
210,201,196,196,18,19,18,19,3,3,1,1,9,5,0,-1,1,-1
267,262,267,257,18,17,18,18,2,2,2,2,5,-5,10,1,-1,0
642,642,642,637,20,19,18,18,1,1,1,2,0,0,5,1,1,0
679,670,670,670,17,16,18,16,2,1,1,1,9,0,0,1,-2,2
506,506,501,501,18,19,18,19,2,1,2,1,0,5,0,-1,1,-1
1003,993,993,993,13,14,15,13,2,1,1,1,10,0,0,-1,-1,2
1012,1007,1012,998,17,16,18,16,3,1,2,2,5,-5,14,1,-2,2
464,454,454,459,17,16,18,16,1,1,3,3,10,0,-5,1,-2,2
1064,1059,1073,1073,20,19,20,21,1,2,2,2,5,-14,0,1,-1,-1
693,684,684,689,20,19,18,18,1,2,4,1,9,0,-5,1,1,0
440,431,436,431,20,19,20,18,2,1,3,1,9,-5,5,1,-1,2
660,660,656,651,20,19,18,18,1,1,3,2,0,4,5,1,1,0
660,656,656,651,20,19,18,18,1,1,1,1,4,0,5,1,1,0
450,445,468,440,20,19,20,18,1,2,2,3,5,-23,28,1,-1,2
965,960,956,956,13,14,12,13,2,1,1,1,5,4,0,-1,2,-1
956,946,951,946,17,16,18,18,2,2,2,2,10,-5,5,1,-2,0
993,993,993,989,13,14,12,13,3,3,2,1,0,0,4,-1,2,-1
736,726,721,721,17,16,18,16,3,2,3,2,10,5,0,1,-2,2
487,482,487,482,18,19,18,19,1,2,2,1,5,-5,5,-1,1,-1
379,379,379,379,20,19,20,18,1,3,1,1,0,0,0,1,-1,2
586,567,562,562,14,14,13,13,1,4,1,2,19,5,0,0,1,0
801,796,801,801,14,14,13,13,3,2,3,3,5,-5,0,0,1,0
937,942,937,942,13,14,12,13,1,3,1,1,-5,5,-5,-1,2,-1
309,295,295,290,18,17,18,16,3,2,2,1,14,0,5,1,-1,2
229,224,224,224,18,17,18,16,1,2,1,3,5,0,0,1,-1,2
487,482,487,487,21,19,21,19,2,1,2,1,5,-5,0,2,-2,2
567,562,557,557,14,17,15,16,1,1,1,2,5,5,0,-3,2,-1
374,224,229,220,17,14,15,13,1,2,3,2,150,-5,9,3,-1,2
586,581,576,571,18,19,18,18,1,1,1,2,5,5,5,-1,1,0
660,656,656,703,13,16,15,13,3,1,3,1,4,0,-47,-3,1,2
703,693,693,693,13,14,15,13,1,1,1,1,10,0,0,-1,-1,2
459,450,464,464,17,16,18,16,4,2,2,3,9,-14,0,1,-2,2
506,501,501,496,18,19,18,19,2,4,1,1,5,0,5,-1,1,-1
787,778,764,768,14,14,15,16,1,1,2,1,9,14,-4,0,-1,-1
374,374,374,384,17,16,18,16,1,2,1,1,0,0,-10,1,-2,2
895,881,881,876,14,14,15,13,1,3,1,2,14,0,5,0,-1,2
876,862,862,867,14,14,15,13,1,3,2,3,14,0,-5,0,-1,2
210,201,196,192,14,14,13,13,3,2,1,2,9,5,4,0,1,0
796,792,792,787,14,17,15,16,1,2,3,2,4,0,5,-3,2,-1
182,182,1078,1073,14,14,13,13,1,1,1,2,0,-896,5,0,1,0
876,871,876,876,21,19,20,18,2,2,1,3,5,-5,0,2,-1,2
867,867,871,867,18,19,18,18,2,2,2,1,0,-4,4,-1,1,0
571,567,567,562,14,14,15,13,1,2,2,3,4,0,5,0,-1,2
534,524,524,524,21,19,20,19,1,2,1,2,10,0,0,2,-1,1
914,904,900,890,14,14,13,13,3,1,1,2,10,4,10,0,1,0
1040,1036,1036,1036,13,16,15,16,1,2,1,2,4,0,0,-3,1,-1
342,342,342,337,13,14,12,13,1,2,2,1,0,0,5,-1,2,-1
520,515,515,515,18,17,18,19,2,3,3,1,5,0,0,1,-1,-1
1059,1050,1050,1045,13,14,15,13,2,3,2,2,9,0,5,-1,-1,2
192,182,187,182,14,17,15,16,2,1,2,1,10,-5,5,-3,2,-1
703,698,698,703,13,14,12,13,2,1,6,1,5,0,-5,-1,2,-1
787,773,773,768,18,16,18,18,1,1,2,1,14,0,5,2,-2,0
909,904,909,909,18,19,18,19,2,2,3,1,5,-5,0,-1,1,-1
229,224,229,229,18,19,18,19,2,2,1,1,5,-5,0,-1,1,-1
539,539,529,529,21,19,20,19,3,3,1,1,0,10,0,2,-1,1
464,450,450,450,13,14,15,13,2,3,2,1,14,0,0,-1,-1,2
234,229,229,224,14,17,15,16,3,3,2,2,5,0,5,-3,2,-1
379,374,374,379,20,19,18,18,1,2,1,3,5,0,-5,1,1,0
196,192,192,192,14,17,15,16,1,2,1,3,4,0,0,-3,2,-1
642,637,637,632,17,16,18,16,3,2,2,1,5,0,5,1,-2,2
300,295,290,290,14,14,13,13,1,5,1,1,5,5,0,0,1,0
220,215,215,215,18,19,18,19,2,1,2,1,5,0,0,-1,1,-1
267,267,267,262,14,14,15,16,3,3,3,2,0,0,5,0,-1,-1
267,253,248,248,14,14,13,13,3,2,2,2,14,5,0,0,1,0
595,595,595,595,14,14,13,13,4,2,3,1,0,0,0,0,1,0
839,829,824,820,18,19,18,19,2,3,1,3,10,5,4,-1,1,-1
623,604,604,609,14,14,15,13,1,3,1,1,19,0,-5,0,-1,2
951,946,951,946,13,14,15,13,2,2,2,3,5,-5,5,-1,-1,2
609,600,590,590,14,14,15,13,3,3,2,1,9,10,0,0,-1,2
782,782,782,782,14,14,13,13,1,2,1,1,0,0,0,0,1,0
581,576,576,576,21,19,20,18,1,1,1,2,5,0,0,2,-1,2
886,876,876,867,18,19,18,18,1,2,1,2,10,0,9,-1,1,0
534,524,524,524,14,14,13,13,2,1,1,1,10,0,0,0,1,0
562,557,529,562,14,14,13,13,1,2,1,1,5,28,-33,0,1,0
839,829,824,824,14,17,15,16,2,2,1,1,10,5,0,-3,2,-1
398,389,379,370,13,14,15,13,1,3,2,1,9,10,9,-1,-1,2
407,398,398,398,13,14,12,13,2,3,1,1,9,0,0,-1,2,-1
717,712,712,712,20,19,20,18,2,5,1,1,5,0,0,1,-1,2
895,890,890,886,14,14,13,13,1,3,1,1,5,0,4,0,1,0
304,304,309,304,21,19,21,21,2,1,1,2,0,-5,5,2,-2,0
436,426,426,426,13,14,15,13,2,3,3,3,10,0,0,-1,-1,2
571,674,562,557,18,14,18,16,3,1,2,2,-103,112,5,4,-4,2
417,412,417,407,13,14,12,13,2,2,2,1,5,-5,10,-1,2,-1
886,881,881,881,14,14,13,13,2,2,1,1,5,0,0,0,1,0
900,436,436,440,21,19,20,18,1,4,1,1,464,0,-4,2,-1,2
984,970,979,974,20,19,20,21,2,3,2,2,14,-9,5,1,-1,-1
1054,1050,1050,1045,20,19,20,21,2,2,4,2,4,0,5,1,-1,-1
262,262,257,257,21,19,20,18,2,1,1,2,0,5,0,2,-1,2
304,309,309,304,21,19,21,19,1,1,2,3,-5,0,5,2,-2,2
220,201,196,201,14,14,13,13,2,2,3,2,19,5,-5,0,1,0
553,548,548,562,18,17,18,18,3,1,2,1,5,0,-14,1,-1,0
600,595,595,600,21,19,20,19,1,2,1,1,5,0,-5,2,-1,1
721,721,721,721,13,14,15,13,1,2,3,1,0,0,0,-1,-1,2
482,478,487,482,18,19,18,19,1,1,2,1,4,-9,5,-1,1,-1
201,196,192,192,21,19,21,19,1,1,1,2,5,4,0,2,-2,2
215,206,206,206,18,19,18,19,1,3,2,1,9,0,0,-1,1,-1
923,918,918,914,18,17,18,16,2,1,2,2,5,0,4,1,-1,2
731,726,726,721,20,19,20,21,2,1,2,2,5,0,5,1,-1,-1
210,210,215,210,14,14,15,13,3,2,2,2,0,-5,5,0,-1,2
379,379,379,374,13,14,15,13,1,2,3,2,0,0,5,-1,-1,2
1036,1036,1026,1026,17,16,18,16,1,4,1,1,0,10,0,1,-2,2
351,346,346,342,17,16,15,16,4,3,2,1,5,0,4,1,1,-1
759,754,754,750,13,14,12,13,2,3,2,2,5,0,4,-1,2,-1
974,965,974,979,20,19,20,18,2,2,4,3,9,-9,-5,1,-1,2
426,426,426,421,20,19,20,18,2,1,2,1,0,0,5,1,-1,2
309,304,304,300,18,19,18,19,2,3,1,2,5,0,4,-1,1,-1
824,820,820,815,18,19,18,19,1,1,1,2,4,0,5,-1,1,-1
609,604,600,600,21,19,20,19,3,2,3,1,5,4,0,2,-1,1
201,196,192,192,18,19,21,19,2,1,1,1,5,4,0,-1,-2,2
834,829,829,829,21,19,20,21,3,1,1,1,5,0,0,2,-1,-1
839,839,834,834,21,19,20,21,1,1,1,2,0,5,0,2,-1,-1
801,801,796,796,14,14,15,13,1,3,1,1,0,5,0,0,-1,2
787,787,787,782,14,17,15,16,1,2,1,2,0,0,5,-3,2,-1
576,567,567,562,18,19,18,18,2,3,3,1,9,0,5,-1,1,0
904,904,900,900,21,19,20,21,1,1,3,1,0,4,0,2,-1,-1
492,482,482,482,21,19,21,19,1,2,1,1,10,0,0,2,-2,2
796,792,782,787,18,19,18,19,1,1,1,1,4,10,-5,-1,1,-1
1059,1054,1059,1054,17,16,18,18,1,1,2,2,5,-5,5,1,-2,0
895,890,890,886,18,17,18,19,1,1,1,1,5,0,4,1,-1,-1
346,337,337,337,20,19,20,18,2,3,1,1,9,0,0,1,-1,2
506,492,496,492,14,14,15,13,3,2,1,1,14,-4,4,0,-1,2
651,646,642,637,13,14,15,13,1,2,2,3,5,4,5,-1,-1,2
403,398,398,398,13,14,15,13,2,1,1,2,5,0,0,-1,-1,2
539,534,539,529,14,14,13,13,1,1,2,2,5,-5,10,0,1,0
646,646,646,642,17,19,18,18,1,2,2,1,0,0,4,-2,1,0
712,707,707,712,20,19,20,21,1,1,1,2,5,0,-5,1,-1,-1
576,562,562,567,14,17,15,16,1,1,1,1,14,0,-5,-3,2,-1
271,276,271,271,18,19,18,18,2,5,3,3,-5,5,0,-1,1,0
642,637,642,637,13,14,12,13,2,1,2,2,5,-5,5,-1,2,-1
286,276,276,271,14,14,15,13,2,2,2,1,10,0,5,0,-1,2
548,543,524,539,21,19,20,21,1,1,1,1,5,19,-15,2,-1,-1
393,389,389,389,20,19,18,18,3,2,3,1,4,0,0,1,1,0
412,412,417,417,17,16,18,18,1,2,2,1,0,-5,0,1,-2,0
571,571,571,567,21,19,20,21,2,5,2,3,0,0,4,2,-1,-1
571,562,562,562,21,19,20,21,1,2,1,3,9,0,0,2,-1,-1
276,267,267,267,18,19,18,18,1,2,1,1,9,0,0,-1,1,0
553,553,553,553,21,19,20,21,2,2,3,1,0,0,0,2,-1,-1
923,909,909,914,21,19,21,21,1,2,1,1,14,0,-5,2,-2,0
267,257,257,253,18,17,18,18,1,1,1,2,10,0,4,1,-1,0
309,309,304,304,18,17,18,19,2,1,1,1,0,5,0,1,-1,-1
384,384,384,379,13,14,12,13,1,1,1,2,0,0,5,-1,2,-1
759,750,745,740,17,16,18,16,3,2,2,1,9,5,5,1,-2,2
881,867,857,853,14,14,15,13,2,2,2,1,14,10,4,0,-1,2
309,300,309,300,18,19,18,19,2,4,1,2,9,-9,9,-1,1,-1
824,806,815,810,14,14,13,13,1,2,2,1,18,-9,5,0,1,0
346,342,342,337,17,16,15,16,3,2,1,1,4,0,5,1,1,-1
374,365,365,365,13,14,12,13,2,3,1,3,9,0,0,-1,2,-1
1007,1003,1003,998,20,19,20,21,1,1,1,2,4,0,5,1,-1,-1
431,431,431,431,17,16,18,18,1,3,1,2,0,0,0,1,-2,0
459,454,459,459,17,16,18,18,3,3,2,1,5,-5,0,1,-2,0
220,220,220,215,18,19,18,19,1,3,2,1,0,0,5,-1,1,-1
707,703,698,698,13,14,12,13,3,2,1,3,4,5,0,-1,2,-1
510,506,510,506,21,19,20,21,2,2,2,1,4,-4,4,2,-1,-1
867,862,857,862,14,14,13,13,1,2,3,2,5,5,-5,0,1,0
1040,1031,1036,1036,17,19,18,18,2,2,2,1,9,-5,0,-2,1,0
1026,1021,1017,1017,13,14,15,13,2,3,1,1,5,4,0,-1,-1,2
796,792,792,787,21,19,21,21,1,2,1,2,4,0,5,2,-2,0
773,759,768,773,13,14,12,13,1,2,2,1,14,-9,-5,-1,2,-1
1059,1054,1059,1059,13,14,15,13,5,2,2,1,5,-5,0,-1,-1,2
646,642,637,637,13,14,15,13,1,1,3,2,4,5,0,-1,-1,2
290,286,276,271,21,19,20,21,2,1,1,1,4,10,5,2,-1,-1
876,867,871,867,18,17,18,16,1,2,2,3,9,-4,4,1,-1,2
965,984,960,956,17,16,15,16,1,1,1,2,-19,24,4,1,1,-1
829,810,820,815,14,14,15,13,4,2,3,1,19,-10,5,0,-1,2
764,764,759,759,17,16,18,18,1,3,2,1,0,5,0,1,-2,0
539,534,529,529,14,17,15,16,1,2,1,2,5,5,0,-3,2,-1
271,262,257,257,14,17,15,16,2,2,3,3,9,5,0,-3,2,-1
234,234,234,234,14,14,13,13,1,4,1,3,0,0,0,0,1,0
595,576,581,586,14,14,13,13,1,3,3,2,19,-5,-5,0,1,0
417,417,417,412,17,16,18,16,1,1,1,1,0,0,5,1,-2,2
951,942,942,937,17,16,18,16,3,1,2,2,9,0,5,1,-2,2
618,609,618,609,14,14,13,13,3,3,2,2,9,-9,9,0,1,0
346,337,337,337,20,19,18,18,2,1,2,1,9,0,0,1,1,0
304,300,300,300,14,14,13,13,3,2,2,1,4,0,0,0,1,0
810,806,806,801,14,14,13,13,1,2,3,2,4,0,5,0,1,0
787,768,768,768,21,19,20,18,1,2,2,1,19,0,0,2,-1,2
951,951,951,951,13,14,12,13,1,1,2,3,0,0,0,-1,2,-1
609,600,600,595,14,14,13,13,1,2,2,2,9,0,5,0,1,0
600,590,581,581,14,17,15,16,2,1,1,1,10,9,0,-3,2,-1
464,459,459,454,17,16,15,16,1,2,2,1,5,0,5,1,1,-1
253,243,239,239,18,19,18,18,1,1,1,1,10,4,0,-1,1,0
829,824,824,820,18,17,18,19,1,2,1,2,5,0,4,1,-1,-1
393,393,389,389,17,19,18,18,2,2,1,1,0,4,0,-2,1,0
736,736,731,731,13,14,15,16,3,3,3,2,0,5,0,-1,-1,-1
417,412,412,412,17,19,18,18,3,1,3,1,5,0,0,-2,1,0
960,436,960,965,17,19,18,18,2,1,1,1,524,-524,-5,-2,1,0
267,262,262,262,18,17,18,18,2,2,1,1,5,0,0,1,-1,0
473,473,478,487,17,16,15,16,1,2,1,1,0,-5,-9,1,1,-1
895,904,904,900,14,17,15,16,1,3,2,2,-9,0,4,-3,2,-1
196,196,196,192,18,17,18,19,3,1,1,2,0,0,4,1,-1,-1
989,984,989,984,17,16,18,16,2,4,4,2,5,-5,5,1,-2,2
248,243,234,234,14,14,15,13,2,5,2,1,5,9,0,0,-1,2
707,703,698,707,17,16,18,18,1,1,1,4,4,5,-9,1,-2,0
379,374,374,370,20,19,20,18,3,3,1,2,5,0,4,1,-1,2
731,721,717,712,17,16,15,16,1,3,1,2,10,4,5,1,1,-1
904,895,900,895,14,14,15,13,2,2,3,1,9,-5,5,0,-1,2
482,473,468,468,14,14,12,13,1,2,2,2,9,5,0,0,2,-1
271,257,257,262,18,19,18,18,1,2,1,1,14,0,-5,-1,1,0
778,773,773,768,13,14,12,13,2,1,1,2,5,0,5,-1,2,-1
923,914,914,914,14,14,13,13,1,2,1,2,9,0,0,0,1,0
281,267,267,271,14,14,15,13,1,3,1,3,14,0,-4,0,-1,2
590,539,539,539,18,19,18,18,1,2,1,1,51,0,0,-1,1,0
853,848,843,843,18,19,18,18,2,2,3,2,5,5,0,-1,1,0
909,904,904,904,18,19,18,19,3,1,2,1,5,0,0,-1,1,-1
717,707,703,693,20,19,20,18,2,3,2,2,10,4,10,1,-1,2
384,379,398,403,20,19,20,21,3,2,2,1,5,-19,-5,1,-1,-1
1026,1017,1017,1017,13,14,15,13,1,2,2,1,9,0,0,-1,-1,2
487,487,473,478,14,17,15,16,2,1,1,1,0,14,-5,-3,2,-1
993,989,984,974,13,14,12,13,3,2,2,2,4,5,10,-1,2,-1
421,426,426,421,13,14,12,13,1,1,1,4,-5,0,5,-1,2,-1
801,796,796,796,18,19,21,19,1,4,1,1,5,0,0,-1,-2,2
960,956,965,979,13,14,12,13,1,3,3,5,4,-9,-14,-1,2,-1
1012,1003,1003,1003,13,14,15,13,1,1,1,1,9,0,0,-1,-1,2
276,253,243,239,14,14,13,13,1,2,1,2,23,10,4,0,1,0
956,951,956,946,13,16,15,16,1,1,1,3,5,-5,10,-3,1,-1
792,787,792,787,18,17,18,16,2,1,2,2,5,-5,5,1,-1,2
445,440,440,440,17,16,18,18,2,2,1,2,5,0,0,1,-2,0
946,946,937,942,20,19,20,18,1,3,3,1,0,9,-5,1,-1,2
473,459,464,459,20,19,20,18,2,4,2,1,14,-5,5,1,-1,2
374,365,370,365,13,16,15,16,1,2,2,2,9,-5,5,-3,1,-1
726,721,717,712,13,14,15,13,3,1,2,2,5,4,5,-1,-1,2
248,239,234,234,14,14,13,13,1,2,2,3,9,5,0,0,1,0
229,224,224,224,18,19,18,19,1,2,1,2,5,0,0,-1,1,-1
379,379,365,365,20,19,20,18,1,2,1,2,0,14,0,1,-1,2
332,328,328,328,20,19,21,19,1,1,1,1,4,0,0,1,-2,2
534,529,445,529,18,17,20,19,2,1,1,1,5,84,-84,1,-3,1
450,445,440,445,17,16,15,16,1,3,2,1,5,5,-5,1,1,-1
576,567,571,571,18,19,18,18,1,2,1,1,9,-4,0,-1,1,0
506,506,506,501,14,14,15,13,2,2,1,2,0,0,5,0,-1,2
810,806,806,801,14,14,13,13,1,1,2,3,4,0,5,0,1,0
787,782,778,773,14,14,13,13,3,1,1,2,5,4,5,0,1,0
1021,1021,1021,1017,20,19,20,18,1,1,1,2,0,0,4,1,-1,2
867,853,839,834,14,17,15,16,1,3,1,2,14,14,5,-3,2,-1
431,426,421,421,13,14,15,13,3,3,1,4,5,5,0,-1,-1,2
1021,1012,1012,1007,13,14,12,13,2,3,3,1,9,0,5,-1,2,-1
946,951,946,946,13,14,12,13,1,1,1,1,-5,5,0,-1,2,-1
201,187,187,187,21,19,21,21,3,2,1,1,14,0,0,2,-2,0
853,853,843,853,14,14,13,13,2,1,1,1,0,10,-10,0,1,0
328,323,328,318,18,17,18,19,1,2,2,1,5,-5,10,1,-1,-1
510,501,501,506,14,14,15,16,1,1,3,3,9,0,-5,0,-1,-1
487,473,468,468,14,16,15,16,1,1,1,1,14,5,0,-2,1,-1
1073,1059,1064,1054,13,14,15,13,1,2,2,2,14,-5,10,-1,-1,2
515,501,501,501,14,17,15,16,2,6,1,4,14,0,0,-3,2,-1
464,459,459,464,20,19,20,21,1,1,3,1,5,0,-5,1,-1,-1
660,660,656,656,20,19,20,18,3,1,1,1,0,4,0,1,-1,2
229,220,220,215,14,17,15,16,1,2,2,2,9,0,5,-3,2,-1
187,187,187,182,14,14,13,13,2,1,2,1,0,0,5,0,1,0
618,614,614,609,21,19,21,21,1,3,1,2,4,0,5,2,-2,0
356,351,351,346,17,16,18,18,1,2,2,2,5,0,5,1,-2,0
553,553,553,553,21,19,20,21,2,2,1,1,0,0,0,2,-1,-1
904,904,900,895,14,17,15,16,2,2,3,1,0,4,5,-3,2,-1
206,201,201,201,21,19,21,21,3,3,1,1,5,0,0,2,-2,0
1012,998,998,998,13,14,12,13,2,3,1,1,14,0,0,-1,2,-1
773,768,764,764,20,19,20,21,2,1,1,1,5,4,0,1,-1,-1
562,548,553,553,14,17,15,16,4,1,2,1,14,-5,0,-3,2,-1
674,665,670,674,17,16,18,18,2,2,2,1,9,-5,-4,1,-2,0
656,656,660,656,13,14,12,13,1,1,1,1,0,-4,4,-1,2,-1
712,712,712,703,17,16,15,16,1,1,2,1,0,0,9,1,1,-1
745,745,740,740,20,19,18,18,3,1,3,2,0,5,0,1,1,0
342,332,337,332,20,19,20,18,2,2,2,1,10,-5,5,1,-1,2
726,721,721,717,20,19,18,18,3,2,3,1,5,0,4,1,1,0
768,764,759,764,17,16,18,18,2,1,1,2,4,5,-5,1,-2,0
417,412,412,412,13,14,12,13,1,3,4,1,5,0,0,-1,2,-1
201,196,201,196,21,19,21,21,3,1,2,1,5,-5,5,2,-2,0
304,290,295,290,18,17,18,16,3,4,3,3,14,-5,5,1,-1,2
1026,1017,1021,1021,17,19,18,18,3,2,1,2,9,-4,0,-2,1,0
806,796,792,792,14,14,15,13,1,3,1,3,10,4,0,0,-1,2
539,524,534,534,21,19,20,18,1,4,2,1,15,-10,0,2,-1,2
1017,998,993,993,13,14,15,13,1,2,1,3,19,5,0,-1,-1,2
224,220,210,215,14,17,15,16,1,1,1,1,4,10,-5,-3,2,-1
450,445,440,436,17,16,18,16,1,2,1,2,5,5,4,1,-2,2
529,524,529,524,18,17,18,16,2,4,2,2,5,-5,5,1,-1,2
581,581,576,576,14,14,15,13,1,1,1,2,0,5,0,0,-1,2
586,581,586,586,21,19,20,21,1,1,2,1,5,-5,0,2,-1,-1
257,248,248,248,21,19,20,21,1,2,1,2,9,0,0,2,-1,-1
796,792,792,787,14,17,15,16,1,2,2,2,4,0,5,-3,2,-1
286,281,281,281,18,19,18,19,1,3,3,1,5,0,0,-1,1,-1
295,295,290,290,14,14,13,13,2,3,1,3,0,5,0,0,1,0
445,436,436,436,17,16,15,16,3,1,1,1,9,0,0,1,1,-1
862,862,862,857,18,17,18,18,2,2,1,1,0,0,5,1,-1,0
534,529,529,524,14,14,15,16,1,4,2,2,5,0,5,0,-1,-1
1026,1021,1026,1021,17,16,18,16,1,2,2,3,5,-5,5,1,-2,2
220,215,215,215,18,17,18,16,1,5,2,1,5,0,0,1,-1,2
810,806,806,796,14,14,15,16,1,3,2,3,4,0,10,0,-1,-1
389,384,389,379,20,19,20,21,3,1,1,1,5,-5,10,1,-1,-1
960,956,965,960,17,16,18,18,3,1,2,1,4,-9,5,1,-2,0
257,234,234,239,14,14,15,13,1,2,1,2,23,0,-5,0,-1,2
239,234,234,234,14,17,15,16,2,2,1,1,5,0,0,-3,2,-1
571,501,506,501,18,17,18,19,2,1,2,2,70,-5,5,1,-1,-1
520,510,510,510,14,17,15,16,2,1,1,3,10,0,0,-3,2,-1
426,417,412,412,13,14,12,13,1,2,2,1,9,5,0,-1,2,-1
548,548,548,543,18,17,18,16,2,3,3,2,0,0,5,1,-1,2
731,731,740,740,20,19,18,18,3,1,3,1,0,-9,0,1,1,0
637,628,623,623,20,19,21,21,2,1,1,1,9,5,0,1,-2,0
1007,998,1003,993,17,16,15,16,3,2,1,2,9,-5,10,1,1,-1
998,993,993,989,13,14,12,13,3,4,1,2,5,0,4,-1,2,-1
562,562,557,557,18,19,18,18,4,1,2,1,0,5,0,-1,1,0
651,646,642,642,20,19,18,18,3,3,1,2,5,4,0,1,1,0
890,881,881,881,14,14,13,13,1,1,1,1,9,0,0,0,1,0
904,900,904,904,14,14,13,13,1,1,2,2,4,-4,0,0,1,0
806,801,801,796,18,19,18,19,4,2,1,1,5,0,5,-1,1,-1
506,506,501,506,14,14,15,13,4,2,1,2,0,5,-5,0,-1,2
286,271,271,267,14,14,13,13,1,3,2,2,15,0,4,0,1,0
445,440,440,440,17,16,18,18,2,2,2,1,5,0,0,1,-2,0
290,286,290,286,14,14,13,13,1,2,3,2,4,-4,4,0,1,0
553,553,557,553,14,14,13,13,3,2,2,1,0,-4,4,0,1,0
862,857,862,853,21,19,20,21,2,2,2,1,5,-5,9,2,-1,-1
689,684,684,689,13,14,12,13,1,2,1,1,5,0,-5,-1,2,-1
182,182,182,182,18,19,18,19,1,1,1,1,0,0,0,-1,1,-1
506,501,501,506,21,19,21,19,3,1,2,1,5,0,-5,2,-2,2
581,576,576,576,18,19,18,18,1,1,2,1,5,0,0,-1,1,0
318,314,314,314,14,17,15,16,3,1,1,1,4,0,0,-3,2,-1
196,196,196,192,14,17,15,16,2,1,2,1,0,0,4,-3,2,-1
436,431,431,426,20,19,20,21,1,2,1,2,5,0,5,1,-1,-1
1031,1021,1021,1021,13,14,12,13,2,2,1,1,10,0,0,-1,2,-1
210,206,206,201,21,19,20,21,1,1,1,2,4,0,5,2,-1,-1
979,974,974,970,13,14,15,13,1,2,1,2,5,0,4,-1,-1,2
731,731,731,736,20,19,20,18,1,1,1,2,0,0,-5,1,-1,2
1017,1007,1012,1012,17,19,18,18,3,1,2,1,10,-5,0,-2,1,0
731,721,717,721,20,19,20,21,1,1,1,1,10,4,-4,1,-1,-1
1007,998,998,993,17,16,18,16,2,3,1,1,9,0,5,1,-2,2
979,965,960,960,17,16,15,16,1,1,2,3,14,5,0,1,1,-1
815,815,815,815,14,17,15,16,1,2,2,1,0,0,0,-3,2,-1
309,304,304,304,18,19,18,19,3,1,2,1,5,0,0,-1,1,-1
1036,1036,1031,1031,20,19,18,18,1,1,1,1,0,5,0,1,1,0
848,848,984,843,14,14,23,13,3,1,1,1,0,-136,141,0,-9,10
1064,1054,1054,1054,17,16,15,16,1,2,2,3,10,0,0,1,1,-1
960,960,960,956,13,14,12,13,2,3,2,2,0,0,4,-1,2,-1
267,262,257,253,21,19,20,21,3,1,2,1,5,5,4,2,-1,-1
1054,1050,1045,1045,20,19,20,18,1,3,1,2,4,5,0,1,-1,2
886,881,886,881,21,19,20,21,2,2,1,2,5,-5,5,2,-1,-1
731,717,717,721,13,14,12,13,2,2,1,1,14,0,-4,-1,2,-1
824,815,815,810,14,14,13,13,3,2,2,3,9,0,5,0,1,0
815,810,810,815,21,19,20,21,2,2,1,1,5,0,-5,2,-1,-1
192,187,192,192,14,14,15,13,2,3,3,1,5,-5,0,0,-1,2
323,318,318,323,14,14,13,13,3,2,3,1,5,0,-5,0,1,0
557,656,553,553,21,19,20,21,1,2,1,3,-99,103,0,2,-1,-1
796,773,768,764,14,14,12,13,1,2,2,2,23,5,4,0,2,-1
234,224,220,220,14,14,15,13,3,1,1,1,10,4,0,0,-1,2
684,679,679,679,20,19,18,18,3,2,3,2,5,0,0,1,1,0
900,886,881,881,18,17,18,16,1,2,1,2,14,5,0,1,-1,2
304,300,304,300,21,19,20,21,3,2,1,1,4,-4,4,2,-1,-1
684,674,670,670,17,16,18,16,1,3,1,1,10,4,0,1,-2,2
548,539,539,534,18,19,18,18,3,2,1,1,9,0,5,-1,1,0
239,224,224,224,18,17,18,19,2,2,1,2,15,0,0,1,-1,-1
787,768,768,365,14,14,15,11,3,2,1,1,19,0,403,0,-1,4
637,632,628,623,13,14,15,13,3,1,1,2,5,4,5,-1,-1,2
900,895,895,895,14,14,15,13,2,2,1,2,5,0,0,0,-1,2
867,857,862,862,21,19,20,18,1,1,3,1,10,-5,0,2,-1,2
417,407,407,407,17,19,18,18,1,2,1,2,10,0,0,-2,1,0
407,403,431,407,13,14,12,13,3,2,2,2,4,-28,24,-1,2,-1
276,271,267,262,14,14,15,16,3,3,2,1,5,4,5,0,-1,-1
445,436,440,440,20,19,20,18,3,2,2,1,9,-4,0,1,-1,2
881,876,876,876,18,19,18,18,3,2,1,2,5,0,0,-1,1,0
1050,1045,1040,1036,13,14,12,13,3,3,1,1,5,5,4,-1,2,-1
295,290,286,281,18,19,18,19,3,1,1,2,5,4,5,-1,1,-1
839,834,839,834,14,14,13,13,2,2,2,2,5,-5,5,0,1,0
703,693,689,693,17,16,15,16,3,2,1,1,10,4,-4,1,1,-1
693,693,693,689,20,19,20,21,1,1,1,2,0,0,4,1,-1,-1
1045,1040,1036,1036,13,16,15,16,2,1,2,1,5,4,0,-3,1,-1
867,857,862,862,21,19,20,18,1,2,1,1,10,-5,0,2,-1,2
318,304,309,309,14,14,15,13,1,1,1,2,14,-5,0,0,-1,2
187,182,182,182,18,19,18,19,1,1,1,1,5,0,0,-1,1,-1
1054,1050,1054,1050,13,14,12,13,1,2,1,2,4,-4,4,-1,2,-1
215,206,201,201,14,14,13,13,1,3,1,3,9,5,0,0,1,0
295,286,281,281,14,14,15,16,1,3,1,2,9,5,0,0,-1,-1
623,614,609,609,14,14,13,13,2,3,2,1,9,5,0,0,1,0
192,1068,1059,1064,14,14,12,13,2,3,3,1,-876,9,-5,0,2,-1
286,286,286,286,18,17,18,16,3,3,1,1,0,0,0,1,-1,2
642,637,637,632,13,14,15,13,1,2,1,2,5,0,5,-1,-1,2
496,487,487,487,14,17,15,16,1,1,2,1,9,0,0,-3,2,-1
614,370,365,365,21,14,15,13,1,1,2,2,244,5,0,7,-1,2
553,543,543,543,14,14,13,13,1,1,1,1,10,0,0,0,1,0
379,374,379,370,20,19,20,21,3,1,2,2,5,-5,9,1,-1,-1
820,824,824,820,14,14,13,13,2,3,1,1,-4,0,4,0,1,0
192,1054,1059,1054,18,16,15,16,3,3,4,2,-862,-5,5,2,1,-1
346,337,337,337,17,16,18,16,1,2,1,1,9,0,0,1,-2,2
1031,1036,1031,1031,13,14,15,13,1,3,1,3,-5,5,0,-1,-1,2
571,557,553,548,14,14,15,13,1,3,2,1,14,4,5,0,-1,2
314,304,304,300,21,19,20,21,1,1,1,2,10,0,4,2,-1,-1
196,187,192,192,18,19,18,19,1,2,1,1,9,-5,0,-1,1,-1
309,300,300,300,14,14,13,13,1,2,2,3,9,0,0,0,1,0
323,328,323,323,18,19,18,19,3,1,1,1,-5,5,0,-1,1,-1
923,918,923,918,21,19,21,21,2,2,1,1,5,-5,5,2,-2,0
698,698,693,693,17,16,15,16,3,1,3,2,0,5,0,1,1,-1
220,220,220,220,14,17,15,16,1,2,2,1,0,0,0,-3,2,-1
286,267,257,253,14,14,13,13,1,2,2,1,19,10,4,0,1,0
993,979,984,984,13,14,12,13,1,2,1,3,14,-5,0,-1,2,-1
646,642,642,646,13,14,15,13,1,2,3,3,4,0,-4,-1,-1,2
323,318,323,323,21,19,21,21,2,2,2,1,5,-5,0,2,-2,0
403,403,398,398,20,19,20,21,1,1,2,1,0,5,0,1,-1,-1
459,454,454,450,20,19,20,18,1,2,2,2,5,0,4,1,-1,2
201,192,192,192,18,19,18,19,1,2,1,1,9,0,0,-1,1,-1
646,642,642,637,17,16,18,16,3,1,2,3,4,0,5,1,-2,2
600,595,595,595,14,17,15,16,1,1,2,3,5,0,0,-3,2,-1
323,314,314,314,18,17,18,19,3,2,1,2,9,0,0,1,-1,-1
965,960,956,956,13,14,15,13,3,1,3,1,5,4,0,-1,-1,2
182,1073,1073,1073,14,14,12,13,1,2,1,1,-891,0,0,0,2,-1
342,342,337,337,13,14,12,13,2,3,3,2,0,5,0,-1,2,-1
286,276,281,276,14,14,13,13,1,2,2,2,10,-5,5,0,1,0
576,571,571,567,18,19,20,18,1,3,1,1,5,0,4,-1,-1,2
651,646,642,670,13,14,15,13,1,2,1,1,5,4,-28,-1,-1,2
862,857,853,848,14,17,15,16,1,2,1,2,5,4,5,-3,2,-1
520,515,515,510,14,14,13,13,2,1,2,2,5,0,5,0,1,0
862,857,857,853,14,14,15,13,3,3,1,2,5,0,4,0,-1,2
534,534,539,534,21,19,20,21,2,1,1,1,0,-5,5,2,-1,-1
1064,1059,1059,1059,17,16,15,16,1,4,1,1,5,0,0,1,1,-1
478,478,473,473,20,19,20,21,1,1,1,1,0,5,0,1,-1,-1
876,871,871,871,14,14,15,16,1,3,2,3,5,0,0,0,-1,-1
796,787,782,773,18,17,18,18,1,1,1,2,9,5,9,1,-1,0
773,768,773,768,17,16,15,16,1,2,3,2,5,-5,5,1,1,-1
412,407,403,398,13,14,12,13,1,1,2,2,5,4,5,-1,2,-1
187,182,187,187,18,17,18,16,2,1,2,1,5,-5,0,1,-1,2
642,637,637,632,20,19,18,18,2,1,2,2,5,0,5,1,1,0
609,600,604,604,18,17,18,16,1,3,2,1,9,-4,0,1,-1,2
300,300,295,295,14,14,15,13,3,1,1,2,0,5,0,0,-1,2
510,506,506,496,18,17,18,19,2,1,1,1,4,0,10,1,-1,-1
810,806,806,801,18,17,18,16,1,1,2,2,4,0,5,1,-1,2
965,960,960,956,20,19,18,18,2,2,4,2,5,0,4,1,1,0
914,909,904,1073,18,17,18,18,1,3,6,1,5,5,-169,1,-1,0
1045,1036,1031,1017,20,19,18,18,3,3,2,2,9,5,14,1,1,0
323,318,318,314,14,14,13,13,2,2,1,2,5,0,4,0,1,0
965,960,1078,956,13,14,13,13,2,1,1,1,5,-118,122,-1,1,0
848,839,839,843,14,14,15,16,1,1,1,1,9,0,-4,0,-1,-1
1012,1012,1007,1007,20,19,18,18,1,2,3,1,0,5,0,1,1,0
1068,1064,1064,1073,20,19,20,21,3,2,1,1,4,0,-9,1,-1,-1
609,557,567,571,18,19,20,18,3,2,1,2,52,-10,-4,-1,-1,2
1059,1054,1054,1050,20,19,18,18,2,1,1,1,5,0,4,1,1,0
956,951,960,951,17,16,18,16,1,2,2,2,5,-9,9,1,-2,2
1073,1073,1073,1073,20,19,18,18,2,1,2,3,0,0,0,1,1,0
810,806,806,806,18,19,18,19,1,1,1,1,4,0,0,-1,1,-1
900,890,904,895,21,19,20,19,2,2,1,1,10,-14,9,2,-1,1
192,187,182,182,14,14,15,16,1,2,1,1,5,5,0,0,-1,-1
304,304,304,300,18,19,18,19,3,4,1,1,0,0,4,-1,1,-1
801,796,796,792,14,14,15,13,2,3,3,2,5,0,4,0,-1,2
1007,993,984,993,13,14,12,13,3,3,3,2,14,9,-9,-1,2,-1
220,393,229,224,14,14,15,13,2,1,4,2,-173,164,5,0,-1,2
1040,1036,290,1036,13,14,15,13,2,2,1,1,4,746,-746,-1,-1,2
801,796,796,796,21,19,21,19,2,2,1,2,5,0,0,2,-2,2
1040,1031,1036,1050,13,14,12,13,3,1,3,1,9,-5,-14,-1,2,-1
346,342,492,337,17,16,21,18,3,2,1,1,4,-150,155,1,-5,3
871,867,862,857,14,14,15,13,1,1,2,3,4,5,5,0,-1,2
539,534,534,529,14,17,15,16,2,3,2,1,5,0,5,-3,2,-1
712,707,703,703,20,19,20,18,2,1,1,1,5,4,0,1,-1,2
960,960,960,956,20,19,20,18,1,3,2,3,0,0,4,1,-1,2
1031,1017,1003,998,13,14,12,13,1,2,3,2,14,14,5,-1,2,-1
712,707,703,703,17,16,18,18,2,1,1,1,5,4,0,1,-2,0
267,262,257,257,21,19,20,21,3,2,2,2,5,5,0,2,-1,-1
693,679,674,674,13,14,15,13,2,2,3,2,14,5,0,-1,-1,2
674,665,670,670,20,19,18,18,1,2,1,1,9,-5,0,1,1,0
886,886,886,881,14,14,13,13,1,3,2,3,0,0,5,0,1,0
712,703,703,703,20,19,20,18,1,1,2,2,9,0,0,1,-1,2
754,745,745,745,13,14,12,13,2,3,1,4,9,0,0,-1,2,-1
1012,1003,1003,1003,13,14,15,13,3,2,1,3,9,0,0,-1,-1,2
656,646,651,646,17,19,18,18,2,2,1,2,10,-5,5,-2,1,0
618,595,600,595,18,19,18,19,1,2,1,2,23,-5,5,-1,1,-1
309,304,300,300,18,19,18,19,1,1,2,1,5,4,0,-1,1,-1
759,754,754,754,17,19,18,18,2,1,1,1,5,0,0,-2,1,0
417,417,412,412,20,19,18,18,2,1,1,3,0,5,0,1,1,0
998,989,993,989,17,16,18,18,1,1,2,2,9,-4,4,1,-2,0
360,351,351,351,17,16,18,18,3,1,1,1,9,0,0,1,-2,0
806,792,796,796,18,17,18,19,1,2,3,1,14,-4,0,1,-1,-1
801,796,787,782,14,17,15,16,2,5,1,2,5,9,5,-3,2,-1
407,403,403,403,13,14,12,13,3,3,5,3,4,0,0,-1,2,-1
857,853,853,853,18,17,18,16,2,2,1,1,4,0,0,1,-1,2
337,337,328,328,17,16,18,16,1,1,1,1,0,9,0,1,-2,2
271,276,271,271,18,17,18,16,1,1,1,1,-5,5,0,1,-1,2
745,736,740,740,13,14,15,13,2,2,2,3,9,-4,0,-1,-1,2
689,679,679,674,13,16,15,16,2,1,2,3,10,0,5,-3,1,-1
834,829,862,829,14,14,15,13,1,2,1,2,5,-33,33,0,-1,2
745,740,740,736,13,14,12,13,1,1,2,2,5,0,4,-1,2,-1
979,979,974,970,13,14,12,13,2,1,1,1,0,5,4,-1,2,-1
970,960,960,965,20,19,20,18,1,2,1,1,10,0,-5,1,-1,2
300,295,290,290,18,17,18,19,2,3,1,2,5,5,0,1,-1,-1
337,337,337,337,20,19,20,21,2,1,2,1,0,0,0,1,-1,-1
792,787,792,787,14,14,15,13,3,2,1,1,5,-5,5,0,-1,2
1026,1017,1026,1021,20,19,20,21,1,1,1,2,9,-9,5,1,-1,-1
295,290,290,290,18,17,18,19,1,1,2,2,5,0,0,1,-1,-1
267,262,262,262,18,19,18,18,3,1,1,3,5,0,0,-1,1,0
1026,1012,1017,1017,13,14,15,13,2,2,2,1,14,-5,0,-1,-1,2
1007,998,998,998,17,19,18,18,5,2,1,1,9,0,0,-2,1,0
492,487,492,492,18,19,18,19,2,2,2,1,5,-5,0,-1,1,-1
768,768,768,768,20,19,20,21,1,1,1,3,0,0,0,1,-1,-1
670,665,665,665,20,19,20,21,1,1,1,2,5,0,0,1,-1,-1
684,679,674,670,17,19,18,18,2,3,2,2,5,5,4,-2,1,0
679,670,670,670,13,14,15,13,2,2,1,1,9,0,0,-1,-1,2
586,581,581,604,18,19,18,19,3,2,1,2,5,0,-23,-1,1,-1
581,581,581,581,18,17,18,19,1,3,2,1,0,0,0,1,-1,-1
581,581,581,586,21,19,20,21,2,1,1,1,0,0,-5,2,-1,-1
628,618,623,618,14,14,15,13,1,2,2,1,10,-5,5,0,-1,2
520,520,520,515,18,19,18,19,2,1,2,1,0,0,5,-1,1,-1
271,267,267,262,14,14,13,13,5,3,2,2,4,0,5,0,1,0
745,750,745,745,17,16,18,16,1,1,2,1,-5,5,0,1,-2,2
220,215,215,210,14,14,13,13,1,3,1,2,5,0,5,0,1,0
520,515,515,510,21,19,20,21,2,3,1,1,5,0,5,2,-1,-1
562,557,562,562,14,14,15,13,4,2,2,1,5,-5,0,0,-1,2
360,356,356,356,13,14,15,13,1,2,1,3,4,0,0,-1,-1,2
801,792,782,787,14,14,13,13,3,3,1,1,9,10,-5,0,1,0
286,286,286,286,18,19,18,19,1,1,3,1,0,0,0,-1,1,-1
567,562,562,562,14,14,15,13,1,3,1,1,5,0,0,0,-1,2
365,365,365,365,13,14,15,16,2,2,2,1,0,0,0,-1,-1,-1
473,473,473,473,20,19,20,18,1,1,1,1,0,0,0,1,-1,2
468,464,464,468,17,16,18,16,1,2,3,1,4,0,-4,1,-2,2
801,796,801,792,14,14,15,13,3,1,2,1,5,-5,9,0,-1,2
834,834,839,829,18,17,18,16,2,3,4,2,0,-5,10,1,-1,2
918,918,918,918,14,17,15,16,4,1,3,1,0,0,0,-3,2,-1
239,234,229,229,14,17,15,16,1,2,1,2,5,5,0,-3,2,-1
337,328,323,328,17,17,15,16,2,1,1,1,9,5,-5,0,2,-1
314,314,314,309,18,19,18,19,2,2,2,1,0,0,5,-1,1,-1
609,609,609,600,18,19,18,19,3,1,3,2,0,0,9,-1,1,-1
890,890,890,890,21,19,20,19,2,1,1,1,0,0,0,2,-1,1
1068,1059,1059,1059,13,16,15,16,1,1,3,1,9,0,0,-3,1,-1
412,407,412,407,13,14,15,16,1,2,3,2,5,-5,5,-1,-1,-1
1003,998,993,998,20,19,18,18,3,1,3,1,5,5,-5,1,1,0
1026,1017,1012,1012,13,14,15,13,1,4,2,1,9,5,0,-1,-1,2
1007,1007,1007,1003,13,14,12,13,1,2,2,1,0,0,4,-1,2,-1
379,374,365,365,20,19,18,18,1,3,1,2,5,9,0,1,1,0
974,970,979,970,17,16,18,16,3,3,1,1,4,-9,9,1,-2,2
834,820,824,824,18,17,18,16,1,2,1,2,14,-4,0,1,-1,2
773,773,768,768,13,16,15,16,1,1,1,1,0,5,0,-3,1,-1
853,857,853,853,18,17,18,18,2,4,2,3,-4,4,0,1,-1,0
867,848,848,853,14,14,13,13,4,3,1,3,19,0,-5,0,1,0
450,440,445,445,13,14,15,13,1,2,2,2,10,-5,0,-1,-1,2
1050,1050,1050,1040,13,16,15,16,1,3,2,1,0,0,10,-3,1,-1
1045,1040,1040,1040,17,16,18,18,3,2,2,1,5,0,0,1,-2,0
309,290,290,290,14,17,15,16,1,2,1,3,19,0,0,-3,2,-1
379,370,360,365,13,16,15,16,1,3,5,1,9,10,-5,-3,1,-1
581,567,567,562,14,17,15,16,2,2,2,2,14,0,5,-3,2,-1
562,562,557,553,14,14,15,13,3,1,1,2,0,5,4,0,-1,2
946,946,946,942,20,19,20,21,1,1,2,1,0,0,4,1,-1,-1
600,590,590,586,14,17,15,16,3,2,2,2,10,0,4,-3,2,-1
824,815,824,815,21,19,20,21,1,1,2,2,9,-9,9,2,-1,-1
993,984,984,984,13,14,15,13,3,3,1,1,9,0,0,-1,-1,2
923,914,914,909,18,17,18,16,3,3,2,3,9,0,5,1,-1,2
651,646,637,637,17,16,15,16,3,1,1,1,5,9,0,1,1,-1
881,881,881,881,14,17,15,16,2,3,3,3,0,0,0,-3,2,-1
314,314,309,314,14,14,15,13,3,4,1,1,0,5,-5,0,-1,2
482,478,487,487,14,14,15,16,2,1,1,2,4,-9,0,0,-1,-1
1054,1050,1059,1059,20,19,20,18,2,3,2,3,4,-9,0,1,-1,2
609,600,586,590,14,14,15,13,3,1,3,1,9,14,-4,0,-1,2
937,932,937,932,20,19,20,21,2,1,2,1,5,-5,5,1,-1,-1
562,553,548,548,18,17,18,16,1,3,1,2,9,5,0,1,-1,2
1021,1017,1017,1017,13,14,12,13,1,2,3,2,4,0,0,-1,2,-1
515,510,510,510,21,19,20,19,1,1,2,1,5,0,0,2,-1,1
895,886,886,886,18,17,18,16,1,3,1,2,9,0,0,1,-1,2
881,871,871,867,14,14,15,13,1,2,1,2,10,0,4,0,-1,2
1031,1021,1021,1021,17,16,18,18,2,1,1,2,10,0,0,1,-2,0
1021,1012,1017,1017,17,16,15,16,2,2,2,1,9,-5,0,1,1,-1
267,262,267,262,18,17,18,18,2,2,2,1,5,-5,5,1,-1,0
993,993,989,989,13,14,15,16,1,1,1,2,0,4,0,-1,-1,-1
403,398,398,407,20,19,20,18,1,2,1,1,5,0,-9,1,-1,2
768,764,759,754,20,19,20,18,4,1,1,2,4,5,5,1,-1,2
215,210,210,215,21,19,20,19,2,2,1,1,5,0,-5,2,-1,1
895,886,886,886,18,17,18,16,3,2,3,2,9,0,0,1,-1,2
506,492,492,492,21,19,21,19,1,1,1,1,14,0,0,2,-2,2
412,403,417,417,17,16,15,16,1,2,2,3,9,-14,0,1,1,-1
398,398,398,393,20,19,20,21,3,1,1,2,0,0,5,1,-1,-1
895,890,890,890,14,17,15,16,3,3,1,2,5,0,0,-3,2,-1
689,684,684,684,17,16,18,18,1,1,1,1,5,0,0,1,-2,0
951,946,946,942,13,14,15,16,2,1,3,1,5,0,4,-1,-1,-1
684,679,679,674,20,19,18,18,1,2,1,2,5,0,5,1,1,0
965,960,960,960,20,19,20,18,1,3,1,1,5,0,0,1,-1,2
1017,1012,1017,1012,13,14,12,13,2,2,1,1,5,-5,5,-1,2,-1
609,600,600,600,14,17,15,16,3,3,2,3,9,0,0,-3,2,-1
900,886,886,886,14,14,13,13,2,4,2,1,14,0,0,0,1,0
1007,1007,1003,998,13,14,12,13,1,2,1,2,0,4,5,-1,2,-1
806,801,801,801,18,17,18,19,3,2,1,1,5,0,0,1,-1,-1
618,623,618,618,14,14,15,16,2,3,1,2,-5,5,0,0,-1,-1
210,206,206,206,21,19,20,21,2,2,1,2,4,0,0,2,-1,-1
440,431,436,426,13,14,12,13,1,2,2,1,9,-5,10,-1,2,-1
824,815,810,810,14,17,15,16,2,1,1,2,9,5,0,-3,2,-1
942,937,942,937,13,14,12,13,1,1,2,2,5,-5,5,-1,2,-1
703,698,703,698,17,16,18,16,1,5,2,2,5,-5,5,1,-2,2
417,412,417,412,13,14,15,16,1,2,1,2,5,-5,5,-1,-1,-1
745,745,740,740,17,16,18,18,2,1,2,1,0,5,0,1,-2,0
637,637,628,623,20,19,21,19,2,2,1,1,0,9,5,1,-2,2
309,304,300,304,21,19,20,21,3,2,1,3,5,4,-4,2,-1,-1
468,464,468,468,17,16,15,16,2,2,1,1,4,-4,0,1,1,-1
496,496,492,492,14,14,15,13,1,3,3,1,0,4,0,0,-1,2
276,271,262,257,14,14,15,16,2,1,1,2,5,9,5,0,-1,-1
1017,1012,1012,1012,17,19,18,18,1,2,1,3,5,0,0,-2,1,0
384,379,374,374,13,14,12,13,2,3,2,2,5,5,0,-1,2,-1
890,890,890,890,14,17,15,16,1,3,1,2,0,0,0,-3,2,-1
562,562,567,557,14,14,15,16,2,3,2,2,0,-5,10,0,-1,-1
492,492,492,492,18,17,18,19,3,3,3,1,0,0,0,1,-1,-1
539,529,529,534,14,14,13,13,4,2,2,3,10,0,-5,0,1,0
412,407,398,393,20,19,20,21,1,1,1,1,5,9,5,1,-1,-1
628,618,618,614,14,14,13,13,1,1,1,3,10,0,4,0,1,0
459,454,454,450,13,16,15,16,3,3,2,2,5,0,4,-3,1,-1
534,520,515,520,18,19,18,19,2,1,2,3,14,5,-5,-1,1,-1
314,309,309,304,18,19,18,19,1,1,1,3,5,0,5,-1,1,-1
253,253,243,243,14,14,15,13,3,5,1,3,0,10,0,0,-1,2
637,632,623,623,13,14,15,13,1,2,1,2,5,9,0,-1,-1,2
567,553,557,553,14,14,13,13,3,2,2,2,14,-4,4,0,1,0
192,187,192,187,14,14,13,13,1,2,2,3,5,-5,5,0,1,0
693,684,689,693,13,14,12,13,1,2,3,1,9,-5,-4,-1,2,-1
586,553,557,557,14,14,15,13,2,1,1,3,33,-4,0,0,-1,2
1031,1021,1021,1021,20,19,18,18,2,2,4,1,10,0,0,1,1,0
534,529,534,534,21,19,20,21,3,2,1,1,5,-5,0,2,-1,-1
740,731,736,736,17,19,18,18,2,2,1,1,9,-5,0,-2,1,0
731,731,731,731,17,16,18,18,1,3,2,1,0,0,0,1,-2,0
567,553,548,543,14,14,13,13,2,2,1,3,14,5,5,0,1,0
239,220,210,210,14,14,13,13,1,3,1,1,19,10,0,0,1,0
590,586,590,590,18,19,18,19,2,2,2,1,4,-4,0,-1,1,-1
984,984,984,979,17,16,18,16,1,1,2,2,0,0,5,1,-2,2
515,515,510,510,14,14,15,16,3,1,1,1,0,5,0,0,-1,-1
834,824,824,820,18,17,18,19,3,1,2,2,10,0,4,1,-1,-1
618,618,614,609,14,14,15,13,1,1,2,1,0,4,5,0,-1,2
595,595,600,590,14,14,13,13,2,2,3,2,0,-5,10,0,1,0
787,787,792,787,14,17,15,16,2,2,2,1,0,-5,5,-3,2,-1
571,562,557,557,18,17,18,18,3,2,1,1,9,5,0,1,-1,0
604,595,595,595,21,19,20,21,2,1,1,2,9,0,0,2,-1,-1
736,726,726,731,13,14,12,13,3,3,1,2,10,0,-5,-1,2,-1
473,464,464,459,20,19,18,18,2,3,2,1,9,0,5,1,1,0
229,224,224,220,18,19,18,19,2,2,1,2,5,0,4,-1,1,-1
1017,1012,1012,1007,20,19,20,21,1,1,1,2,5,0,5,1,-1,-1
314,309,309,309,14,14,15,13,2,2,1,1,5,0,0,0,-1,2
810,810,806,806,14,14,15,16,1,2,2,1,0,4,0,0,-1,-1
271,271,271,271,18,19,18,18,2,2,1,1,0,0,0,-1,1,0
923,923,923,923,14,14,13,13,2,2,1,1,0,0,0,0,1,0
300,295,290,290,18,17,18,19,1,1,1,1,5,5,0,1,-1,-1
792,787,782,782,18,19,21,19,3,1,1,1,5,5,0,-1,-2,2
956,942,928,923,13,14,13,13,1,4,1,2,14,14,5,-1,1,0
956,951,951,951,13,14,12,13,1,1,1,2,5,0,0,-1,2,-1
951,989,974,974,13,16,15,13,1,1,2,2,-38,15,0,-3,1,2
1003,1003,993,993,20,19,20,18,1,1,1,1,0,10,0,1,-1,2
918,909,904,904,14,14,13,13,2,4,2,4,9,5,0,0,1,0
651,656,651,646,20,19,18,18,1,1,2,1,-5,5,5,1,1,0
276,271,271,271,14,17,15,16,2,2,1,5,5,0,0,-3,2,-1
623,614,623,628,18,19,18,19,2,3,1,1,9,-9,-5,-1,1,-1
501,487,496,496,14,14,13,13,1,4,2,1,14,-9,0,0,1,0
229,206,206,206,18,17,18,19,2,1,1,1,23,0,0,1,-1,-1
393,393,389,384,13,14,15,16,1,1,2,1,0,4,5,-1,-1,-1
239,229,234,234,14,14,15,13,1,2,3,3,10,-5,0,0,-1,2
651,642,646,642,20,19,20,18,1,2,2,1,9,-4,4,1,-1,2
234,229,229,234,14,14,13,13,2,3,2,2,5,0,-5,0,1,0
590,590,590,586,21,19,20,21,2,4,1,3,0,0,4,2,-1,-1
759,754,750,745,13,14,12,13,1,3,1,2,5,4,5,-1,2,-1
346,342,342,342,20,19,20,18,1,2,1,2,4,0,0,1,-1,2
501,496,496,496,18,17,18,19,2,1,1,1,5,0,0,1,-1,-1
703,693,693,839,13,14,12,16,1,2,1,1,10,0,-146,-1,2,-4
356,351,346,351,17,19,18,18,2,1,1,1,5,5,-5,-2,1,0
909,904,904,904,14,17,15,16,1,1,1,1,5,0,0,-3,2,-1
229,224,229,224,14,17,15,16,2,2,3,1,5,-5,5,-3,2,-1
717,712,707,703,17,16,15,16,5,2,3,2,5,5,4,1,1,-1
670,656,651,656,13,14,15,16,3,1,3,1,14,5,-5,-1,-1,-1
951,951,965,946,20,19,20,21,3,1,3,1,0,-14,19,1,-1,-1
689,670,689,651,13,14,12,13,2,2,3,1,19,-19,38,-1,2,-1
309,304,300,300,14,14,15,13,1,1,1,1,5,4,0,0,-1,2
571,571,571,576,14,14,13,13,2,3,2,3,0,0,-5,0,1,0
201,196,187,187,14,14,13,13,1,3,1,3,5,9,0,0,1,0
510,492,487,487,14,14,13,13,2,2,1,1,18,5,0,0,1,0
867,862,857,862,14,17,15,16,2,2,1,1,5,5,-5,-3,2,-1
1073,1068,1068,1068,20,19,18,18,1,1,1,1,5,0,0,1,1,0
829,824,824,824,21,19,20,19,1,2,1,1,5,0,0,2,-1,1
604,600,759,595,21,19,20,21,2,2,1,2,4,-159,164,2,-1,-1
365,360,365,360,13,14,12,13,1,2,2,2,5,-5,5,-1,2,-1
609,586,586,586,14,14,15,13,1,3,1,2,23,0,0,0,-1,2
871,867,867,862,14,14,15,13,2,1,1,2,4,0,5,0,-1,2
262,262,262,257,18,17,18,18,4,2,2,2,0,0,5,1,-1,0
370,365,360,360,17,16,15,16,1,1,1,1,5,5,0,1,1,-1
750,731,745,740,20,19,20,18,2,2,2,1,19,-14,5,1,-1,2
286,281,281,276,21,19,20,18,2,1,1,1,5,0,5,2,-1,2
698,698,698,698,13,14,15,13,1,3,2,2,0,0,0,-1,-1,2
201,187,192,196,14,14,15,13,2,3,1,1,14,-5,-4,0,-1,2
876,942,867,862,18,19,18,16,3,2,2,1,-66,75,5,-1,1,2
365,360,351,351,20,19,18,18,1,3,3,1,5,9,0,1,1,0
389,389,384,389,20,19,18,18,3,1,1,1,0,5,-5,1,1,0
421,417,417,417,13,14,15,13,1,2,1,1,4,0,0,-1,-1,2
637,632,628,628,13,16,15,16,1,1,2,1,5,4,0,-3,1,-1
370,360,360,360,13,14,12,13,2,2,1,3,10,0,0,-1,2,-1
745,736,726,726,17,16,18,16,2,2,3,3,9,10,0,1,-2,2
750,745,750,745,20,19,20,18,1,1,1,1,5,-5,5,1,-1,2
506,501,496,492,14,14,15,13,1,3,1,1,5,5,4,0,-1,2
801,792,778,778,18,19,18,18,3,1,1,1,9,14,0,-1,1,0
389,384,384,389,20,19,20,21,1,2,2,3,5,0,-5,1,-1,-1
454,454,454,454,13,14,12,13,3,1,2,1,0,0,0,-1,2,-1
904,900,900,900,18,17,18,19,1,1,1,2,4,0,0,1,-1,-1
323,318,323,318,18,17,18,16,2,1,4,2,5,-5,5,1,-1,2
393,384,384,384,13,14,12,13,1,3,2,1,9,0,0,-1,2,-1
679,670,665,665,13,14,15,13,2,3,2,2,9,5,0,-1,-1,2
1007,1012,1003,1012,20,19,20,18,1,1,1,1,-5,9,-9,1,-1,2
937,932,928,928,17,16,15,16,1,2,1,1,5,4,0,1,1,-1
384,374,374,374,17,16,18,18,2,2,1,1,10,0,0,1,-2,0
459,459,454,450,20,19,18,18,1,1,2,1,0,5,4,1,1,0
721,721,721,721,13,14,12,13,3,2,2,1,0,0,0,-1,2,-1
1012,1012,1007,1003,20,19,20,21,1,1,1,4,0,5,4,1,-1,-1
421,421,421,421,20,19,20,21,1,2,1,1,0,0,0,1,-1,-1
815,810,806,801,18,19,18,19,1,3,1,1,5,4,5,-1,1,-1
201,187,201,206,21,19,21,21,1,2,2,1,14,-14,-5,2,-2,0
356,356,356,356,13,14,15,16,2,2,1,2,0,0,0,-1,-1,-1
421,417,412,421,13,16,15,16,2,2,3,4,4,5,-9,-3,1,-1
595,586,586,586,18,17,18,19,1,2,2,1,9,0,0,1,-1,-1
1059,1054,1054,1054,17,16,18,16,2,2,1,2,5,0,0,1,-2,2
1012,1007,1007,1007,13,14,12,13,1,4,2,3,5,0,0,-1,2,-1
914,909,909,914,21,19,21,19,1,1,1,1,5,0,-5,2,-2,2
1059,1054,1054,1050,17,19,18,18,1,1,2,1,5,0,4,-2,1,0
918,923,918,918,21,19,21,21,2,2,1,3,-5,5,0,2,-2,0
571,571,571,571,14,17,15,16,2,2,2,3,0,0,0,-3,2,-1
342,332,342,328,20,19,18,19,2,2,3,1,10,-10,14,1,1,-1
628,614,623,618,14,14,15,13,1,2,2,2,14,-9,5,0,-1,2
459,450,445,445,13,14,12,13,2,2,1,2,9,5,0,-1,2,-1
365,360,365,360,20,19,20,21,2,3,2,1,5,-5,5,1,-1,-1
871,867,867,867,21,19,20,18,1,1,1,2,4,0,0,2,-1,2
567,567,567,562,14,17,15,16,2,2,2,1,0,0,5,-3,2,-1
239,234,224,224,18,19,18,19,2,1,3,1,5,10,0,-1,1,-1
637,637,637,632,17,16,18,18,1,3,3,1,0,0,5,1,-2,0
210,206,206,201,21,19,20,21,1,1,1,2,4,0,5,2,-1,-1
206,1073,1073,1073,18,19,18,18,2,1,3,1,-867,0,0,-1,1,0
886,871,871,871,14,17,15,16,1,3,1,1,15,0,0,-3,2,-1
318,323,323,318,14,14,15,13,2,1,2,2,-5,0,5,0,-1,2
487,482,478,473,18,19,18,18,1,1,1,2,5,4,5,-1,1,0
656,646,651,651,20,19,20,18,1,2,1,1,10,-5,0,1,-1,2
215,206,210,206,14,17,15,16,1,2,1,3,9,-4,4,-3,2,-1
454,445,450,450,17,16,18,16,3,2,2,1,9,-5,0,1,-2,2
187,182,187,182,18,19,18,19,1,1,2,1,5,-5,5,-1,1,-1
1031,1026,1026,1021,17,16,18,18,3,2,1,3,5,0,5,1,-2,0
243,239,239,239,14,17,15,16,2,3,1,1,4,0,0,-3,2,-1
684,679,679,679,13,14,12,13,2,2,1,1,5,0,0,-1,2,-1
993,993,989,993,13,14,15,13,1,3,3,1,0,4,-4,-1,-1,2
1059,1045,1045,1045,17,16,18,18,3,2,1,3,14,0,0,1,-2,0
576,576,571,571,18,19,18,18,1,1,1,2,0,5,0,-1,1,0
951,942,942,937,13,14,12,13,2,2,3,2,9,0,5,-1,2,-1
834,829,829,829,18,17,18,16,1,1,2,1,5,0,0,1,-1,2
407,398,389,393,13,14,15,13,2,3,3,1,9,9,-4,-1,-1,2
890,881,881,881,14,14,15,13,1,2,1,2,9,0,0,0,-1,2
534,524,524,524,18,17,18,19,2,2,4,2,10,0,0,1,-1,-1
684,679,679,679,20,19,20,21,1,1,1,1,5,0,0,1,-1,-1
553,548,543,543,21,19,20,21,1,1,1,1,5,5,0,2,-1,-1
1045,1036,1036,1031,13,14,15,13,1,1,1,2,9,0,5,-1,-1,2
820,815,815,810,14,14,15,16,1,2,1,1,5,0,5,0,-1,-1
1073,1064,1059,1059,13,14,12,13,1,2,3,1,9,5,0,-1,2,-1
614,618,609,609,21,19,21,19,4,1,1,1,-4,9,0,2,-2,2
370,365,365,365,17,16,18,16,1,1,1,1,5,0,0,1,-2,2
206,201,206,201,18,17,18,19,2,2,1,1,5,-5,5,1,-1,-1
867,862,862,857,21,19,20,21,2,2,4,2,5,0,5,2,-1,-1
337,332,328,323,20,19,18,19,2,2,1,2,5,4,5,1,1,-1
726,731,731,731,13,14,12,13,3,3,1,1,-5,0,0,-1,2,-1
989,979,989,979,20,19,20,21,1,2,2,6,10,-10,10,1,-1,-1
918,909,904,904,14,17,15,16,1,2,1,2,9,5,0,-3,2,-1
374,365,365,365,17,16,15,16,1,1,1,2,9,0,0,1,1,-1
553,548,548,548,14,17,15,16,1,3,1,1,5,0,0,-3,2,-1
1026,1021,1026,1026,13,14,15,13,1,1,1,1,5,-5,0,-1,-1,2
295,286,286,286,14,17,15,16,3,2,1,2,9,0,0,-3,2,-1
970,951,946,946,13,14,15,16,1,2,2,1,19,5,0,-1,-1,-1
693,689,689,689,17,16,18,18,1,2,2,1,4,0,0,1,-2,0
454,436,431,436,13,14,12,13,3,2,2,1,18,5,-5,-1,2,-1
1003,1003,998,998,13,16,15,16,3,3,1,1,0,5,0,-3,1,-1
304,300,300,300,14,14,13,13,2,3,2,1,4,0,0,0,1,0
951,951,946,951,17,16,18,18,1,3,3,1,0,5,-5,1,-2,0
543,539,543,539,18,17,18,18,2,4,2,2,4,-4,4,1,-1,0
834,829,829,829,14,14,13,13,1,1,1,1,5,0,0,0,1,0
281,276,276,271,18,19,18,18,2,3,2,2,5,0,5,-1,1,0
1021,1017,1017,1017,17,19,18,18,2,3,3,1,4,0,0,-2,1,0
1040,1040,1040,1036,13,16,15,16,1,2,2,2,0,0,4,-3,1,-1
703,698,698,698,17,16,18,16,1,2,1,1,5,0,0,1,-2,2
637,628,628,628,17,17,18,16,2,1,1,1,9,0,0,0,-1,2
323,318,318,323,21,19,21,21,1,1,1,2,5,0,-5,2,-2,0
609,604,604,604,18,17,18,16,1,1,5,1,5,0,0,1,-1,2
581,571,571,576,18,17,15,16,2,1,2,1,10,0,-5,1,2,-1
379,374,374,370,17,16,18,18,1,2,1,1,5,0,4,1,-2,0
609,604,604,604,14,14,15,16,2,4,1,1,5,0,0,0,-1,-1
365,356,351,351,17,16,15,16,2,2,3,3,9,5,0,1,1,-1
820,815,820,815,21,19,20,21,1,2,2,2,5,-5,5,2,-1,-1
642,628,628,628,13,14,15,16,2,1,1,1,14,0,0,-1,-1,-1
229,224,224,220,14,14,13,13,1,3,1,3,5,0,4,0,1,0
1050,1045,1045,1045,17,16,18,16,1,2,2,2,5,0,0,1,-2,2
337,332,337,332,20,19,18,18,2,1,2,1,5,-5,5,1,1,0
684,684,679,674,13,14,12,13,2,1,1,4,0,5,5,-1,2,-1
1054,1050,1050,1050,20,19,20,21,2,2,1,1,4,0,0,1,-1,-1
487,473,473,473,18,19,18,18,2,1,1,1,14,0,0,-1,1,0
450,450,445,445,13,16,15,16,1,1,3,1,0,5,0,-3,1,-1
1040,1036,1040,1040,20,19,18,18,1,4,1,1,4,-4,0,1,1,0
482,478,478,473,14,14,15,13,1,1,1,2,4,0,5,0,-1,2
586,581,581,576,14,14,15,13,2,2,2,1,5,0,5,0,-1,2
337,332,328,328,17,16,15,16,1,2,1,1,5,4,0,1,1,-1
796,806,801,796,21,19,21,19,2,1,2,1,-10,5,5,2,-2,2
642,637,642,637,13,14,15,13,4,2,2,1,5,-5,5,-1,-1,2
346,342,337,337,20,19,18,18,1,2,1,2,4,5,0,1,1,0
501,492,492,492,18,17,18,16,1,1,1,1,9,0,0,1,-1,2
895,886,890,886,21,19,20,19,3,3,1,1,9,-4,4,2,-1,1
510,515,515,506,18,17,18,19,3,1,1,2,-5,0,9,1,-1,-1
942,937,262,932,17,16,15,16,3,2,1,1,5,675,-670,1,1,-1
674,674,674,674,20,19,20,21,1,1,2,2,0,0,0,1,-1,-1
478,473,478,473,20,19,18,18,1,2,2,1,5,-5,5,1,1,0
403,393,393,393,17,16,18,18,2,2,1,1,10,0,0,1,-2,0
637,632,637,632,13,14,12,13,2,1,2,1,5,-5,5,-1,2,-1
267,257,262,262,14,14,15,13,1,1,2,1,10,-5,0,0,-1,2
904,900,900,895,14,14,15,16,1,2,2,1,4,0,5,0,-1,-1
881,876,881,881,18,19,18,19,2,2,2,1,5,-5,0,-1,1,-1
731,726,726,726,20,19,18,18,1,1,2,1,5,0,0,1,1,0
196,192,187,187,14,17,15,16,1,1,1,1,4,5,0,-3,2,-1
332,323,323,323,17,17,15,16,1,2,1,3,9,0,0,0,2,-1
464,459,464,459,20,19,20,21,1,2,1,1,5,-5,5,1,-1,-1
454,445,450,450,13,14,12,13,2,2,3,3,9,-5,0,-1,2,-1
393,384,379,417,13,14,15,13,1,2,1,1,9,5,-38,-1,-1,2
393,384,379,379,13,14,12,13,1,1,1,3,9,5,0,-1,2,-1
267,257,257,248,14,14,13,13,1,3,3,4,10,0,9,0,1,0
379,374,370,370,13,14,12,13,2,1,1,1,5,4,0,-1,2,-1
904,876,862,862,14,14,13,13,1,1,1,1,28,14,0,0,1,0
318,323,323,323,21,19,21,19,2,1,2,1,-5,0,0,2,-2,2
506,496,487,492,14,14,13,13,1,3,1,3,10,9,-5,0,1,0
276,271,271,290,21,19,20,19,1,1,2,1,5,0,-19,2,-1,1
1059,1050,1050,1045,13,14,15,13,2,2,2,2,9,0,5,-1,-1,2
1012,1012,1012,1007,17,16,15,16,1,3,2,1,0,0,5,1,1,-1
670,665,665,665,17,16,18,18,2,3,2,1,5,0,0,1,-2,0
370,360,365,360,20,19,20,21,1,3,2,2,10,-5,5,1,-1,-1
768,759,759,754,20,19,20,21,2,2,1,1,9,0,5,1,-1,-1
543,539,539,534,21,19,20,18,2,1,2,2,4,0,5,2,-1,2
304,309,304,314,18,17,18,19,2,1,5,1,-5,5,-10,1,-1,-1
768,764,759,759,13,14,12,13,1,3,1,2,4,5,0,-1,2,-1
904,900,900,900,21,19,20,19,3,1,1,1,4,0,0,2,-1,1
445,445,450,440,13,14,12,13,1,1,2,2,0,-5,10,-1,2,-1
224,215,215,220,14,14,15,16,1,2,3,1,9,0,-5,0,-1,-1
304,290,286,286,14,14,13,13,2,5,2,1,14,4,0,0,1,0
974,970,970,965,13,14,15,13,1,3,1,2,4,0,5,-1,-1,2
693,684,679,684,13,14,12,13,1,2,5,2,9,5,-5,-1,2,-1
665,660,656,656,13,14,15,13,3,4,1,1,5,4,0,-1,-1,2
609,595,595,590,18,17,18,19,3,1,1,3,14,0,5,1,-1,-1
389,379,379,374,13,16,15,16,1,1,1,1,10,0,5,-3,1,-1
1045,1040,1036,1036,17,19,18,18,1,1,1,1,5,4,0,-2,1,0
928,923,918,918,21,19,21,21,1,1,1,2,5,5,0,2,-2,0
1007,1007,1007,1003,20,19,18,18,1,3,2,1,0,0,4,1,1,0
974,965,970,965,20,19,20,21,1,2,1,1,9,-5,5,1,-1,-1
918,918,909,909,18,19,18,19,1,1,2,3,0,9,0,-1,1,-1
398,398,393,389,20,19,20,18,1,1,1,2,0,5,4,1,-1,2
857,857,853,843,18,19,18,18,3,1,3,2,0,4,10,-1,1,0
595,595,586,590,21,19,20,19,2,4,3,1,0,9,-4,2,-1,1
956,956,942,946,17,19,18,18,1,1,1,1,0,14,-4,-2,1,0
745,740,740,745,20,19,20,21,1,1,1,1,5,0,-5,1,-1,-1
792,782,792,787,18,17,18,16,4,2,2,2,10,-10,5,1,-1,2
806,806,806,801,14,17,15,16,3,1,1,2,0,0,5,-3,2,-1
646,646,642,642,20,19,20,18,1,1,1,2,0,4,0,1,-1,2
342,337,332,332,13,14,13,13,2,3,1,1,5,5,0,-1,1,0
740,731,721,721,13,14,12,13,3,3,1,3,9,10,0,-1,2,-1
314,304,304,304,21,19,20,19,1,1,1,1,10,0,0,2,-1,1
286,286,281,281,21,19,20,21,1,3,1,4,0,5,0,2,-1,-1
304,309,300,304,14,17,15,16,3,4,2,1,-5,9,-4,-3,2,-1
1068,1068,1064,1054,13,14,15,13,1,3,1,2,0,4,10,-1,-1,2
801,796,792,792,21,19,21,21,3,1,1,1,5,4,0,2,-2,0
651,646,646,637,17,16,18,16,1,2,1,2,5,0,9,1,-2,2
815,815,810,810,14,14,15,16,1,3,3,1,0,5,0,0,-1,-1
693,684,693,693,17,16,18,16,2,1,1,2,9,-9,0,1,-2,2
900,900,900,904,18,19,18,19,1,2,2,3,0,0,-4,-1,1,-1
782,782,773,778,14,14,15,16,1,1,3,1,0,9,-5,0,-1,-1
417,417,412,412,17,16,15,16,3,3,1,1,0,5,0,1,1,-1
459,454,450,445,13,14,12,13,1,1,1,2,5,4,5,-1,2,-1
839,829,834,829,18,17,18,19,2,4,1,1,10,-5,5,1,-1,-1
712,712,707,703,17,16,15,16,3,3,1,2,0,5,4,1,1,-1
689,689,693,689,20,19,20,18,1,1,1,1,0,-4,4,1,-1,2
703,693,693,693,13,14,15,13,2,1,2,1,10,0,0,-1,-1,2
590,576,576,581,14,17,15,16,1,2,1,1,14,0,-5,-3,2,-1
834,834,834,829,14,14,15,13,2,2,3,2,0,0,5,0,-1,2
553,548,543,543,14,14,15,16,4,4,1,1,5,5,0,0,-1,-1
510,492,492,492,14,14,13,13,2,4,2,1,18,0,0,0,1,0
210,210,210,210,21,19,20,21,2,2,3,1,0,0,0,2,-1,-1
839,839,839,839,14,14,13,13,2,3,4,1,0,0,0,0,1,0
698,689,679,674,13,16,15,16,2,1,1,1,9,10,5,-3,1,-1
567,567,571,562,18,17,18,18,2,1,2,2,0,-4,9,1,-1,0
960,960,956,956,13,14,15,13,1,3,2,3,0,4,0,-1,-1,2
806,801,801,801,21,19,21,21,1,2,1,1,5,0,0,2,-2,0
557,548,553,553,14,17,15,16,1,2,5,1,9,-5,0,-3,2,-1
243,239,243,243,14,17,15,16,3,1,2,2,4,-4,0,-3,2,-1
1040,1026,1036,1031,13,14,12,13,3,2,2,1,14,-10,5,-1,2,-1
557,543,543,553,21,19,20,18,1,2,3,1,14,0,-10,2,-1,2
379,370,370,374,20,19,18,18,3,2,1,3,9,0,-4,1,1,0
506,506,506,501,14,14,13,13,1,1,1,5,0,0,5,0,1,0
759,764,759,759,20,19,20,18,1,1,3,3,-5,5,0,1,-1,2
431,426,426,426,17,16,18,18,3,2,1,2,5,0,0,1,-2,0
482,468,487,487,18,16,18,16,1,2,2,2,14,-19,0,2,-2,2
323,323,323,318,18,17,18,19,2,2,1,2,0,0,5,1,-1,-1
853,848,848,829,18,19,18,19,1,1,1,8,5,0,19,-1,1,-1
1068,1064,1073,1078,17,19,18,18,2,2,2,1,4,-9,-5,-2,1,0
1021,1012,1012,1007,13,14,15,13,1,1,1,1,9,0,5,-1,-1,2
342,332,665,323,17,16,10,16,2,1,1,1,10,-333,342,1,6,-6
501,492,496,492,18,19,18,19,1,2,2,1,9,-4,4,-1,1,-1
1064,1064,1064,1059,13,14,12,13,1,1,2,2,0,0,5,-1,2,-1
407,398,403,398,17,19,18,18,1,2,1,1,9,-5,5,-2,1,0
468,468,468,468,13,14,15,16,1,3,3,1,0,0,0,-1,-1,-1
824,820,820,820,21,19,20,19,1,1,1,1,4,0,0,2,-1,1
670,665,665,670,13,14,15,16,2,2,1,1,5,0,-5,-1,-1,-1
909,900,900,900,14,14,13,13,3,1,1,1,9,0,0,0,1,0
562,557,562,557,18,19,18,18,3,4,2,1,5,-5,5,-1,1,0
1026,1021,1026,1026,13,14,12,13,1,4,1,1,5,-5,0,-1,2,-1
693,693,698,693,13,14,12,13,3,2,1,1,0,-5,5,-1,2,-1
1003,989,984,979,17,16,18,18,2,1,1,1,14,5,5,1,-2,0
267,262,262,262,14,17,15,16,3,2,1,2,5,0,0,-3,2,-1
403,398,403,403,13,16,15,16,1,2,2,4,5,-5,0,-3,1,-1
464,459,464,459,13,14,15,16,1,3,1,1,5,-5,5,-1,-1,-1
553,548,548,543,14,14,13,13,1,3,2,1,5,0,5,0,1,0
468,450,445,445,17,16,18,18,1,1,2,1,18,5,0,1,-2,0
281,271,267,271,21,19,20,21,1,1,1,1,10,4,-4,2,-1,-1
736,731,731,731,17,16,15,16,1,1,3,3,5,0,0,1,1,-1
745,736,731,731,13,14,12,13,2,2,1,1,9,5,0,-1,2,-1
553,553,557,548,14,14,13,13,3,2,2,1,0,-4,9,0,1,0
979,979,974,974,17,16,15,16,3,1,3,1,0,5,0,1,1,-1
576,571,567,567,14,14,15,13,2,3,2,1,5,4,0,0,-1,2
632,637,632,632,20,19,20,18,1,1,1,2,-5,5,0,1,-1,2
750,750,750,750,17,16,18,18,1,4,2,3,0,0,0,1,-2,0
787,759,759,759,18,16,18,18,1,4,1,1,28,0,0,2,-2,0
304,304,318,323,14,14,15,13,2,1,2,2,0,-14,-5,0,-1,2
360,356,351,346,20,19,20,21,2,1,1,2,4,5,5,1,-1,-1
886,881,886,881,18,19,18,19,2,1,1,1,5,-5,5,-1,1,-1
206,192,201,201,21,19,21,19,3,2,2,1,14,-9,0,2,-2,2
524,529,529,529,14,14,13,13,2,2,2,1,-5,0,0,0,1,0
454,450,450,450,20,19,20,21,1,1,1,4,4,0,0,1,-1,-1
721,712,712,712,13,14,12,13,1,3,1,1,9,0,0,-1,2,-1
520,515,520,515,14,17,15,16,2,1,2,2,5,-5,5,-3,2,-1
1050,1045,1045,1040,17,19,18,18,1,1,2,2,5,0,5,-2,1,0
1059,1050,1050,1050,13,14,12,13,1,1,2,3,9,0,0,-1,2,-1
314,290,300,300,18,17,18,19,1,2,2,2,24,-10,0,1,-1,-1
1073,1068,1064,1064,17,16,18,18,1,1,1,1,5,4,0,1,-2,0
464,454,459,454,13,14,12,13,3,2,4,3,10,-5,5,-1,2,-1
262,253,257,253,14,14,13,13,1,2,2,1,9,-4,4,0,1,0
1026,1031,1021,1017,20,19,20,18,3,1,2,2,-5,10,4,1,-1,2
262,253,253,253,14,17,15,16,2,2,2,2,9,0,0,-3,2,-1
478,473,478,473,13,14,13,13,1,2,2,2,5,-5,5,-1,1,0
979,979,984,979,17,16,18,18,1,3,2,1,0,-5,5,1,-2,0
974,970,965,970,17,16,15,16,2,3,3,2,4,5,-5,1,1,-1
1026,1026,1026,1026,17,16,15,16,1,2,2,1,0,0,0,1,1,-1
843,829,824,824,14,14,13,13,3,1,1,3,14,5,0,0,1,0
839,829,829,829,18,17,15,16,1,2,3,2,10,0,0,1,2,-1
187,1073,1068,1073,14,14,15,13,3,3,1,3,-886,5,-5,0,-1,2
196,196,196,196,14,17,15,16,2,2,1,2,0,0,0,-3,2,-1
248,243,248,248,21,19,20,18,2,3,1,1,5,-5,0,2,-1,2
890,886,886,881,14,17,15,16,1,2,2,2,4,0,5,-3,2,-1
918,923,923,918,18,17,18,19,2,1,3,1,-5,0,5,1,-1,-1
768,764,768,759,20,19,18,18,3,1,2,1,4,-4,9,1,1,0
342,332,332,323,17,16,18,16,4,2,1,2,10,0,9,1,-2,2
740,745,740,736,17,16,15,16,3,3,2,1,-5,5,4,1,1,-1
323,323,318,318,18,19,18,19,2,1,1,1,0,5,0,-1,1,-1
1017,248,1012,1017,13,14,15,13,1,1,1,1,769,-764,-5,-1,-1,2
637,623,614,614,13,14,13,13,1,2,2,3,14,9,0,-1,1,0
271,271,271,271,14,14,15,13,3,2,2,1,0,0,0,0,-1,2
318,314,323,318,18,19,18,19,3,2,1,1,4,-9,5,-1,1,-1
351,346,337,337,13,16,15,16,2,4,1,1,5,9,0,-3,1,-1
436,426,426,426,17,16,15,16,1,3,1,1,10,0,0,1,1,-1
576,576,571,571,14,14,13,13,2,3,1,2,0,5,0,0,1,0
618,609,600,600,18,17,18,19,2,1,1,1,9,9,0,1,-1,-1
379,374,370,365,17,16,18,18,2,1,3,2,5,4,5,1,-2,0
520,520,515,510,14,14,13,13,2,3,1,1,0,5,5,0,1,0
187,187,187,182,14,17,15,16,1,1,2,1,0,0,5,-3,2,-1
951,942,942,951,17,16,15,16,2,1,1,1,9,0,-9,1,1,-1
867,862,862,867,14,14,15,13,1,2,3,1,5,0,-5,0,-1,2
736,731,731,736,13,14,12,13,1,1,1,3,5,0,-5,-1,2,-1
515,515,510,510,14,17,15,16,1,2,1,1,0,5,0,-3,2,-1
482,482,487,482,14,14,15,16,1,2,2,1,0,-5,5,0,-1,-1
773,768,768,764,13,14,12,13,3,1,1,1,5,0,4,-1,2,-1
1021,1012,1007,1003,13,14,15,13,1,3,2,1,9,5,4,-1,-1,2
515,506,501,506,14,17,15,16,1,2,1,1,9,5,-5,-3,2,-1
904,904,904,904,21,19,20,19,1,1,2,1,0,0,0,2,-1,1
417,421,417,417,20,19,20,21,1,4,1,1,-4,4,0,1,-1,-1
398,389,389,389,13,14,15,13,2,1,1,1,9,0,0,-1,-1,2
1045,1036,1040,1040,20,19,20,21,4,4,1,1,9,-4,0,1,-1,-1
295,300,304,295,14,14,13,13,2,3,2,2,-5,-4,9,0,1,0
993,993,993,993,20,19,20,18,1,1,2,1,0,0,0,1,-1,2
201,1078,1073,1064,14,14,12,13,1,1,2,2,-877,5,9,0,2,-1
843,839,843,839,18,17,18,18,2,2,2,1,4,-4,4,1,-1,0
440,431,426,426,17,16,18,18,2,1,1,3,9,5,0,1,-2,0
1078,1064,1064,1064,13,14,12,13,1,2,1,3,14,0,0,-1,2,-1
492,492,487,482,14,17,15,16,2,2,1,1,0,5,5,-3,2,-1
754,750,745,745,20,19,20,21,3,3,1,1,4,5,0,1,-1,-1
970,965,965,965,20,19,18,18,1,3,1,1,5,0,0,1,1,0
595,590,595,590,14,14,13,13,1,3,2,1,5,-5,5,0,1,0
759,754,754,754,20,19,20,21,1,1,1,3,5,0,0,1,-1,-1
314,318,318,314,18,19,18,19,2,1,1,3,-4,0,4,-1,1,-1
871,867,867,857,14,14,15,13,1,2,2,2,4,0,10,0,-1,2
886,745,745,745,14,16,15,16,1,3,2,1,141,0,0,-2,1,-1
857,843,843,848,21,19,20,21,3,1,3,3,14,0,-5,2,-1,-1
407,403,398,393,13,14,15,13,1,3,2,3,4,5,5,-1,-1,2
703,698,689,693,20,19,20,21,1,3,1,3,5,9,-4,1,-1,-1
286,281,290,267,21,19,20,18,1,1,1,2,5,-9,23,2,-1,2
1054,1045,1045,1040,17,19,18,18,6,3,5,2,9,0,5,-2,1,0
623,623,628,623,18,19,18,19,2,2,1,2,0,-5,5,-1,1,-1
970,965,970,970,13,16,15,16,2,2,2,1,5,-5,0,-3,1,-1
295,290,290,290,14,17,15,16,1,2,2,1,5,0,0,-3,2,-1
829,820,824,820,18,17,18,19,1,2,2,1,9,-4,4,1,-1,-1
201,187,187,187,14,14,15,13,2,2,3,2,14,0,0,0,-1,2
257,243,243,239,18,19,18,18,1,2,1,3,14,0,4,-1,1,0
843,839,839,839,21,19,20,18,3,2,2,1,4,0,0,2,-1,2
314,309,314,309,21,19,21,21,1,1,1,2,5,-5,5,2,-2,0
623,609,604,600,14,17,15,16,2,1,1,2,14,5,4,-3,2,-1
796,782,787,782,14,17,15,16,1,2,2,1,14,-5,5,-3,2,-1
421,421,417,421,13,14,12,13,1,3,1,1,0,4,-4,-1,2,-1
192,187,187,182,18,17,18,19,2,2,2,1,5,0,5,1,-1,-1
707,707,698,698,13,14,12,13,1,3,1,3,0,9,0,-1,2,-1
440,431,436,431,20,19,18,18,1,2,2,2,9,-5,5,1,1,0
586,581,586,581,14,14,15,13,3,3,2,3,5,-5,5,0,-1,2
895,890,895,890,18,19,18,19,3,3,2,1,5,-5,5,-1,1,-1
609,600,600,595,14,14,15,13,2,3,1,2,9,0,5,0,-1,2
614,609,604,600,18,19,18,19,1,1,2,1,5,5,4,-1,1,-1
824,810,806,801,14,14,13,13,3,1,2,2,14,4,5,0,1,0
450,440,436,436,13,14,12,13,1,3,1,1,10,4,0,-1,2,-1
421,403,398,398,13,14,12,13,2,2,1,1,18,5,0,-1,2,-1
984,974,960,960,13,14,15,13,3,2,1,2,10,14,0,-1,-1,2
253,253,248,243,14,14,15,13,3,3,3,2,0,5,5,0,-1,2
267,257,253,253,18,19,18,18,2,1,1,1,10,4,0,-1,1,0
862,857,862,853,14,14,13,13,2,4,2,2,5,-5,9,0,1,0
839,834,834,824,14,14,15,13,1,3,2,2,5,0,10,0,-1,2
604,604,600,600,21,19,20,21,1,1,1,1,0,4,0,2,-1,-1
346,342,337,337,13,14,12,13,4,3,3,2,4,5,0,-1,2,-1
778,773,778,773,13,14,13,13,2,2,1,2,5,-5,5,-1,1,0
187,182,1078,1073,21,19,20,18,3,1,1,3,5,-896,5,2,-1,2
843,829,820,824,14,14,13,13,2,4,1,1,14,9,-4,0,1,0
1068,1068,1073,1073,17,16,18,18,1,2,2,2,0,-5,0,1,-2,0
651,651,642,642,13,14,12,13,1,1,1,1,0,9,0,-1,2,-1
342,337,342,337,13,14,12,13,3,3,2,1,5,-5,5,-1,2,-1
501,487,482,482,14,14,13,13,2,2,1,1,14,5,0,0,1,0
314,304,309,309,18,17,18,19,1,2,2,1,10,-5,0,1,-1,-1
370,360,365,365,17,16,18,16,1,2,1,1,10,-5,0,1,-2,2
698,698,703,707,20,19,20,18,1,2,1,1,0,-5,-4,1,-1,2
595,590,590,586,14,14,15,13,2,3,2,2,5,0,4,0,-1,2
595,586,590,586,21,19,20,21,3,3,2,1,9,-4,4,2,-1,-1
1050,1045,1040,1040,13,16,15,16,5,3,2,2,5,5,0,-3,1,-1
660,656,656,651,13,14,12,13,2,2,1,2,4,0,5,-1,2,-1
862,262,867,876,18,19,18,18,1,1,2,2,600,-605,-9,-1,1,0
590,586,586,586,14,17,15,16,3,2,1,1,4,0,0,-3,2,-1
1059,1050,1050,1054,20,19,20,21,2,1,1,1,9,0,-4,1,-1,-1
914,909,900,900,18,19,18,19,2,3,1,3,5,9,0,-1,1,-1
571,571,567,567,14,14,13,13,2,2,1,2,0,4,0,0,1,0
464,464,478,459,13,14,13,13,1,3,2,1,0,-14,19,-1,1,0
886,881,220,881,18,19,20,19,2,2,1,1,5,661,-661,-1,-1,1
1026,1021,1017,1017,13,14,15,13,3,2,1,1,5,4,0,-1,-1,2
909,909,909,904,14,14,13,13,2,3,2,2,0,0,5,0,1,0
323,318,318,318,14,14,15,13,3,3,2,1,5,0,0,0,-1,2
482,482,478,473,14,14,13,13,2,1,2,2,0,4,5,0,1,0
473,473,468,468,13,14,12,13,1,1,5,3,0,5,0,-1,2,-1
881,871,867,867,14,14,15,13,2,2,1,1,10,4,0,0,-1,2
309,304,304,304,18,17,18,16,3,1,1,1,5,0,0,1,-1,2
234,224,224,224,14,17,15,16,1,2,2,1,10,0,0,-3,2,-1
309,304,304,300,18,17,18,19,2,2,2,1,5,0,4,1,-1,-1
351,346,346,337,17,19,18,18,1,2,2,1,5,0,9,-2,1,0
360,356,356,356,20,19,20,18,1,1,1,1,4,0,0,1,-1,2
482,468,473,478,18,16,18,16,2,2,1,1,14,-5,-5,2,-2,2
346,342,342,342,17,19,18,18,2,1,2,1,4,0,0,-2,1,0
843,839,839,834,18,17,18,16,3,1,1,3,4,0,5,1,-1,2
998,993,989,989,17,16,15,16,3,3,5,1,5,4,0,1,1,-1
1036,1031,1031,1031,13,14,15,13,1,2,1,3,5,0,0,-1,-1,2
604,609,604,600,14,14,13,13,3,3,1,1,-5,5,4,0,1,0
1031,1007,1007,1007,20,19,20,21,1,3,1,1,24,0,0,1,-1,-1
604,595,590,590,14,14,13,13,3,1,1,2,9,5,0,0,1,0
187,1078,1078,1073,14,16,15,16,1,1,1,2,-891,0,5,-2,1,-1
351,342,337,323,17,19,18,19,1,2,2,2,9,5,14,-2,1,-1
937,923,914,923,13,14,13,13,3,2,3,2,14,9,-9,-1,1,0
365,360,356,356,13,14,15,13,1,3,1,2,5,4,0,-1,-1,2
956,951,946,946,13,14,15,13,2,3,2,4,5,5,0,-1,-1,2
839,829,829,834,14,14,15,13,3,3,1,2,10,0,-5,0,-1,2
1068,1059,1078,187,20,19,20,21,4,1,1,1,9,-19,891,1,-1,-1
295,281,267,267,18,19,18,18,1,2,1,1,14,14,0,-1,1,0
356,346,346,342,13,16,15,16,1,2,2,2,10,0,4,-3,1,-1
506,492,496,496,14,14,13,13,1,1,2,1,14,-4,0,0,1,0
946,937,937,937,13,14,12,13,2,3,2,1,9,0,0,-1,2,-1
553,543,543,543,14,14,15,16,3,2,1,2,10,0,0,0,-1,-1
876,871,876,871,21,19,20,18,2,1,3,2,5,-5,5,2,-1,2
571,562,557,557,21,19,20,21,1,1,1,3,9,5,0,2,-1,-1
726,717,707,276,20,19,20,13,1,2,1,1,9,10,431,1,-1,7
951,942,946,946,13,14,12,13,1,1,2,1,9,-4,0,-1,2,-1
234,224,229,229,14,14,13,13,2,5,2,3,10,-5,0,0,1,0
553,553,543,539,18,19,18,18,2,3,1,2,0,10,4,-1,1,0
693,684,684,679,20,19,20,18,2,1,1,1,9,0,5,1,-1,2
970,965,965,960,20,19,20,21,3,1,1,1,5,0,5,1,-1,-1
1036,1031,1036,1036,20,19,18,18,2,2,1,1,5,-5,0,1,1,0
257,248,253,253,21,19,20,21,1,1,2,2,9,-5,0,2,-1,-1
820,810,810,810,14,14,13,13,3,3,1,1,10,0,0,0,1,0
721,717,721,712,13,14,12,13,1,5,2,1,4,-4,9,-1,2,-1
604,595,595,595,14,17,15,16,1,2,2,1,9,0,0,-3,2,-1
796,918,773,773,14,14,15,16,3,1,2,1,-122,145,0,0,-1,-1
646,651,646,651,20,19,20,18,3,1,1,1,-5,5,-5,1,-1,2
998,989,984,984,17,16,18,18,2,1,1,1,9,5,0,1,-2,0
886,876,876,876,14,17,15,16,2,3,1,1,10,0,0,-3,2,-1
1040,1031,1036,1031,17,16,18,18,3,2,4,1,9,-5,5,1,-2,0
815,796,792,792,14,17,15,16,2,2,1,1,19,4,0,-3,2,-1
923,923,918,918,21,19,21,19,1,2,1,2,0,5,0,2,-2,2
792,796,792,792,18,19,18,19,2,3,3,1,-4,4,0,-1,1,-1
337,323,323,318,13,14,15,13,2,2,2,2,14,0,5,-1,-1,2
571,553,1059,553,14,14,18,13,1,2,1,1,18,-506,506,0,-4,5
810,801,806,806,14,14,13,13,3,2,2,2,9,-5,0,0,1,0
670,660,660,660,20,19,18,18,2,1,2,1,10,0,0,1,1,0
881,876,876,876,21,19,20,18,1,4,1,1,5,0,0,2,-1,2
548,543,543,543,18,17,18,18,1,1,1,3,5,0,0,1,-1,0
1064,1054,1054,1059,20,19,18,18,2,2,1,1,10,0,-5,1,1,0
707,698,703,707,17,16,15,16,1,2,2,1,9,-5,-4,1,1,-1
323,309,314,314,14,17,15,16,2,3,2,3,14,-5,0,-3,2,-1
412,407,407,403,20,19,20,18,2,3,1,1,5,0,4,1,-1,2
993,993,989,989,20,19,18,18,2,1,3,1,0,4,0,1,1,0
946,946,942,942,17,16,18,16,2,3,2,1,0,4,0,1,-2,2
248,239,262,243,14,14,15,13,5,3,3,2,9,-23,19,0,-1,2
586,581,576,576,14,14,15,16,1,3,1,2,5,5,0,0,-1,-1
600,590,595,600,18,19,18,19,2,1,1,1,10,-5,-5,-1,1,-1
271,271,271,271,14,14,13,13,2,2,2,2,0,0,0,0,1,0
276,271,257,253,21,19,20,18,3,3,1,1,5,14,4,2,-1,2
515,506,510,506,18,17,18,19,3,2,2,2,9,-4,4,1,-1,-1
323,318,318,314,18,17,18,16,1,3,2,2,5,0,4,1,-1,2
459,450,450,454,20,19,20,21,2,3,1,1,9,0,-4,1,-1,-1
314,300,403,309,14,14,15,16,1,2,1,1,14,-103,94,0,-1,-1
309,300,300,300,14,14,15,16,1,2,2,1,9,0,0,0,-1,-1
736,721,721,726,20,19,18,18,1,1,1,1,15,0,-5,1,1,0
979,974,970,965,13,14,15,13,2,3,1,2,5,4,5,-1,-1,2
750,740,745,740,13,14,15,13,2,2,2,3,10,-5,5,-1,-1,2
243,229,234,224,14,14,13,13,2,2,2,2,14,-5,10,0,1,0
778,773,778,773,20,19,20,21,2,2,1,2,5,-5,5,1,-1,-1
337,337,337,332,13,14,15,13,1,1,2,1,0,0,5,-1,-1,2
745,736,736,736,13,14,12,13,3,1,2,1,9,0,0,-1,2,-1
824,820,820,820,14,17,15,16,2,2,3,1,4,0,0,-3,2,-1
417,412,417,412,17,16,18,18,1,2,2,1,5,-5,5,1,-2,0
262,257,257,253,21,19,20,21,1,2,3,2,5,0,4,2,-1,-1
862,853,848,853,14,14,13,13,3,3,2,1,9,5,-5,0,1,0
618,609,604,604,14,14,15,13,3,4,3,1,9,5,0,0,-1,2
257,253,248,248,18,17,18,16,2,1,1,1,4,5,0,1,-1,2
290,290,290,290,18,17,18,16,2,1,2,1,0,0,0,1,-1,2
304,304,304,300,18,17,18,19,2,3,2,1,0,0,4,1,-1,-1
660,646,646,646,13,14,12,13,3,2,2,1,14,0,0,-1,2,-1
1073,1064,1068,1064,20,19,20,18,2,2,1,1,9,-4,4,1,-1,2
843,839,839,839,18,17,18,18,1,2,5,1,4,0,0,1,-1,0
342,337,337,337,13,14,15,16,1,2,3,1,5,0,0,-1,-1,-1
932,923,918,928,20,19,18,19,1,2,1,1,9,5,-10,1,1,-1
759,754,745,740,17,16,15,16,1,3,3,2,5,9,5,1,1,-1
1017,1007,1003,1003,13,14,15,16,1,2,3,3,10,4,0,-1,-1,-1
1073,1068,1064,1059,20,19,20,18,2,2,1,2,5,4,5,1,-1,2
576,567,571,567,18,17,18,16,1,2,2,2,9,-4,4,1,-1,2
520,510,515,515,14,14,15,13,1,2,3,3,10,-5,0,0,-1,2
239,229,229,229,21,19,20,21,2,2,1,1,10,0,0,2,-1,-1
787,782,778,778,21,19,20,21,1,1,1,1,5,4,0,2,-1,-1
337,332,332,332,13,14,15,13,3,2,1,1,5,0,0,-1,-1,2
224,215,210,215,14,17,15,16,1,1,1,1,9,5,-5,-3,2,-1
459,464,464,459,13,16,15,16,3,2,2,2,-5,0,5,-3,1,-1
304,290,286,286,14,14,15,13,2,2,1,1,14,4,0,0,-1,2
604,600,600,600,18,19,18,19,2,1,1,1,4,0,0,-1,1,-1
356,351,356,351,17,19,18,18,2,1,2,2,5,-5,5,-2,1,0
286,276,281,271,18,17,18,16,1,2,2,2,10,-5,10,1,-1,2
304,295,300,300,21,19,20,21,1,2,2,1,9,-5,0,2,-1,-1
628,618,623,628,14,17,15,16,1,2,2,1,10,-5,-5,-3,2,-1
876,871,871,871,14,17,15,16,2,3,1,2,5,0,0,-3,2,-1
1073,220,1073,1073,17,17,18,18,3,2,2,1,853,-853,0,0,-1,0
557,553,553,553,21,19,20,18,3,1,2,1,4,0,0,2,-1,2
914,904,904,904,14,14,15,13,2,3,1,1,10,0,0,0,-1,2
618,614,614,609,21,19,21,21,2,2,1,2,4,0,5,2,-2,0
970,960,951,946,13,16,15,16,1,5,1,2,10,9,5,-3,1,-1
890,857,857,857,14,14,15,13,2,3,2,1,33,0,0,0,-1,2
726,717,717,712,13,14,12,13,1,3,1,3,9,0,5,-1,2,-1
464,459,459,459,13,14,12,13,3,3,4,1,5,0,0,-1,2,-1
609,609,604,604,18,17,18,16,1,1,2,2,0,5,0,1,-1,2
623,618,618,618,18,19,18,19,1,2,1,1,5,0,0,-1,1,-1
290,286,286,286,21,19,20,21,3,1,1,2,4,0,0,2,-1,-1
501,501,501,496,14,14,13,13,2,3,2,1,0,0,5,0,1,0
754,750,745,745,13,14,12,13,3,5,2,2,4,5,0,-1,2,-1
993,984,979,979,20,19,20,21,2,2,1,1,9,5,0,1,-1,-1
314,309,309,309,14,14,15,16,2,1,1,2,5,0,0,0,-1,-1
407,398,398,398,13,14,15,13,2,1,1,1,9,0,0,-1,-1,2
792,792,796,792,14,17,15,16,2,1,1,3,0,-4,4,-3,2,-1
1073,1068,1064,1064,13,14,15,13,2,1,1,3,5,4,0,-1,-1,2
440,431,436,426,17,16,18,16,1,2,1,1,9,-5,10,1,-2,2
210,206,206,206,14,14,13,13,2,2,1,1,4,0,0,0,1,0
646,637,642,637,20,19,20,21,1,1,2,3,9,-5,5,1,-1,-1
492,482,473,473,14,14,12,13,1,1,1,2,10,9,0,0,2,-1
412,412,407,407,13,14,12,13,2,1,3,1,0,5,0,-1,2,-1
436,431,431,436,20,19,20,21,2,1,2,1,5,0,-5,1,-1,-1
881,876,876,876,18,19,18,18,3,2,1,1,5,0,0,-1,1,0
974,970,970,974,17,19,18,18,3,1,1,1,4,0,-4,-2,1,0
604,604,604,600,14,14,13,13,1,1,2,2,0,0,4,0,1,0
548,543,548,539,18,19,18,18,1,1,3,1,5,-5,9,-1,1,0
403,398,389,379,13,14,12,13,2,3,3,2,5,9,10,-1,2,-1
993,989,989,979,13,14,15,13,1,2,2,1,4,0,10,-1,-1,2
965,960,960,956,13,14,15,13,1,2,1,1,5,0,4,-1,-1,2
693,689,684,684,20,19,20,18,2,1,1,1,4,5,0,1,-1,2
379,374,374,374,20,19,18,18,1,1,1,1,5,0,0,1,1,0
764,754,754,750,20,19,20,18,1,3,2,3,10,0,4,1,-1,2
979,979,979,979,13,14,12,13,2,1,1,2,0,0,0,-1,2,-1
1007,998,998,998,17,16,18,16,2,2,2,1,9,0,0,1,-2,2
436,426,421,421,13,14,12,13,1,3,3,2,10,5,0,-1,2,-1
271,257,253,253,14,14,13,13,3,2,1,3,14,4,0,0,1,0
773,764,768,764,17,16,18,18,1,2,2,2,9,-4,4,1,-2,0
656,651,651,646,20,19,20,21,1,1,2,2,5,0,5,1,-1,-1
796,787,782,782,18,17,18,16,1,1,1,1,9,5,0,1,-1,2
464,454,440,436,17,16,15,16,1,2,2,1,10,14,4,1,1,-1
1007,998,1003,998,20,19,18,18,2,2,2,1,9,-5,5,1,1,0
642,642,679,703,20,19,20,21,2,1,1,1,0,-37,-24,1,-1,-1
492,492,487,487,18,19,18,19,2,4,1,1,0,5,0,-1,1,-1
876,871,881,867,18,17,18,18,1,3,2,1,5,-10,14,1,-1,0
346,342,337,337,17,16,18,16,2,1,1,1,4,5,0,1,-2,2
1064,1054,1059,1054,13,16,15,16,3,1,1,2,10,-5,5,-3,1,-1
782,782,778,773,14,14,15,13,2,2,1,2,0,4,5,0,-1,2
974,965,970,970,13,14,12,13,1,2,2,1,9,-5,0,-1,2,-1
862,857,853,848,18,19,18,18,3,2,1,2,5,4,5,-1,1,0
360,365,360,356,13,14,12,13,3,3,2,2,-5,5,4,-1,2,-1
881,876,881,881,14,17,15,16,2,2,3,1,5,-5,0,-3,2,-1
253,253,253,248,18,19,18,18,1,1,2,1,0,0,5,-1,1,0
970,960,332,956,13,14,13,13,1,3,1,1,10,628,-624,-1,1,0
970,965,974,979,17,16,18,16,1,2,1,2,5,-9,-5,1,-2,2
853,853,848,848,14,17,15,16,2,3,2,1,0,5,0,-3,2,-1
412,407,403,407,13,14,15,13,1,3,4,1,5,4,-4,-1,-1,2
548,539,539,539,18,17,18,16,2,1,1,2,9,0,0,1,-1,2
253,253,253,253,18,17,18,18,2,3,1,1,0,0,0,1,-1,0
398,393,389,389,20,19,20,21,4,1,2,1,5,4,0,1,-1,-1
717,712,712,712,13,14,12,13,3,2,4,2,5,0,0,-1,2,-1
1012,1012,1003,1007,13,14,15,13,2,3,1,1,0,9,-4,-1,-1,2
1031,1026,1026,1026,17,16,15,16,2,3,1,3,5,0,0,1,1,-1
1012,1007,1003,1003,20,19,20,18,1,2,4,2,5,4,0,1,-1,2
886,881,890,881,18,19,18,19,2,1,2,1,5,-9,9,-1,1,-1
1045,1036,1036,1036,17,16,15,16,1,2,3,1,9,0,0,1,1,-1
192,187,182,182,18,17,18,19,3,1,1,1,5,5,0,1,-1,-1
787,782,787,782,18,17,18,19,1,2,2,1,5,-5,5,1,-1,-1
459,454,454,454,17,16,18,18,2,1,2,2,5,0,0,1,-2,0
492,487,492,487,18,19,18,19,3,2,2,1,5,-5,5,-1,1,-1
890,890,886,881,21,19,20,21,2,1,1,2,0,4,5,2,-1,-1
984,979,979,974,17,16,15,16,2,1,2,2,5,0,5,1,1,-1
571,567,567,567,14,17,15,16,2,2,2,1,4,0,0,-3,2,-1
993,989,984,984,20,19,20,21,1,1,1,1,4,5,0,1,-1,-1
886,876,876,871,14,14,13,13,2,2,3,2,10,0,5,0,1,0
787,787,787,787,14,14,15,13,2,3,2,1,0,0,0,0,-1,2
806,801,796,796,14,17,15,16,1,1,1,1,5,5,0,-3,2,-1
482,478,478,473,14,14,15,13,2,1,2,2,4,0,5,0,-1,2
1036,1026,1017,1012,13,14,12,13,1,2,1,2,10,9,5,-1,2,-1
281,276,234,276,14,14,13,13,1,3,2,1,5,42,-42,0,1,0
248,248,243,243,14,14,13,13,2,3,3,1,0,5,0,0,1,0
848,853,853,848,14,14,15,13,1,4,2,2,-5,0,5,0,-1,2
482,482,482,482,18,19,21,19,2,1,1,1,0,0,0,-1,-2,2
510,510,510,506,14,17,15,16,2,1,2,3,0,0,4,-3,2,-1
262,239,229,229,14,14,15,13,1,2,3,1,23,10,0,0,-1,2
257,257,253,248,14,14,13,13,2,3,1,2,0,4,5,0,1,0
979,1003,979,974,13,14,15,13,3,1,1,1,-24,24,5,-1,-1,2
389,389,384,384,17,16,18,16,2,3,2,1,0,5,0,1,-2,2
736,736,736,726,13,14,15,13,1,3,2,2,0,0,10,-1,-1,2
937,928,928,928,17,17,15,16,2,1,1,1,9,0,0,0,2,-1
239,234,239,239,21,19,20,21,2,2,1,1,5,-5,0,2,-1,-1
857,843,853,853,18,17,18,16,3,2,2,1,14,-10,0,1,-1,2
796,787,778,778,18,19,18,18,3,1,2,1,9,9,0,-1,1,0
754,754,754,750,13,16,15,16,1,3,1,2,0,0,4,-3,1,-1
1021,1007,1007,1007,17,16,18,16,2,3,1,3,14,0,0,1,-2,2
984,974,974,970,13,14,15,13,2,2,2,3,10,0,4,-1,-1,2
454,450,450,445,17,16,18,16,2,3,1,2,4,0,5,1,-2,2
464,454,454,450,13,14,15,13,1,3,2,1,10,0,4,-1,-1,2
1021,1012,1012,1007,13,16,15,16,2,2,2,1,9,0,5,-3,1,-1
492,487,482,487,14,14,15,13,2,2,1,1,5,5,-5,0,-1,2
787,792,787,787,21,19,21,21,2,3,2,2,-5,5,0,2,-2,0
576,571,567,571,14,14,13,13,1,2,1,3,5,4,-4,0,1,0
239,215,210,210,14,14,15,13,3,2,1,2,24,5,0,0,-1,2
970,970,970,965,20,19,20,18,2,1,2,2,0,0,5,1,-1,2
539,529,529,529,14,14,15,16,2,5,1,3,10,0,0,0,-1,-1
581,576,581,576,18,17,18,18,1,1,3,2,5,-5,5,1,-1,0
328,309,309,300,14,17,15,16,1,2,2,1,19,0,9,-3,2,-1
820,815,815,815,18,17,18,16,1,1,2,2,5,0,0,1,-1,2
257,257,257,257,18,17,18,16,2,3,2,4,0,0,0,1,-1,2
1017,1012,1017,1017,17,16,15,16,1,2,1,1,5,-5,0,1,1,-1
407,407,403,403,17,16,15,16,1,1,1,4,0,4,0,1,1,-1
1050,1050,1050,1050,20,19,20,18,1,1,2,2,0,0,0,1,-1,2
300,295,295,295,14,14,13,13,3,3,2,1,5,0,0,0,1,0
365,360,365,365,13,14,12,13,1,1,1,2,5,-5,0,-1,2,-1
501,487,487,482,14,14,15,13,1,3,2,1,14,0,5,0,-1,2
646,642,637,623,13,14,12,13,1,3,2,3,4,5,14,-1,2,-1
740,740,736,731,13,14,12,13,1,3,2,2,0,4,5,-1,2,-1
600,586,590,586,14,17,15,16,1,2,1,2,14,-4,4,-3,2,-1
539,529,529,534,14,14,13,13,1,2,1,1,10,0,-5,0,1,0
295,286,290,295,21,19,20,19,2,2,1,1,9,-4,-5,2,-1,1
436,426,421,417,20,19,20,18,1,1,1,1,10,5,4,1,-1,2
721,717,717,717,13,14,12,13,1,3,1,1,4,0,0,-1,2,-1
698,684,684,679,13,14,15,13,1,2,3,1,14,0,5,-1,-1,2
839,834,829,829,14,14,15,13,1,1,3,1,5,5,0,0,-1,2
393,384,389,384,17,16,18,18,1,2,2,2,9,-5,5,1,-2,0
468,454,445,445,13,14,12,13,1,2,6,1,14,9,0,-1,2,-1
881,876,886,881,18,19,18,19,4,2,2,1,5,-10,5,-1,1,-1
834,820,820,820,21,19,20,19,1,2,1,1,14,0,0,2,-1,1
689,679,679,684,13,14,12,13,1,2,1,1,10,0,-5,-1,2,-1
534,529,529,520,14,14,13,13,3,2,2,2,5,0,9,0,1,0
1064,1064,1064,1059,13,14,12,13,1,1,2,1,0,0,5,-1,2,-1
1073,1068,1068,1068,13,14,12,13,1,3,1,1,5,0,0,-1,2,-1
857,932,853,848,21,19,20,21,1,1,2,2,-75,79,5,2,-1,-1
576,567,562,567,14,14,13,13,1,3,1,1,9,5,-5,0,1,0
792,787,782,782,18,19,18,19,2,2,1,1,5,5,0,-1,1,-1
970,956,956,956,20,19,20,18,1,1,3,2,14,0,0,1,-1,2
600,600,595,590,14,14,15,13,3,1,3,4,0,5,5,0,-1,2
651,651,651,646,17,16,18,18,1,2,3,2,0,0,5,1,-2,0
571,567,571,567,14,14,13,13,1,1,1,1,4,-4,4,0,1,0
1059,1050,1045,1045,13,14,15,16,2,3,3,1,9,5,0,-1,-1,-1
1078,1068,1068,1064,17,16,18,18,2,2,3,2,10,0,4,1,-2,0
750,736,731,731,13,14,15,13,2,1,1,2,14,5,0,-1,-1,2
857,843,848,848,14,17,15,16,3,2,2,2,14,-5,0,-3,2,-1
745,740,736,736,17,16,15,16,2,3,1,2,5,4,0,1,1,-1
1031,1021,1021,1021,13,16,15,16,3,2,1,3,10,0,0,-3,1,-1
792,782,778,773,14,14,13,13,3,2,1,2,10,4,5,0,1,0
239,229,224,224,14,17,15,16,4,1,3,1,10,5,0,-3,2,-1
290,281,646,286,14,14,12,13,1,1,1,1,9,-365,360,0,2,-1
839,829,824,824,18,17,18,16,1,2,2,1,10,5,0,1,-1,2
314,304,286,304,18,17,18,16,1,2,1,3,10,18,-18,1,-1,2
886,890,890,886,14,14,13,13,2,3,1,3,-4,0,4,0,1,0
524,520,520,520,18,17,18,16,2,1,1,3,4,0,0,1,-1,2
220,210,215,206,14,14,15,16,1,3,2,2,10,-5,9,0,-1,-1
843,839,839,839,14,14,13,13,3,2,1,2,4,0,0,0,1,0
431,436,431,431,13,16,15,16,1,2,2,1,-5,5,0,-3,1,-1
393,393,393,393,17,16,15,16,1,1,3,1,0,0,0,1,1,-1
220,196,187,187,18,17,18,16,1,2,1,3,24,9,0,1,-1,2
937,937,937,937,20,19,20,18,1,2,1,1,0,0,0,1,-1,2
951,946,946,946,17,16,18,18,1,1,1,1,5,0,0,1,-2,0
886,886,881,881,18,19,18,19,1,1,1,1,0,5,0,-1,1,-1
993,989,989,984,13,14,15,13,1,2,2,2,4,0,5,-1,-1,2
656,646,651,646,17,16,15,16,2,2,1,2,10,-5,5,1,1,-1
623,618,618,618,18,19,18,19,1,1,2,1,5,0,0,-1,1,-1
403,403,403,398,17,16,18,18,3,1,1,1,0,0,5,1,-2,0
281,281,276,276,14,17,15,16,1,3,2,1,0,5,0,-3,2,-1
787,782,778,782,14,17,15,16,3,2,1,1,5,4,-4,-3,2,-1
403,398,398,398,17,16,18,16,1,2,1,3,5,0,0,1,-2,2
487,482,482,487,18,19,18,19,2,1,1,1,5,0,-5,-1,1,-1
928,918,914,914,18,19,18,19,1,3,2,1,10,4,0,-1,1,-1
351,356,351,351,13,14,15,16,3,3,1,1,-5,5,0,-1,-1,-1
450,450,445,440,17,16,15,16,1,1,2,2,0,5,5,1,1,-1
918,918,918,918,14,17,15,16,4,1,3,2,0,0,0,-3,2,-1
937,937,928,928,17,16,18,19,3,1,1,1,0,9,0,1,-2,-1
646,642,642,642,13,14,15,16,1,2,2,1,4,0,0,-1,-1,-1
801,796,796,792,14,14,13,13,2,2,2,3,5,0,4,0,1,0
881,881,881,881,18,17,18,19,2,2,2,3,0,0,0,1,-1,-1
426,417,417,421,20,19,20,18,2,3,1,1,9,0,-4,1,-1,2
440,436,445,431,13,16,15,16,1,2,4,2,4,-9,14,-3,1,-1
1078,1068,1068,1064,17,16,15,16,1,2,2,2,10,0,4,1,1,-1
337,332,328,323,17,16,15,16,2,1,1,2,5,4,5,1,1,-1
717,712,712,707,13,16,15,16,1,2,2,1,5,0,5,-3,1,-1
426,417,412,417,13,14,12,13,2,1,3,2,9,5,-5,-1,2,-1
623,623,618,614,18,19,18,19,1,2,1,1,0,5,4,-1,1,-1
323,309,309,309,14,14,15,13,1,1,3,1,14,0,0,0,-1,2
524,520,520,900,14,14,15,13,2,3,1,1,4,0,-380,0,-1,2
829,820,820,820,18,19,18,19,1,1,1,2,9,0,0,-1,1,-1
951,942,946,942,13,14,15,13,1,2,2,2,9,-4,4,-1,-1,2
234,229,229,229,18,17,18,19,1,2,1,2,5,0,0,1,-1,-1
1040,1036,1045,1036,13,14,15,13,3,1,1,3,4,-9,9,-1,-1,2
234,224,224,220,18,19,18,19,1,2,2,2,10,0,4,-1,1,-1
600,600,595,595,14,17,15,16,1,3,1,1,0,5,0,-3,2,-1
1068,1068,1059,1054,13,14,15,13,1,3,1,3,0,9,5,-1,-1,2
543,543,543,543,21,19,20,21,1,3,1,1,0,0,0,2,-1,-1
712,703,698,693,20,19,20,18,2,1,1,3,9,5,5,1,-1,2
1040,1031,1031,1031,13,14,15,13,3,2,1,2,9,0,0,-1,-1,2
1068,1064,1059,1059,13,14,12,13,3,4,1,2,4,5,0,-1,2,-1
234,234,243,234,14,17,15,16,2,4,4,1,0,-9,9,-3,2,-1
618,604,595,595,18,19,18,19,2,1,1,1,14,9,0,-1,1,-1
464,459,464,459,20,19,20,18,3,2,1,2,5,-5,5,1,-1,2
937,923,928,923,20,19,21,19,2,2,1,2,14,-5,5,1,-2,2
196,192,187,187,14,17,15,16,1,2,2,1,4,5,0,-3,2,-1
276,271,276,271,18,19,18,18,1,3,2,1,5,-5,5,-1,1,0
548,539,534,529,21,19,20,19,3,1,1,1,9,5,5,2,-1,1
951,946,951,951,13,14,15,13,3,2,2,1,5,-5,0,-1,-1,2
468,464,454,459,13,14,12,13,1,3,1,3,4,10,-5,-1,2,-1
398,389,393,389,17,16,18,16,2,2,1,1,9,-4,4,1,-2,2
567,557,553,548,18,17,18,18,2,1,1,2,10,4,5,1,-1,0
956,956,956,956,20,19,20,21,1,1,2,1,0,0,0,1,-1,-1
187,182,1078,1078,18,17,18,18,3,1,1,1,5,-896,0,1,-1,0
824,820,815,820,21,19,20,21,1,3,1,1,4,5,-5,2,-1,-1
707,698,689,689,13,14,15,13,1,5,2,1,9,9,0,-1,-1,2
740,736,731,731,17,16,15,16,3,1,1,2,4,5,0,1,1,-1
726,721,721,721,20,19,20,21,2,2,1,1,5,0,0,1,-1,-1
323,318,314,318,18,17,18,16,2,2,1,3,5,4,-4,1,-1,2
895,890,890,890,18,19,18,19,2,2,1,2,5,0,0,-1,1,-1
660,665,660,656,20,19,20,21,1,1,1,2,-5,5,4,1,-1,-1
623,614,614,614,18,17,18,19,2,1,3,1,9,0,0,1,-1,-1
210,206,206,201,14,14,15,13,3,3,3,1,4,0,5,0,-1,2
248,243,239,239,18,19,18,18,3,1,1,1,5,4,0,-1,1,0
923,918,918,914,18,19,18,19,2,1,2,1,5,0,4,-1,1,-1
323,318,314,314,14,14,15,13,2,1,1,1,5,4,0,0,-1,2
253,248,248,248,18,17,18,16,3,1,1,1,5,0,0,1,-1,2
665,660,670,670,20,19,18,18,2,1,4,1,5,-10,0,1,1,0
1059,1054,1050,1054,13,14,12,13,1,1,1,1,5,4,-4,-1,2,-1
993,989,989,989,20,19,20,18,1,2,1,1,4,0,0,1,-1,2
839,829,834,824,21,19,20,19,1,2,2,2,10,-5,10,2,-1,1
431,426,431,426,13,16,15,16,3,1,1,2,5,-5,5,-3,1,-1
407,403,407,403,17,16,18,16,3,2,1,2,4,-4,4,1,-2,2
393,384,389,389,13,14,15,13,2,2,1,1,9,-5,0,-1,-1,2
220,201,206,210,18,17,15,16,1,2,2,1,19,-5,-4,1,2,-1
487,473,473,473,18,19,18,18,3,2,1,1,14,0,0,-1,1,0
379,374,374,370,13,14,12,13,3,3,2,2,5,0,4,-1,2,-1
1054,1054,1050,1045,13,16,15,16,2,5,3,1,0,4,5,-3,1,-1
1050,1040,1045,1045,13,14,12,13,1,1,1,1,10,-5,0,-1,2,-1
900,900,900,895,21,19,20,21,2,1,2,1,0,0,5,2,-1,-1
759,750,740,740,20,19,20,18,1,3,1,1,9,10,0,1,-1,2
1040,1040,1040,1040,13,14,12,13,3,2,1,3,0,0,0,-1,2,-1
923,918,918,914,21,19,21,19,1,2,1,2,5,0,4,2,-2,2
468,468,464,464,13,14,15,13,3,3,1,1,0,4,0,-1,-1,2
567,562,562,562,14,14,13,13,2,2,3,3,5,0,0,0,1,0
286,271,267,267,14,17,15,16,2,2,1,1,15,4,0,-3,2,-1
309,304,295,300,18,17,18,19,2,3,3,1,5,9,-5,1,-1,-1
426,417,417,421,20,19,18,18,1,2,1,1,9,0,-4,1,1,0
689,684,684,684,20,19,18,18,1,1,2,1,5,0,0,1,1,0
928,923,937,918,14,14,15,13,1,2,2,2,5,-14,19,0,-1,2
436,436,431,426,13,14,12,13,1,1,1,2,0,5,5,-1,2,-1
407,398,398,393,13,14,15,13,2,3,2,2,9,0,5,-1,-1,2
740,740,736,731,13,14,12,13,2,1,2,1,0,4,5,-1,2,-1
192,187,187,187,14,17,15,16,1,3,3,1,5,0,0,-3,2,-1
937,932,932,932,20,19,20,18,3,1,1,1,5,0,0,1,-1,2
600,590,595,604,21,19,20,21,1,2,1,1,10,-5,-9,2,-1,-1
421,421,417,417,17,19,18,18,1,1,1,1,0,4,0,-2,1,0
257,248,248,243,21,19,20,21,1,1,2,2,9,0,5,2,-1,-1
810,806,801,796,18,17,18,19,2,1,2,1,4,5,5,1,-1,-1
993,989,989,989,20,19,20,18,1,1,1,1,4,0,0,1,-1,2
262,257,257,253,14,14,15,13,1,3,2,6,5,0,4,0,-1,2
932,942,932,932,20,19,20,18,1,2,1,1,-10,10,0,1,-1,2
543,539,543,539,14,14,15,16,1,3,2,1,4,-4,4,0,-1,-1
487,473,473,478,18,16,18,16,1,2,1,1,14,0,-5,2,-2,2
684,679,679,679,13,14,12,13,3,3,3,1,5,0,0,-1,2,-1
1064,1054,1054,1054,13,14,15,13,3,2,1,5,10,0,0,-1,-1,2
1054,1040,1040,1045,20,19,20,21,1,2,1,1,14,0,-5,1,-1,-1
328,318,309,314,14,14,13,13,1,2,1,1,10,9,-5,0,1,0
534,529,534,529,14,14,13,13,2,2,2,1,5,-5,5,0,1,0
703,703,698,698,17,16,18,18,1,2,1,1,0,5,0,1,-2,0
918,918,918,914,18,17,18,16,2,2,2,2,0,0,4,1,-1,2
581,576,571,571,18,17,18,18,1,1,1,1,5,5,0,1,-1,0
595,590,586,586,18,19,18,19,1,4,1,1,5,4,0,-1,1,-1
998,993,993,993,13,14,12,13,3,2,3,1,5,0,0,-1,2,-1
473,459,459,454,20,19,18,18,1,2,6,3,14,0,5,1,1,0
979,970,965,965,13,14,15,13,4,3,1,2,9,5,0,-1,-1,2
1059,1050,1050,1050,20,19,20,21,2,1,1,1,9,0,0,1,-1,-1
468,468,468,468,20,19,18,18,1,1,3,1,0,0,0,1,1,0
1026,1017,1017,1021,17,16,18,16,2,2,1,2,9,0,-4,1,-2,2
384,374,374,374,13,14,15,13,2,2,3,2,10,0,0,-1,-1,2
998,993,993,993,17,16,18,16,2,2,3,1,5,0,0,1,-2,2
806,787,787,787,14,17,15,16,3,1,2,1,19,0,0,-3,2,-1
271,271,276,276,21,19,20,18,2,3,1,2,0,-5,0,2,-1,2
342,346,332,332,20,19,20,21,1,1,1,1,-4,14,0,1,-1,-1
993,993,989,984,17,19,18,18,3,3,2,2,0,4,5,-2,1,0
201,196,196,192,18,19,18,19,1,2,2,1,5,0,4,-1,1,-1
736,736,736,731,13,14,12,13,1,3,1,1,0,0,5,-1,2,-1
210,187,1078,1073,14,14,15,13,2,2,1,1,23,-891,5,0,-1,2
304,304,300,300,18,17,18,16,2,1,1,1,0,4,0,1,-1,2
665,656,665,660,13,14,12,13,2,2,2,1,9,-9,5,-1,2,-1
693,684,689,693,20,19,20,18,1,4,1,1,9,-5,-4,1,-1,2
206,196,187,187,18,19,18,19,3,1,1,1,10,9,0,-1,1,-1
745,740,740,740,20,19,20,21,1,2,3,1,5,0,0,1,-1,-1
745,736,736,736,17,16,15,16,2,2,3,1,9,0,0,1,1,-1
736,726,731,726,20,19,20,18,2,2,2,1,10,-5,5,1,-1,2
862,862,862,857,14,14,13,13,2,3,2,2,0,0,5,0,1,0
426,426,421,421,13,14,12,13,2,3,1,1,0,5,0,-1,2,-1
496,496,492,487,14,17,15,16,3,1,2,3,0,4,5,-3,2,-1
314,300,300,300,14,14,13,13,3,3,1,1,14,0,0,0,1,0
993,993,984,984,17,16,18,16,2,1,1,3,0,9,0,1,-2,2
989,979,979,970,13,14,12,13,3,3,3,2,10,0,9,-1,2,-1
965,960,965,960,13,14,15,13,2,1,2,1,5,-5,5,-1,-1,2
787,806,768,768,21,14,20,21,3,1,1,1,-19,38,0,7,-6,-1
637,637,632,637,20,19,20,21,1,2,1,1,0,5,-5,1,-1,-1
520,506,510,520,14,14,15,16,1,2,3,2,14,-4,-10,0,-1,-1
567,562,562,567,14,14,13,13,2,3,1,1,5,0,-5,0,1,0
496,496,487,492,14,14,15,16,1,1,3,1,0,9,-5,0,-1,-1
843,843,843,843,14,14,13,13,2,3,3,1,0,0,0,0,1,0
417,412,412,412,17,16,18,16,1,2,2,1,5,0,0,1,-2,2
665,660,660,656,13,14,12,13,2,3,2,3,5,0,4,-1,2,-1
323,323,328,323,14,14,13,13,2,2,2,3,0,-5,5,0,1,0
234,224,224,220,18,19,18,19,1,1,2,1,10,0,4,-1,1,-1
539,539,534,529,21,19,20,19,2,2,2,2,0,5,5,2,-1,1
576,576,571,571,18,19,18,18,1,2,1,1,0,5,0,-1,1,0
600,595,590,590,18,19,18,19,2,1,2,1,5,5,0,-1,1,-1
553,548,548,548,14,14,15,13,2,2,1,1,5,0,0,0,-1,2
684,679,679,679,17,16,18,16,1,1,1,3,5,0,0,1,-2,2
567,557,567,562,18,17,15,16,3,2,2,1,10,-10,5,1,2,-1
759,754,759,750,20,19,18,18,1,2,3,2,5,-5,9,1,1,0
1026,1012,1012,1012,17,16,15,16,1,2,3,1,14,0,0,1,1,-1
543,539,534,534,21,19,20,18,2,2,1,1,4,5,0,2,-1,2
839,824,824,824,18,17,18,19,1,1,1,1,15,0,0,1,-1,-1
1036,1031,1031,1017,13,14,12,13,1,1,2,4,5,0,14,-1,2,-1
684,679,679,674,20,19,20,21,2,5,2,4,5,0,5,1,-1,-1
581,571,571,796,14,17,15,13,1,3,1,1,10,0,-225,-3,2,2
581,576,581,581,14,17,15,16,1,2,2,1,5,-5,0,-3,2,-1
839,834,834,829,14,17,15,16,2,2,2,1,5,0,5,-3,2,-1
609,604,604,595,18,17,18,19,3,1,1,2,5,0,9,1,-1,-1
1054,1050,1054,1050,13,14,15,13,1,1,2,2,4,-4,4,-1,-1,2
187,1073,1073,1068,14,14,12,13,2,2,2,1,-886,0,5,0,2,-1
393,379,379,374,17,16,15,16,6,2,2,2,14,0,5,1,1,-1
937,932,937,932,13,16,15,16,2,1,2,1,5,-5,5,-3,1,-1
693,689,684,684,17,16,18,18,1,3,1,2,4,5,0,1,-2,0
642,637,637,637,17,16,15,16,1,1,3,1,5,0,0,1,1,-1
295,276,271,262,14,14,13,13,3,1,2,2,19,5,9,0,1,0
810,801,801,801,21,19,21,21,1,2,1,1,9,0,0,2,-2,0
703,693,689,689,13,16,15,16,1,2,3,1,10,4,0,-3,1,-1
623,623,623,618,14,17,15,16,2,1,2,2,0,0,5,-3,2,-1
468,464,468,468,20,19,20,18,1,1,1,2,4,-4,0,1,-1,2
196,192,192,192,14,17,15,16,3,2,1,1,4,0,0,-3,2,-1
848,839,843,839,21,19,20,18,2,2,1,2,9,-4,4,2,-1,2
848,834,834,839,14,17,15,16,1,3,2,1,14,0,-5,-3,2,-1
253,243,239,239,14,17,15,16,1,4,3,1,10,4,0,-3,2,-1
810,806,815,815,21,19,20,21,3,1,1,3,4,-9,0,2,-1,-1
689,684,689,689,20,19,20,18,1,2,2,3,5,-5,0,1,-1,2
923,923,923,923,21,19,21,21,2,1,1,1,0,0,0,2,-2,0
290,276,267,271,14,14,13,13,1,4,3,1,14,9,-4,0,1,0
510,506,501,501,18,17,18,16,3,1,1,1,4,5,0,1,-1,2
248,239,234,229,14,14,13,13,2,3,2,2,9,5,5,0,1,0
881,881,876,871,14,17,15,16,2,1,2,1,0,5,5,-3,2,-1
773,773,768,768,20,19,20,18,3,1,1,1,0,5,0,1,-1,2
1078,1068,1073,1068,13,14,12,13,2,1,2,2,10,-5,5,-1,2,-1
192,1068,1064,1064,14,14,12,13,1,4,1,2,-876,4,0,0,2,-1
820,820,815,815,21,19,20,21,1,1,1,1,0,5,0,2,-1,-1
323,309,300,295,14,17,15,16,3,2,1,2,14,9,5,-3,2,-1
618,614,614,614,18,17,18,19,2,2,3,1,4,0,0,1,-1,-1
450,440,445,440,17,16,15,16,1,2,2,3,10,-5,5,1,1,-1
918,914,909,909,14,14,15,13,5,3,1,1,4,5,0,0,-1,2
295,290,290,281,21,19,20,21,1,3,2,3,5,0,9,2,-1,-1
220,220,215,210,18,17,18,19,2,3,1,2,0,5,5,1,-1,-1
970,960,965,965,13,14,12,13,3,4,2,3,10,-5,0,-1,2,-1
1021,1017,1017,1021,20,19,20,21,2,2,1,1,4,0,-4,1,-1,-1
187,187,187,187,14,14,15,16,1,3,1,1,0,0,0,0,-1,-1
539,534,534,534,18,17,18,16,2,2,2,2,5,0,0,1,-1,2
215,206,206,206,14,14,15,13,3,2,3,2,9,0,0,0,-1,2
815,810,806,806,14,14,13,13,2,2,1,2,5,4,0,0,1,0
431,426,426,426,13,16,15,16,2,1,4,1,5,0,0,-3,1,-1
520,515,515,520,21,19,20,19,1,4,1,3,5,0,-5,2,-1,1
539,529,529,524,14,14,15,13,1,2,2,3,10,0,5,0,-1,2
300,290,281,281,21,19,20,21,1,1,1,1,10,9,0,2,-1,-1
792,703,703,698,14,16,15,16,3,2,3,2,89,0,5,-2,1,-1
576,571,576,576,18,17,18,18,1,3,2,4,5,-5,0,1,-1,0
1078,1068,1068,1073,17,16,18,18,1,4,5,2,10,0,-5,1,-2,0
618,590,600,595,18,17,18,16,1,2,2,2,28,-10,5,1,-1,2
468,464,464,459,13,14,12,13,3,2,1,2,4,0,5,-1,2,-1
1068,1068,1059,1059,20,19,20,21,2,3,1,1,0,9,0,1,-1,-1
1064,1054,1059,1054,20,19,18,18,3,1,2,2,10,-5,5,1,1,0
473,473,468,468,17,16,15,16,3,3,3,1,0,5,0,1,1,-1
243,234,229,206,14,17,15,16,3,1,1,3,9,5,23,-3,2,-1
970,970,974,970,20,19,20,21,1,1,1,1,0,-4,4,1,-1,-1
965,960,946,942,17,16,18,18,2,1,1,1,5,14,4,1,-2,0
464,454,454,450,13,14,15,13,2,2,2,5,10,0,4,-1,-1,2
665,660,660,656,13,14,15,13,2,3,3,4,5,0,4,-1,-1,2
951,946,942,942,20,19,18,18,1,1,1,1,5,4,0,1,1,0
745,745,740,736,17,16,18,18,1,3,2,3,0,5,4,1,-2,0
510,501,501,501,14,14,15,13,1,2,3,2,9,0,0,0,-1,2
389,379,374,379,13,16,15,16,1,3,3,2,10,5,-5,-3,1,-1
646,642,646,642,17,16,18,18,1,1,2,1,4,-4,4,1,-2,0
557,557,557,553,14,14,15,13,1,3,2,3,0,0,4,0,-1,2
731,731,731,731,13,14,15,13,2,2,1,1,0,0,0,-1,-1,2
224,201,201,201,14,14,15,13,1,3,2,2,23,0,0,0,-1,2
421,417,421,417,20,19,18,18,3,2,2,1,4,-4,4,1,1,0
1050,1045,1040,1045,17,19,18,18,1,1,1,1,5,5,-5,-2,1,0
370,365,365,365,17,19,18,18,2,2,1,1,5,0,0,-2,1,0
604,600,595,595,14,14,15,13,3,3,3,2,4,5,0,0,-1,2
881,881,881,871,14,17,15,16,3,3,1,2,0,0,10,-3,2,-1
731,740,726,726,13,14,15,16,1,1,1,1,-9,14,0,-1,-1,-1
604,604,600,595,21,19,20,19,1,1,1,1,0,4,5,2,-1,1
482,473,473,478,18,19,18,18,2,2,1,1,9,0,-5,-1,1,0
595,581,586,586,14,17,15,16,1,2,1,2,14,-5,0,-3,2,-1
281,271,271,276,14,14,13,13,3,4,2,3,10,0,-5,0,1,0
524,520,520,520,14,14,13,13,2,2,1,1,4,0,0,0,1,0
257,253,248,253,18,19,18,18,2,1,1,1,4,5,-5,-1,1,0
937,937,932,937,17,16,18,18,3,1,1,1,0,5,-5,1,-2,0
529,510,520,529,18,19,18,19,1,2,3,2,19,-10,-9,-1,1,-1
309,309,304,300,14,17,15,16,2,2,2,3,0,5,4,-3,2,-1
459,454,450,454,13,14,15,13,2,2,1,1,5,4,-4,-1,-1,2
1036,1031,1026,1031,20,19,20,21,2,1,2,1,5,5,-5,1,-1,-1
576,571,567,567,14,14,15,13,1,3,1,2,5,4,0,0,-1,2
782,782,778,778,18,19,18,18,2,1,1,1,0,4,0,-1,1,0
881,876,876,876,18,17,18,16,3,2,3,1,5,0,0,1,-1,2
473,468,468,473,13,14,15,13,1,3,1,1,5,0,-5,-1,-1,2
389,384,379,379,20,19,20,21,1,1,1,2,5,5,0,1,-1,-1
679,670,670,679,17,16,15,16,3,1,2,1,9,0,-9,1,1,-1
698,698,693,693,17,16,18,18,3,2,1,1,0,5,0,1,-2,0
524,510,510,510,18,19,18,19,1,2,4,1,14,0,0,-1,1,-1
553,553,548,548,14,14,15,13,3,1,1,1,0,5,0,0,-1,2
548,543,539,543,18,17,18,18,1,1,3,1,5,4,-4,1,-1,0
886,886,886,881,18,19,18,19,1,3,2,2,0,0,5,-1,1,-1
974,960,960,960,17,16,18,18,1,2,1,1,14,0,0,1,-2,0
360,365,360,356,17,19,18,18,4,3,2,2,-5,5,4,-2,1,0
224,215,210,206,14,14,13,13,1,3,3,1,9,5,4,0,1,0
665,670,660,665,13,14,12,13,1,3,5,1,-5,10,-5,-1,2,-1
703,693,698,693,13,14,15,13,2,3,2,1,10,-5,5,-1,-1,2
374,360,356,360,17,16,15,16,2,3,3,1,14,4,-4,1,1,-1
590,590,590,586,21,19,20,19,2,3,1,2,0,0,4,2,-1,1
314,314,314,318,18,17,18,16,2,4,2,1,0,0,-4,1,-1,2
482,478,478,478,14,14,13,13,1,1,1,1,4,0,0,0,1,0
557,548,553,553,18,19,18,18,3,2,1,1,9,-5,0,-1,1,0
848,843,843,843,21,19,20,21,1,2,1,1,5,0,0,2,-1,-1
328,323,318,318,18,19,18,19,1,1,2,1,5,5,0,-1,1,-1
979,970,974,974,20,19,20,21,1,2,1,2,9,-4,0,1,-1,-1
787,787,787,787,14,14,15,13,2,3,1,3,0,0,0,0,-1,2
637,623,623,628,13,17,15,16,2,2,1,1,14,0,-5,-4,2,-1
1068,1064,1059,1054,17,16,15,16,2,1,3,2,4,5,5,1,1,-1
440,431,431,426,13,14,12,13,2,3,2,2,9,0,5,-1,2,-1
881,881,881,881,18,19,18,19,2,1,1,2,0,0,0,-1,1,-1
229,224,224,224,18,19,20,19,2,2,1,1,5,0,0,-1,-1,1
337,337,337,332,13,16,15,16,1,1,2,1,0,0,5,-3,1,-1
374,370,370,365,20,19,18,18,2,1,2,1,4,0,5,1,1,0
998,993,993,989,13,16,15,16,2,2,2,1,5,0,4,-3,1,-1
609,600,609,609,14,14,13,13,2,4,1,1,9,-9,0,0,1,0
450,440,440,337,13,14,15,16,1,2,1,4,10,0,103,-1,-1,-1
267,262,271,276,14,14,15,13,2,2,2,1,5,-9,-5,0,-1,2
890,886,886,881,18,17,18,19,2,1,2,1,4,0,5,1,-1,-1
717,707,707,703,13,14,12,13,2,1,2,2,10,0,4,-1,2,-1
960,960,960,960,13,14,15,13,3,1,1,1,0,0,0,-1,-1,2
276,267,262,262,18,17,18,16,2,1,1,1,9,5,0,1,-1,2
337,328,323,323,13,14,15,16,2,1,1,1,9,5,0,-1,-1,-1
370,374,370,370,17,19,18,18,1,2,3,3,-4,4,0,-2,1,0
253,243,239,239,14,14,13,13,5,2,3,1,10,4,0,0,1,0
300,290,295,290,18,17,18,19,3,2,2,2,10,-5,5,1,-1,-1
487,487,492,492,18,17,18,16,1,2,2,4,0,-5,0,1,-1,2
407,407,403,393,13,14,15,13,2,2,1,2,0,4,10,-1,-1,2
318,295,295,290,14,14,15,13,2,3,1,2,23,0,5,0,-1,2
220,220,220,220,14,14,15,13,3,3,1,1,0,0,0,0,-1,2
192,187,187,187,14,17,15,16,2,2,1,3,5,0,0,-3,2,-1
609,604,600,595,14,14,15,13,2,1,2,3,5,4,5,0,-1,2
253,248,243,248,14,14,13,13,3,2,2,2,5,5,-5,0,1,0
229,215,220,220,18,17,18,16,3,2,2,1,14,-5,0,1,-1,2
745,740,736,736,13,14,12,13,1,3,3,2,5,4,0,-1,2,-1
1021,1012,1007,1007,17,16,18,16,2,2,1,2,9,5,0,1,-2,2
403,403,393,393,20,19,20,21,2,1,1,1,0,10,0,1,-1,-1
248,248,253,248,14,14,13,13,2,1,4,1,0,-5,5,0,1,0
581,586,581,581,14,17,15,16,2,2,3,1,-5,5,0,-3,2,-1
970,965,965,965,13,14,12,13,1,2,3,1,5,0,0,-1,2,-1
271,271,262,267,21,19,20,18,2,1,1,2,0,9,-5,2,-1,2
600,590,590,590,14,17,15,16,1,1,1,1,10,0,0,-3,2,-1
665,656,660,660,20,19,20,21,1,3,1,1,9,-4,0,1,-1,-1
867,867,862,867,14,17,15,16,2,2,1,1,0,5,-5,-3,2,-1
337,337,332,337,20,19,20,18,1,1,1,1,0,5,-5,1,-1,2
937,928,928,928,20,19,21,21,1,1,1,1,9,0,0,1,-2,0
736,726,726,721,17,16,18,18,2,3,1,1,10,0,5,1,-2,0
403,389,389,210,13,14,15,19,1,1,1,1,14,0,179,-1,-1,-4
670,665,660,656,20,19,18,18,2,3,3,2,5,5,4,1,1,0
243,248,243,248,18,19,18,18,1,1,3,1,-5,5,-5,-1,1,0
286,276,267,267,18,19,18,18,2,1,2,2,10,9,0,-1,1,0
281,267,271,281,14,14,13,13,1,1,3,3,14,-4,-10,0,1,0
895,895,895,895,21,19,20,19,1,3,6,1,0,0,0,2,-1,1
210,206,206,206,14,14,15,13,1,2,3,3,4,0,0,0,-1,2
295,290,290,290,21,19,20,21,1,1,1,2,5,0,0,2,-1,-1
782,778,768,768,21,19,20,21,1,1,1,1,4,10,0,2,-1,-1
454,454,454,492,13,14,15,13,1,1,2,1,0,0,-38,-1,-1,2
304,295,295,295,14,14,13,13,1,2,1,3,9,0,0,0,1,0
1050,1045,1045,1045,13,14,15,13,2,4,1,2,5,0,0,-1,-1,2
1007,1003,1007,1003,17,16,18,18,1,3,2,3,4,-4,4,1,-2,0
187,187,187,182,14,14,13,13,2,2,2,1,0,0,5,0,1,0
492,487,487,482,14,14,15,13,3,1,1,1,5,0,5,0,-1,2
417,412,412,417,20,19,18,18,1,1,1,3,5,0,-5,1,1,0
379,379,379,379,20,19,18,18,1,1,3,1,0,0,0,1,1,0
342,337,337,342,13,16,15,16,3,4,3,1,5,0,-5,-3,1,-1
632,628,628,623,20,19,21,21,1,1,1,2,4,0,5,1,-2,0
1036,1031,1031,1026,13,14,15,13,2,3,2,3,5,0,5,-1,-1,2
1045,1040,1040,1040,17,16,18,18,3,1,2,1,5,0,0,1,-2,0
646,642,637,632,13,14,15,13,3,3,3,2,4,5,5,-1,-1,2
412,398,398,398,13,14,12,13,4,2,1,1,14,0,0,-1,2,-1
698,693,693,698,13,14,15,13,1,2,3,2,5,0,-5,-1,-1,2
210,201,196,196,21,19,21,19,1,2,1,4,9,5,0,2,-2,2
1040,1036,1031,1031,13,14,15,16,2,4,3,1,4,5,0,-1,-1,-1
1045,1040,1040,1045,20,19,20,18,2,3,3,1,5,0,-5,1,-1,2
215,210,215,215,18,17,18,16,2,2,2,1,5,-5,0,1,-1,2
759,754,754,754,20,19,20,21,1,2,1,1,5,0,0,1,-1,-1
426,421,421,421,17,16,18,16,2,1,3,1,5,0,0,1,-2,2
595,586,581,586,21,19,20,19,3,2,1,1,9,5,-5,2,-1,1
234,229,229,229,18,17,18,16,2,1,1,4,5,0,0,1,-1,2
281,281,276,276,14,14,15,13,2,1,1,1,0,5,0,0,-1,2
1026,1012,1007,1007,13,14,12,13,3,3,2,2,14,5,0,-1,2,-1
890,876,876,876,14,14,13,13,3,2,1,1,14,0,0,0,1,0
323,328,323,323,14,14,13,13,1,1,1,2,-5,5,0,0,1,0
586,581,576,571,18,19,20,18,3,1,2,1,5,5,5,-1,-1,2
379,374,379,374,13,14,15,16,1,2,1,2,5,-5,5,-1,-1,-1
210,210,210,210,21,19,20,19,2,2,1,2,0,0,0,2,-1,1
370,370,370,370,20,19,20,18,1,1,2,1,0,0,0,1,-1,2
984,984,984,1040,20,19,20,18,1,1,1,1,0,0,-56,1,-1,2
970,965,970,970,13,14,12,13,1,4,1,1,5,-5,0,-1,2,-1
1021,1017,1017,1017,20,19,20,21,1,2,1,2,4,0,0,1,-1,-1
904,900,900,895,14,14,13,13,1,3,3,2,4,0,5,0,1,0
736,726,731,726,13,14,15,13,1,2,2,3,10,-5,5,-1,-1,2
1026,1017,1017,1021,13,14,15,13,1,2,3,3,9,0,-4,-1,-1,2
295,286,286,286,18,17,15,16,1,1,1,3,9,0,0,1,2,-1
586,586,586,586,18,17,18,16,2,2,1,2,0,0,0,1,-1,2
304,295,290,286,18,19,18,19,1,1,1,2,9,5,4,-1,1,-1
445,440,436,436,13,14,15,13,3,2,1,2,5,4,0,-1,-1,2
342,337,337,337,17,16,18,18,2,2,3,1,5,0,0,1,-2,0
937,932,937,937,17,19,18,18,2,1,2,2,5,-5,0,-2,1,0
1059,1059,1059,1054,20,19,20,21,1,1,2,4,0,0,5,1,-1,-1
586,586,586,581,18,17,18,16,2,2,2,2,0,0,5,1,-1,2
360,356,351,351,17,19,18,18,3,3,2,1,4,5,0,-2,1,0
773,768,768,768,13,14,12,13,1,1,2,1,5,0,0,-1,2,-1
778,773,778,773,13,14,13,13,2,2,1,3,5,-5,5,-1,1,0
464,459,459,459,20,19,20,21,3,2,3,1,5,0,0,1,-1,-1
674,670,670,670,17,16,15,16,1,2,4,1,4,0,0,1,1,-1
1054,1054,1054,1054,17,19,18,18,1,2,1,2,0,0,0,-2,1,0
886,881,881,881,14,17,15,16,1,3,1,1,5,0,0,-3,2,-1
257,253,248,248,18,19,18,18,1,1,1,1,4,5,0,-1,1,0
815,810,806,801,14,17,15,16,4,1,1,2,5,4,5,-3,2,-1
904,895,895,895,18,17,18,19,3,1,1,1,9,0,0,1,-1,-1
421,421,417,417,20,19,20,18,1,1,1,1,0,4,0,1,-1,2
839,824,824,824,14,14,15,13,2,1,2,1,15,0,0,0,-1,2
768,768,773,768,13,14,15,16,3,2,2,1,0,-5,5,-1,-1,-1
436,436,436,431,20,19,20,18,1,1,2,1,0,0,5,1,-1,2
867,862,862,857,21,19,20,18,2,3,1,1,5,0,5,2,-1,2
539,534,529,529,18,17,18,16,1,2,1,2,5,5,0,1,-1,2
857,853,857,862,21,19,20,21,1,1,1,1,4,-4,-5,2,-1,-1
651,651,651,651,13,14,12,13,2,1,1,3,0,0,0,-1,2,-1
229,220,224,224,14,17,15,16,3,2,2,1,9,-4,0,-3,2,-1
323,309,464,295,14,14,15,13,2,4,1,1,14,-155,169,0,-1,2
243,243,243,243,18,19,18,18,2,3,1,2,0,0,0,-1,1,0
862,857,857,853,18,19,18,18,2,1,1,2,5,0,4,-1,1,0
674,670,679,684,20,19,20,21,2,2,1,2,4,-9,-5,1,-1,-1
614,609,609,604,18,19,18,19,4,1,1,2,5,0,5,-1,1,-1
1064,1059,1073,1054,20,19,18,18,1,1,1,3,5,-14,19,1,1,0
346,342,332,332,13,14,15,13,2,3,1,1,4,10,0,-1,-1,2
984,984,979,984,17,16,18,18,2,3,1,1,0,5,-5,1,-2,0
267,257,253,253,18,19,18,18,1,1,1,3,10,4,0,-1,1,0
970,974,970,970,17,16,18,16,1,3,1,1,-4,4,0,1,-2,2
604,590,590,595,18,17,18,16,2,1,2,3,14,0,-5,1,-1,2
853,848,857,848,18,17,18,18,1,3,1,1,5,-9,9,1,-1,0
1003,993,993,993,13,14,12,13,2,1,2,1,10,0,0,-1,2,-1
843,843,843,843,18,19,18,18,2,3,1,2,0,0,0,-1,1,0
731,707,703,281,13,14,15,13,2,2,3,1,24,4,422,-1,-1,2
267,257,253,253,18,19,18,18,4,3,1,1,10,4,0,-1,1,0
